ObID,HRI,HRL,LRI,LRL,Internals,Leaves,Height,Vertices,Size,Duration,RatioIL,MeanBar,StdBar,Beta1,Beta2,
580,6,6,0,6,6,12,4,18,17,370.0,0.5,2.25,0.8541666666666666,1.2333333333333332,5.25,
486,1,2,0,0,1,2,1,3,2,1.0,0.5,1.0,0.0,0.0,1.0,
233,4,1,0,4,4,5,4,9,8,272.0,0.8,2.8,0.5599999999999999,1.1666666666666665,2.0,
48,1,1,0,0,1,1,1,2,1,0.0,1.0,0.0,0.0,0.0,0.0,
400,2,0,0,1,2,1,2,3,2,5.0,2.0,2.0,0.0,1.0,0.5,
472,3,2,0,0,3,2,3,5,4,131.0,1.5,2.5,0.25,1.0,0.875,
658,2,0,0,1,2,1,2,3,2,8.0,2.0,2.0,0.0,1.0,0.5,
480,4,5,0,1,4,6,3,10,9,210.0,0.6666666666666666,1.8333333333333333,0.47222222222222215,0.8333333333333333,2.875,
277,1,1,0,0,1,1,1,2,1,0.0,1.0,0.0,0.0,0.0,0.0,
871,1,0,0,1,1,1,1,2,1,0.0,1.0,0.0,0.0,0.0,0.0,
546,4,3,0,2,4,5,4,9,8,267.0,0.8,3.0,0.8,1.1666666666666665,1.875,
664,1,0,0,3,1,3,1,4,3,72.0,0.3333333333333333,1.0,0.0,0.0,1.5,
830,1,1,0,0,1,1,1,2,1,0.0,1.0,0.0,0.0,0.0,0.0,
232,1,2,0,1,1,3,1,4,3,23.0,0.3333333333333333,1.0,0.0,0.0,1.5,
347,3,2,0,1,3,3,3,6,5,162.0,1.0,2.6666666666666665,0.22222222222222224,1.0,1.25,
799,1,1,0,0,1,1,1,2,1,0.0,1.0,0.0,0.0,0.0,0.0,
52,4,4,1,1,5,5,3,10,9,177.0,1.0,2.0,0.4,1.0833333333333333,2.375,
904,1,1,0,1,1,2,1,3,2,49.0,0.5,1.0,0.0,0.0,1.0,
66,1,1,0,0,1,1,1,2,1,0.0,1.0,0.0,0.0,0.0,0.0,
704,2,1,0,0,2,1,2,3,2,11.0,2.0,2.0,0.0,1.0,0.5,
33,1,1,0,0,1,1,1,2,1,0.0,1.0,0.0,0.0,0.0,0.0,
22,2,2,0,0,2,2,2,4,3,145.0,1.0,1.5,0.25,0.5,1.0,
680,6,5,0,4,6,9,4,15,14,282.0,0.6666666666666666,1.7777777777777777,0.8395061728395062,1.1833333333333333,4.25,
369,7,3,0,1,7,4,4,11,10,185.0,1.75,3.0,1.0,1.0190476190476192,1.5,
785,1,0,0,1,1,1,1,2,1,0.0,1.0,0.0,0.0,0.0,0.0,
265,2,2,0,0,2,2,2,4,3,32.0,1.0,1.5,0.25,0.5,1.0,
581,2,1,0,1,2,2,2,4,3,90.0,1.0,2.0,0.0,1.0,1.0,
428,1,2,0,0,1,2,1,3,2,50.0,0.5,1.0,0.0,0.0,1.0,
199,1,1,0,0,1,1,1,2,1,0.0,1.0,0.0,0.0,0.0,0.0,
714,1,1,0,0,1,1,1,2,1,0.0,1.0,0.0,0.0,0.0,0.0,
15,1,1,0,1,1,2,1,3,2,58.0,0.5,1.0,0.0,0.0,1.0,
61,5,4,0,0,5,4,5,9,8,230.0,1.25,3.75,1.1875,1.1666666666666665,1.15625,
643,1,2,0,0,1,2,1,3,2,53.0,0.5,1.0,0.0,0.0,1.0,
198,1,0,0,1,1,1,1,2,1,0.0,1.0,0.0,0.0,0.0,0.0,
854,1,1,0,0,1,1,1,2,1,0.0,1.0,0.0,0.0,0.0,0.0,
435,1,1,0,0,1,1,1,2,1,0.0,1.0,0.0,0.0,0.0,0.0,
399,3,2,0,1,3,3,3,6,5,129.0,1.0,2.0,0.6666666666666666,0.8333333333333333,1.375,
91,1,1,0,0,1,1,1,2,1,0.0,1.0,0.0,0.0,0.0,0.0,
124,9,6,1,7,10,13,5,23,22,298.0,0.7692307692307693,3.3076923076923075,1.1360946745562133,1.6023809523809522,4.3125,
418,4,1,0,1,4,2,4,6,5,88.0,2.0,3.0,1.0,1.1666666666666665,0.75,
638,2,1,0,1,2,2,2,4,3,50.0,1.0,1.5,0.25,0.5,1.0,
9,3,2,1,1,4,3,3,7,6,549.0,1.3333333333333333,2.6666666666666665,0.22222222222222224,0.8333333333333333,1.25,
153,1,1,0,1,1,2,1,3,2,109.0,0.5,1.0,0.0,0.0,1.0,
589,1,1,0,0,1,1,1,2,1,0.0,1.0,0.0,0.0,0.0,0.0,
685,1,1,0,1,1,2,1,3,2,62.0,0.5,1.0,0.0,0.0,1.0,
915,5,4,0,2,5,6,3,11,10,181.0,0.8333333333333334,2.5,0.25,1.0833333333333333,2.625,
897,1,0,0,1,1,1,1,2,1,0.0,1.0,0.0,0.0,0.0,0.0,
203,7,3,0,2,7,5,5,12,11,295.0,1.4,3.0,1.6,1.2333333333333334,1.90625,
597,1,1,0,0,1,1,1,2,1,0.0,1.0,0.0,0.0,0.0,0.0,
415,1,1,0,0,1,1,1,2,1,0.0,1.0,0.0,0.0,0.0,0.0,
627,2,4,0,2,2,6,2,8,7,181.0,0.3333333333333333,1.1666666666666667,0.13888888888888887,0.5,3.0,
877,6,3,0,5,6,8,4,14,13,241.0,0.75,1.875,0.859375,1.1833333333333333,3.75,
887,1,0,0,1,1,1,1,2,1,0.0,1.0,0.0,0.0,0.0,0.0,
230,2,1,0,0,2,1,2,3,2,21.0,2.0,2.0,0.0,1.0,0.5,
109,1,1,0,0,1,1,1,2,1,0.0,1.0,0.0,0.0,0.0,0.0,
697,1,1,0,2,1,3,1,4,3,36.0,0.3333333333333333,1.0,0.0,0.0,1.5,
798,1,2,0,0,1,2,1,3,2,19.0,0.5,1.0,0.0,0.0,1.0,
83,1,1,0,0,1,1,1,2,1,0.0,1.0,0.0,0.0,0.0,0.0,
560,1,0,0,1,1,1,1,2,1,0.0,1.0,0.0,0.0,0.0,0.0,
257,5,3,0,1,5,4,4,9,8,189.0,1.25,2.75,0.6875,1.1666666666666665,1.625,
377,2,1,0,3,2,4,2,6,5,198.0,0.5,2.0,0.0,1.0,2.0,
312,5,5,0,0,5,5,5,10,9,261.0,1.0,3.4,1.44,1.1666666666666665,1.65625,
783,1,3,0,0,1,3,1,4,3,87.0,0.3333333333333333,1.0,0.0,0.0,1.5,
666,1,2,0,0,1,2,1,3,2,0.0,0.5,1.0,0.0,0.0,1.0,
349,2,1,0,0,2,1,2,3,2,17.0,2.0,2.0,0.0,1.0,0.5,
59,1,1,0,0,1,1,1,2,1,0.0,1.0,0.0,0.0,0.0,0.0,
550,5,2,0,2,5,4,5,9,8,87.0,1.25,2.25,2.6875,1.0333333333333332,1.65625,
71,1,1,0,2,1,3,1,4,3,169.0,0.3333333333333333,1.0,0.0,0.0,1.5,
568,2,1,0,2,2,3,2,5,4,96.0,0.6666666666666666,1.6666666666666667,0.2222222222222222,0.5,1.5,
225,1,1,0,0,1,1,1,2,1,0.0,1.0,0.0,0.0,0.0,0.0,
3,3,1,0,0,3,1,3,4,3,87.0,3.0,3.0,0.0,1.5,0.375,
318,2,1,0,0,2,1,2,3,2,99.0,2.0,2.0,0.0,1.0,0.5,
851,2,2,0,2,2,4,2,6,5,109.0,0.5,2.0,0.0,1.0,2.0,
780,1,1,0,0,1,1,1,2,1,0.0,1.0,0.0,0.0,0.0,0.0,
742,1,1,0,0,1,1,1,2,1,0.0,1.0,0.0,0.0,0.0,0.0,
413,4,4,0,0,4,4,4,8,7,59.0,1.0,2.25,1.6875,0.9166666666666665,1.625,
712,2,2,0,0,2,2,2,4,3,75.0,1.0,1.5,0.25,0.5,1.0,
864,1,1,0,2,1,3,1,4,3,43.0,0.3333333333333333,1.0,0.0,0.0,1.5,
901,1,1,0,0,1,1,1,2,1,0.0,1.0,0.0,0.0,0.0,0.0,
70,1,0,0,1,1,1,1,2,1,0.0,1.0,0.0,0.0,0.0,0.0,
745,2,3,0,0,2,3,2,5,4,65.0,0.6666666666666666,1.6666666666666667,0.2222222222222222,0.5,1.5,
754,5,6,0,2,5,8,4,13,12,225.0,0.625,2.25,0.6875,1.1666666666666665,3.625,
316,3,3,0,1,3,4,2,7,6,109.0,0.75,1.75,0.1875,0.6666666666666666,2.0,
210,1,2,0,1,1,3,1,4,3,30.0,0.3333333333333333,1.0,0.0,0.0,1.5,
611,1,2,0,0,1,2,1,3,2,20.0,0.5,1.0,0.0,0.0,1.0,
564,1,2,0,0,1,2,1,3,2,47.0,0.5,1.0,0.0,0.0,1.0,
218,0,0,1,1,1,1,1,2,1,0.0,1.0,0.0,0.0,0.0,0.0,
147,1,0,0,2,1,2,1,3,2,18.0,0.5,1.0,0.0,0.0,1.0,
576,2,0,0,4,2,4,2,6,5,41.0,0.5,1.25,0.1875,0.5,2.0,
386,2,1,0,0,2,1,2,3,2,54.0,2.0,2.0,0.0,1.0,0.5,
840,2,1,0,0,2,1,2,3,2,22.0,2.0,2.0,0.0,1.0,0.5,
786,1,2,0,0,1,2,1,3,2,95.0,0.5,1.0,0.0,0.0,1.0,
683,3,1,0,2,3,3,3,6,5,149.0,1.0,2.0,0.6666666666666666,0.8333333333333333,1.375,
628,1,0,0,1,1,1,1,2,1,0.0,1.0,0.0,0.0,0.0,0.0,
237,1,1,0,0,1,1,1,2,1,0.0,1.0,0.0,0.0,0.0,0.0,
447,1,1,0,1,1,2,1,3,2,6.0,0.5,1.0,0.0,0.0,1.0,
495,2,1,0,0,2,1,2,3,2,76.0,2.0,2.0,0.0,1.0,0.5,
822,2,1,0,0,2,1,2,3,2,5.0,2.0,2.0,0.0,1.0,0.5,
782,2,4,0,0,2,4,2,6,5,212.0,0.5,1.5,0.25,0.5,2.0,
884,1,1,0,0,1,1,1,2,1,0.0,1.0,0.0,0.0,0.0,0.0,
191,1,0,0,1,1,1,1,2,1,0.0,1.0,0.0,0.0,0.0,0.0,
361,1,0,0,1,1,1,1,2,1,0.0,1.0,0.0,0.0,0.0,0.0,
159,5,3,0,3,5,6,4,11,10,200.0,0.8333333333333334,2.6666666666666665,1.5555555555555554,1.1666666666666665,2.25,
673,10,10,0,6,10,16,6,26,25,439.0,0.625,3.6875,2.08984375,1.4119047619047618,4.75,
811,1,1,0,0,1,1,1,2,1,0.0,1.0,0.0,0.0,0.0,0.0,
505,1,1,0,0,1,1,1,2,1,0.0,1.0,0.0,0.0,0.0,0.0,
820,1,1,0,0,1,1,1,2,1,0.0,1.0,0.0,0.0,0.0,0.0,
36,2,2,0,0,2,2,2,4,3,33.0,1.0,2.0,0.0,1.0,1.0,
134,1,1,0,0,1,1,1,2,1,0.0,1.0,0.0,0.0,0.0,0.0,
844,1,2,0,0,1,2,1,3,2,6.0,0.5,1.0,0.0,0.0,1.0,
125,3,3,0,1,3,4,3,7,6,241.0,0.75,2.25,0.1875,1.0,1.875,
900,1,3,0,1,1,4,1,5,4,103.0,0.25,1.0,0.0,0.0,2.0,
735,2,2,0,0,2,2,2,4,3,16.0,1.0,1.5,0.25,0.5,1.0,
140,11,10,0,4,11,14,6,25,24,368.0,0.7857142857142857,2.857142857142857,2.693877551020409,1.7214285714285713,5.46875,
429,2,1,0,0,2,1,2,3,2,19.0,2.0,2.0,0.0,1.0,0.5,
186,2,1,0,1,2,2,2,4,3,127.0,1.0,1.5,0.25,0.5,1.0,
737,1,1,0,0,1,1,1,2,1,0.0,1.0,0.0,0.0,0.0,0.0,
214,1,2,0,1,1,3,1,4,3,29.0,0.3333333333333333,1.0,0.0,0.0,1.5,
775,1,1,0,0,1,1,1,2,1,0.0,1.0,0.0,0.0,0.0,0.0,
483,4,7,0,0,4,7,3,11,10,248.0,0.5714285714285714,2.142857142857143,0.9795918367346939,1.1666666666666665,3.0,
485,1,1,0,0,1,1,1,2,1,0.0,1.0,0.0,0.0,0.0,0.0,
95,1,0,0,2,1,2,1,3,2,25.0,0.5,1.0,0.0,0.0,1.0,
603,0,0,1,1,1,1,1,2,1,0.0,1.0,0.0,0.0,0.0,0.0,
588,2,1,0,0,2,1,2,3,2,140.0,2.0,2.0,0.0,1.0,0.5,
802,7,8,0,0,7,8,6,15,14,429.0,0.875,2.875,3.109375,1.1023809523809525,2.84375,
248,3,2,0,0,3,2,2,5,4,34.0,1.5,2.0,0.0,0.6666666666666666,1.0,
142,1,0,0,1,1,1,1,2,1,0.0,1.0,0.0,0.0,0.0,0.0,
143,1,1,0,0,1,1,1,2,1,0.0,1.0,0.0,0.0,0.0,0.0,
30,2,2,0,0,2,2,2,4,3,69.0,1.0,2.0,0.0,1.0,1.0,
117,3,3,0,0,3,3,2,6,5,62.0,1.0,1.6666666666666667,0.2222222222222222,0.6666666666666666,1.5,
190,0,1,1,0,1,1,1,2,1,0.0,1.0,0.0,0.0,0.0,0.0,
653,4,6,0,1,4,7,3,11,10,240.0,0.5714285714285714,2.0,0.2857142857142857,0.8333333333333333,3.375,
545,1,0,0,1,1,1,1,2,1,0.0,1.0,0.0,0.0,0.0,0.0,
670,1,1,0,0,1,1,1,2,1,0.0,1.0,0.0,0.0,0.0,0.0,
542,1,1,0,0,1,1,1,2,1,0.0,1.0,0.0,0.0,0.0,0.0,
373,1,0,0,1,1,1,1,2,1,0.0,1.0,0.0,0.0,0.0,0.0,
863,1,1,0,0,1,1,1,2,1,0.0,1.0,0.0,0.0,0.0,0.0,
223,1,0,0,1,1,1,1,2,1,0.0,1.0,0.0,0.0,0.0,0.0,
205,6,5,0,2,6,7,6,13,12,294.0,0.8571428571428571,4.285714285714286,1.6326530612244898,1.2333333333333334,1.6875,
196,5,4,0,0,5,4,4,9,8,153.0,1.25,3.0,0.5,1.1666666666666665,1.5,
694,1,1,0,0,1,1,1,2,1,0.0,1.0,0.0,0.0,0.0,0.0,
322,2,1,0,0,2,1,2,3,2,42.0,2.0,2.0,0.0,1.0,0.5,
880,1,1,0,0,1,1,1,2,1,0.0,1.0,0.0,0.0,0.0,0.0,
317,1,0,0,1,1,1,1,2,1,0.0,1.0,0.0,0.0,0.0,0.0,
0,2,1,0,0,2,1,2,3,2,24.0,2.0,2.0,0.0,1.0,0.5,
691,1,1,0,0,1,1,1,2,1,0.0,1.0,0.0,0.0,0.0,0.0,
467,1,1,0,0,1,1,1,2,1,0.0,1.0,0.0,0.0,0.0,0.0,
487,2,2,0,0,2,2,2,4,3,76.0,1.0,1.5,0.25,0.5,1.0,
425,3,1,0,1,3,2,3,5,4,26.0,1.5,2.0,1.0,0.8333333333333333,0.875,
601,1,1,0,0,1,1,1,2,1,0.0,1.0,0.0,0.0,0.0,0.0,
454,2,1,0,1,2,2,2,4,3,43.0,1.0,2.0,0.0,1.0,1.0,
567,2,1,0,0,2,1,2,3,2,16.0,2.0,2.0,0.0,1.0,0.5,
598,1,0,0,1,1,1,1,2,1,0.0,1.0,0.0,0.0,0.0,0.0,
903,4,4,0,0,4,4,4,8,7,125.0,1.0,2.0,1.5,0.9166666666666665,1.75,
97,6,5,0,1,6,6,4,12,11,155.0,1.0,2.5,0.9166666666666666,1.2333333333333334,2.5,
220,1,1,0,0,1,1,1,2,1,0.0,1.0,0.0,0.0,0.0,0.0,
187,1,1,0,1,1,2,1,3,2,10.0,0.5,1.0,0.0,0.0,1.0,
631,2,0,0,1,2,1,2,3,2,2.0,2.0,2.0,0.0,1.0,0.5,
590,1,1,0,0,1,1,1,2,1,0.0,1.0,0.0,0.0,0.0,0.0,
388,1,1,0,0,1,1,1,2,1,0.0,1.0,0.0,0.0,0.0,0.0,
450,1,2,0,1,1,3,1,4,3,84.0,0.3333333333333333,1.0,0.0,0.0,1.5,
599,1,0,0,3,1,3,1,4,3,48.0,0.3333333333333333,1.0,0.0,0.0,1.5,
330,2,0,0,1,2,1,2,3,2,65.0,2.0,2.0,0.0,1.0,0.5,
213,1,1,0,0,1,1,1,2,1,0.0,1.0,0.0,0.0,0.0,0.0,
639,2,3,1,2,3,5,3,8,7,159.0,0.6,2.4,0.24,1.0,2.25,
837,1,1,0,0,1,1,1,2,1,0.0,1.0,0.0,0.0,0.0,0.0,
253,7,2,0,3,7,5,6,12,11,165.0,1.4,4.6,1.8399999999999999,1.2333333333333332,1.09375,
289,1,0,0,1,1,1,1,2,1,0.0,1.0,0.0,0.0,0.0,0.0,
809,3,2,0,4,3,6,3,9,8,125.0,0.5,1.6666666666666667,0.5555555555555557,0.8333333333333333,2.875,
105,3,1,0,0,3,1,3,4,3,29.0,3.0,3.0,0.0,1.5,0.375,
866,2,3,0,1,2,4,2,6,5,57.0,0.5,1.75,0.1875,0.5,2.0,
741,3,1,1,0,4,1,4,5,4,89.0,4.0,4.0,0.0,1.8333333333333333,0.25,
772,1,0,0,1,1,1,1,2,1,0.0,1.0,0.0,0.0,0.0,0.0,
409,1,1,0,0,1,1,1,2,1,0.0,1.0,0.0,0.0,0.0,0.0,
602,1,1,0,0,1,1,1,2,1,0.0,1.0,0.0,0.0,0.0,0.0,
279,2,1,0,1,2,2,2,4,3,105.0,1.0,1.5,0.25,0.5,1.0,
804,1,1,0,0,1,1,1,2,1,0.0,1.0,0.0,0.0,0.0,0.0,
285,3,4,0,0,3,4,3,7,6,73.0,0.75,2.25,0.1875,1.0,1.875,
632,2,2,0,0,2,2,2,4,3,9.0,1.0,1.5,0.25,0.5,1.0,
623,2,1,0,0,2,1,2,3,2,56.0,2.0,2.0,0.0,1.0,0.5,
408,6,3,0,1,6,4,5,10,9,232.0,1.5,2.75,1.6875,1.0333333333333334,1.65625,
231,1,0,0,1,1,1,1,2,1,0.0,1.0,0.0,0.0,0.0,0.0,
336,1,2,0,0,1,2,1,3,2,21.0,0.5,1.0,0.0,0.0,1.0,
803,3,2,0,1,3,3,2,6,5,318.0,1.0,2.0,0.0,0.6666666666666666,1.5,
765,1,1,0,0,1,1,1,2,1,0.0,1.0,0.0,0.0,0.0,0.0,
282,2,1,0,0,2,1,2,3,2,35.0,2.0,2.0,0.0,1.0,0.5,
625,3,3,0,1,3,4,3,7,6,88.0,0.75,2.0,0.5,0.8333333333333333,1.875,
452,1,0,0,1,1,1,1,2,1,0.0,1.0,0.0,0.0,0.0,0.0,
642,3,3,0,1,3,4,3,7,6,103.0,0.75,2.0,1.0,0.8333333333333333,1.75,
758,1,1,0,0,1,1,1,2,1,0.0,1.0,0.0,0.0,0.0,0.0,
827,1,1,0,0,1,1,1,2,1,0.0,1.0,0.0,0.0,0.0,0.0,
17,1,0,0,1,1,1,1,2,1,0.0,1.0,0.0,0.0,0.0,0.0,
368,3,3,0,0,3,3,3,6,5,65.0,1.0,2.0,0.6666666666666666,0.8333333333333333,1.375,
181,1,2,0,0,1,2,1,3,2,11.0,0.5,1.0,0.0,0.0,1.0,
107,3,3,0,0,3,3,3,6,5,117.0,1.0,2.3333333333333335,0.22222222222222224,1.0,1.375,
909,1,1,0,0,1,1,1,2,1,0.0,1.0,0.0,0.0,0.0,0.0,
499,1,0,0,1,1,1,1,2,1,0.0,1.0,0.0,0.0,0.0,0.0,
88,2,2,0,0,2,2,2,4,3,92.0,1.0,1.5,0.25,0.5,1.0,
574,1,2,0,0,1,2,1,3,2,73.0,0.5,1.0,0.0,0.0,1.0,
482,4,4,0,1,4,5,3,9,8,115.0,0.8,2.2,0.15999999999999998,0.8333333333333333,2.375,
595,1,0,0,1,1,1,1,2,1,0.0,1.0,0.0,0.0,0.0,0.0,
668,1,0,0,1,1,1,1,2,1,0.0,1.0,0.0,0.0,0.0,0.0,
87,2,0,0,1,2,1,2,3,2,28.0,2.0,2.0,0.0,1.0,0.5,
469,2,1,0,0,2,1,2,3,2,12.0,2.0,2.0,0.0,1.0,0.5,
525,2,1,0,2,2,3,2,5,4,86.0,0.6666666666666666,2.0,0.0,1.0,1.5,
391,1,4,0,1,1,5,1,6,5,113.0,0.2,1.0,0.0,0.0,2.5,
194,1,2,0,0,1,2,1,3,2,56.0,0.5,1.0,0.0,0.0,1.0,
708,4,4,0,0,4,4,2,8,7,133.0,1.0,2.0,0.0,1.0,2.0,
99,1,1,0,0,1,1,1,2,1,0.0,1.0,0.0,0.0,0.0,0.0,
217,4,1,0,2,4,3,3,7,6,160.0,1.3333333333333333,2.0,0.6666666666666666,0.8333333333333333,1.375,
859,1,3,0,0,1,3,1,4,3,75.0,0.3333333333333333,1.0,0.0,0.0,1.5,
79,2,1,0,0,2,1,2,3,2,26.0,2.0,2.0,0.0,1.0,0.5,
832,2,1,0,0,2,1,2,3,2,8.0,2.0,2.0,0.0,1.0,0.5,
211,1,1,0,0,1,1,1,2,1,0.0,1.0,0.0,0.0,0.0,0.0,
654,1,1,0,0,1,1,1,2,1,0.0,1.0,0.0,0.0,0.0,0.0,
624,4,7,0,3,4,10,4,14,13,204.0,0.4,3.0,0.4,1.1666666666666665,3.75,
53,2,2,0,0,2,2,2,4,3,16.0,1.0,2.0,0.0,1.0,1.0,
796,1,2,0,0,1,2,1,3,2,49.0,0.5,1.0,0.0,0.0,1.0,
299,1,0,0,1,1,1,1,2,1,0.0,1.0,0.0,0.0,0.0,0.0,
197,2,1,0,0,2,1,2,3,2,19.0,2.0,2.0,0.0,1.0,0.5,
35,2,4,0,0,2,4,2,6,5,81.0,0.5,1.25,0.1875,0.5,2.0,
132,1,0,0,1,1,1,1,2,1,0.0,1.0,0.0,0.0,0.0,0.0,
443,2,1,0,0,2,1,2,3,2,103.0,2.0,2.0,0.0,1.0,0.5,
807,1,1,0,0,1,1,1,2,1,0.0,1.0,0.0,0.0,0.0,0.0,
170,2,2,0,0,2,2,2,4,3,294.0,1.0,1.5,0.25,0.5,1.0,
393,1,1,0,0,1,1,1,2,1,0.0,1.0,0.0,0.0,0.0,0.0,
825,1,0,0,1,1,1,1,2,1,0.0,1.0,0.0,0.0,0.0,0.0,
342,2,2,0,0,2,2,2,4,3,71.0,1.0,2.0,0.0,1.0,1.0,
449,1,1,0,0,1,1,1,2,1,0.0,1.0,0.0,0.0,0.0,0.0,
195,2,1,0,0,2,1,2,3,2,62.0,2.0,2.0,0.0,1.0,0.5,
80,4,3,0,1,4,4,4,8,7,50.0,1.0,1.75,1.6875,0.9166666666666666,1.75,
185,1,1,0,0,1,1,1,2,1,0.0,1.0,0.0,0.0,0.0,0.0,
875,5,2,0,0,5,2,5,7,6,163.0,2.5,3.5,2.25,1.1666666666666665,0.65625,
136,1,1,0,0,1,1,1,2,1,0.0,1.0,0.0,0.0,0.0,0.0,
575,1,1,0,0,1,1,1,2,1,0.0,1.0,0.0,0.0,0.0,0.0,
410,5,3,0,4,5,7,3,12,11,600.0,0.7142857142857143,2.4285714285714284,0.24489795918367344,1.0833333333333333,3.125,
849,1,0,0,1,1,1,1,2,1,0.0,1.0,0.0,0.0,0.0,0.0,
27,1,0,0,1,1,1,1,2,1,0.0,1.0,0.0,0.0,0.0,0.0,
339,7,8,0,1,7,9,5,16,15,360.0,0.7777777777777778,3.5555555555555554,2.691358024691358,1.2,2.625,
254,1,1,0,0,1,1,1,2,1,0.0,1.0,0.0,0.0,0.0,0.0,
328,1,0,0,1,1,1,1,2,1,0.0,1.0,0.0,0.0,0.0,0.0,
539,1,1,0,0,1,1,1,2,1,0.0,1.0,0.0,0.0,0.0,0.0,
26,1,1,0,0,1,1,1,2,1,0.0,1.0,0.0,0.0,0.0,0.0,
96,1,1,0,0,1,1,1,2,1,0.0,1.0,0.0,0.0,0.0,0.0,
858,4,2,0,0,4,2,4,6,5,146.0,2.0,3.0,1.0,1.1666666666666665,0.75,
251,3,1,0,0,3,1,3,4,3,132.0,3.0,3.0,0.0,1.5,0.375,
818,8,4,0,3,8,7,5,15,14,151.0,1.1428571428571428,2.142857142857143,1.5510204081632655,1.3666666666666667,3.15625,
372,11,10,0,1,11,11,7,22,21,275.0,1.0,4.363636363636363,2.776859504132231,1.745238095238095,2.7890625,
494,1,1,0,2,1,3,1,4,3,82.0,0.3333333333333333,1.0,0.0,0.0,1.5,
421,1,1,0,0,1,1,1,2,1,0.0,1.0,0.0,0.0,0.0,0.0,
731,2,0,0,1,2,1,2,3,2,9.0,2.0,2.0,0.0,1.0,0.5,
656,1,1,0,0,1,1,1,2,1,0.0,1.0,0.0,0.0,0.0,0.0,
63,1,0,0,1,1,1,1,2,1,0.0,1.0,0.0,0.0,0.0,0.0,
184,2,1,0,0,2,1,2,3,2,137.0,2.0,2.0,0.0,1.0,0.5,
874,3,2,0,1,3,3,2,6,5,37.0,1.0,2.0,0.0,0.6666666666666666,1.5,
636,2,2,0,1,2,3,2,5,4,34.0,0.6666666666666666,1.3333333333333333,0.2222222222222222,0.5,1.5,
466,1,0,0,1,1,1,1,2,1,0.0,1.0,0.0,0.0,0.0,0.0,
167,1,1,0,0,1,1,1,2,1,0.0,1.0,0.0,0.0,0.0,0.0,
320,1,1,0,0,1,1,1,2,1,0.0,1.0,0.0,0.0,0.0,0.0,
7,1,1,0,0,1,1,1,2,1,0.0,1.0,0.0,0.0,0.0,0.0,
51,3,3,0,0,3,3,3,6,5,183.0,1.0,2.6666666666666665,0.22222222222222224,1.0,1.25,
82,1,1,0,0,1,1,1,2,1,0.0,1.0,0.0,0.0,0.0,0.0,
669,6,3,0,2,6,5,6,11,10,297.0,1.2,4.2,3.3600000000000003,1.2333333333333332,1.34375,
776,1,1,0,0,1,1,1,2,1,0.0,1.0,0.0,0.0,0.0,0.0,
453,4,3,0,2,4,5,4,9,8,135.0,0.8,2.4,1.04,0.9166666666666665,2.125,
227,1,1,0,0,1,1,1,2,1,0.0,1.0,0.0,0.0,0.0,0.0,
732,1,0,0,1,1,1,1,2,1,0.0,1.0,0.0,0.0,0.0,0.0,
845,1,1,0,0,1,1,1,2,1,0.0,1.0,0.0,0.0,0.0,0.0,
554,1,1,0,0,1,1,1,2,1,0.0,1.0,0.0,0.0,0.0,0.0,
298,1,1,0,0,1,1,1,2,1,0.0,1.0,0.0,0.0,0.0,0.0,
644,2,5,0,0,2,5,2,7,6,100.0,0.4,1.2,0.16000000000000006,0.5,2.5,
892,1,0,0,1,1,1,1,2,1,0.0,1.0,0.0,0.0,0.0,0.0,
868,3,1,0,0,3,1,3,4,3,71.0,3.0,3.0,0.0,1.5,0.375,
396,2,1,0,0,2,1,2,3,2,55.0,2.0,2.0,0.0,1.0,0.5,
351,1,0,0,2,1,2,1,3,2,30.0,0.5,1.0,0.0,0.0,1.0,
367,1,1,0,0,1,1,1,2,1,0.0,1.0,0.0,0.0,0.0,0.0,
717,3,0,0,1,3,1,3,4,3,88.0,3.0,3.0,0.0,1.5,0.375,
794,1,0,0,1,1,1,1,2,1,0.0,1.0,0.0,0.0,0.0,0.0,
406,4,4,0,1,4,5,3,9,8,169.0,0.8,2.0,0.4,0.8333333333333333,2.375,
549,5,6,0,0,5,6,5,11,10,180.0,0.8333333333333334,3.0,3.0,1.0333333333333332,2.0625,
255,1,1,0,0,1,1,1,2,1,0.0,1.0,0.0,0.0,0.0,0.0,
154,1,1,0,0,1,1,1,2,1,0.0,1.0,0.0,0.0,0.0,0.0,
766,1,3,0,0,1,3,1,4,3,77.0,0.3333333333333333,1.0,0.0,0.0,1.5,
18,2,4,0,1,2,5,2,7,6,150.0,0.4,1.2,0.16000000000000006,0.5,2.5,
164,2,2,0,1,2,3,2,5,4,91.0,0.6666666666666666,1.3333333333333333,0.2222222222222222,0.5,1.5,
47,1,1,0,0,1,1,1,2,1,0.0,1.0,0.0,0.0,0.0,0.0,
912,1,1,0,0,1,1,1,2,1,0.0,1.0,0.0,0.0,0.0,0.0,
886,2,0,0,1,2,1,2,3,2,36.0,2.0,2.0,0.0,1.0,0.5,
363,3,4,0,3,3,7,3,10,9,257.0,0.42857142857142855,1.5714285714285714,0.5306122448979591,0.8333333333333333,3.375,
357,1,0,0,1,1,1,1,2,1,0.0,1.0,0.0,0.0,0.0,0.0,
73,2,1,0,0,2,1,2,3,2,105.0,2.0,2.0,0.0,1.0,0.5,
724,6,4,0,0,6,4,4,10,9,150.0,1.5,3.5,0.25,1.4166666666666665,1.25,
292,1,1,0,0,1,1,1,2,1,0.0,1.0,0.0,0.0,0.0,0.0,
842,1,2,0,0,1,2,1,3,2,116.0,0.5,1.0,0.0,0.0,1.0,
753,1,3,0,0,1,3,1,4,3,94.0,0.3333333333333333,1.0,0.0,0.0,1.5,
698,3,2,0,0,3,2,2,5,4,48.0,1.5,2.0,0.0,0.6666666666666666,1.0,
379,1,0,0,1,1,1,1,2,1,0.0,1.0,0.0,0.0,0.0,0.0,
38,2,3,0,1,2,4,2,6,5,123.0,0.5,1.5,0.25,0.5,2.0,
617,1,1,0,0,1,1,1,2,1,0.0,1.0,0.0,0.0,0.0,0.0,
860,1,0,0,1,1,1,1,2,1,0.0,1.0,0.0,0.0,0.0,0.0,
238,3,4,0,1,3,5,2,8,7,169.0,0.6,2.0,0.0,0.6666666666666666,2.5,
652,1,1,0,0,1,1,1,2,1,0.0,1.0,0.0,0.0,0.0,0.0,
307,2,0,0,1,2,1,2,3,2,13.0,2.0,2.0,0.0,1.0,0.5,
152,1,1,0,0,1,1,1,2,1,0.0,1.0,0.0,0.0,0.0,0.0,
241,1,1,0,0,1,1,1,2,1,0.0,1.0,0.0,0.0,0.0,0.0,
543,4,6,0,0,4,6,3,10,9,97.0,0.6666666666666666,2.1666666666666665,0.13888888888888884,0.8333333333333333,2.875,
441,1,0,0,2,1,2,1,3,2,14.0,0.5,1.0,0.0,0.0,1.0,
895,1,0,0,1,1,1,1,2,1,0.0,1.0,0.0,0.0,0.0,0.0,
321,1,1,0,0,1,1,1,2,1,0.0,1.0,0.0,0.0,0.0,0.0,
536,4,1,0,2,4,3,4,7,6,67.0,1.3333333333333333,2.6666666666666665,0.8888888888888888,1.1666666666666665,1.25,
768,3,3,0,1,3,4,3,7,6,82.0,0.75,2.25,0.1875,1.0,1.875,
676,9,7,0,3,9,10,6,19,18,365.0,0.9,3.8,1.9600000000000002,1.2690476190476188,2.8125,
531,4,5,0,0,4,5,3,9,8,101.0,0.8,2.6,0.6400000000000002,1.1666666666666665,2.0,
157,1,1,0,0,1,1,1,2,1,0.0,1.0,0.0,0.0,0.0,0.0,
481,3,1,0,0,3,1,3,4,3,42.0,3.0,3.0,0.0,1.5,0.375,
723,1,1,0,0,1,1,1,2,1,0.0,1.0,0.0,0.0,0.0,0.0,
45,1,1,0,0,1,1,1,2,1,0.0,1.0,0.0,0.0,0.0,0.0,
506,1,0,0,2,1,2,1,3,2,42.0,0.5,1.0,0.0,0.0,1.0,
34,2,1,0,0,2,1,2,3,2,25.0,2.0,2.0,0.0,1.0,0.5,
457,2,1,0,0,2,1,2,3,2,56.0,2.0,2.0,0.0,1.0,0.5,
176,4,2,0,1,4,3,3,7,6,79.0,1.3333333333333333,2.3333333333333335,0.8888888888888888,1.1666666666666665,1.25,
456,4,0,0,2,4,2,4,6,5,155.0,2.0,3.0,1.0,1.1666666666666665,0.75,
535,4,2,0,1,4,3,4,7,6,134.0,1.3333333333333333,2.3333333333333335,1.5555555555555554,0.9166666666666665,1.25,
713,2,1,0,0,2,1,2,3,2,38.0,2.0,2.0,0.0,1.0,0.5,
905,3,5,0,0,3,5,2,8,7,192.0,0.6,1.4,0.24,0.6666666666666666,2.5,
850,1,1,0,0,1,1,1,2,1,0.0,1.0,0.0,0.0,0.0,0.0,
748,1,1,0,0,1,1,1,2,1,0.0,1.0,0.0,0.0,0.0,0.0,
275,2,2,0,0,2,2,2,4,3,18.0,1.0,1.5,0.25,0.5,1.0,
84,2,4,0,0,2,4,2,6,5,99.0,0.5,2.0,0.0,1.0,2.0,
791,4,1,0,1,4,2,3,6,5,18.0,2.0,2.5,0.25,0.8333333333333333,0.875,
734,3,4,0,0,3,4,3,7,6,133.0,0.75,2.0,0.5,0.8333333333333333,1.875,
46,3,1,0,0,3,1,3,4,3,23.0,3.0,3.0,0.0,1.5,0.375,
137,1,1,0,0,1,1,1,2,1,0.0,1.0,0.0,0.0,0.0,0.0,
509,1,0,0,1,1,1,1,2,1,0.0,1.0,0.0,0.0,0.0,0.0,
56,1,1,0,0,1,1,1,2,1,0.0,1.0,0.0,0.0,0.0,0.0,
297,15,11,0,2,15,13,8,28,27,665.0,1.1538461538461537,4.846153846153846,3.8224852071005917,2.1976190476190474,2.828125,
526,1,2,0,0,1,2,1,3,2,7.0,0.5,1.0,0.0,0.0,1.0,
25,2,0,1,1,3,1,3,4,3,148.0,3.0,3.0,0.0,1.5,0.375,
919,1,1,0,0,1,1,1,2,1,0.0,1.0,0.0,0.0,0.0,0.0,
326,1,0,0,1,1,1,1,2,1,0.0,1.0,0.0,0.0,0.0,0.0,
634,0,1,1,0,1,1,1,2,1,0.0,1.0,0.0,0.0,0.0,0.0,
853,2,4,0,0,2,4,2,6,5,133.0,0.5,1.5,0.25,0.5,2.0,
6,2,1,0,0,2,1,2,3,2,13.0,2.0,2.0,0.0,1.0,0.5,
914,1,1,0,0,1,1,1,2,1,0.0,1.0,0.0,0.0,0.0,0.0,
432,2,2,0,0,2,2,2,4,3,60.0,1.0,2.0,0.0,1.0,1.0,
911,2,0,0,1,2,1,2,3,2,21.0,2.0,2.0,0.0,1.0,0.5,
28,5,4,0,1,5,5,4,10,9,393.0,1.0,2.2,1.3599999999999999,1.1666666666666665,2.125,
518,1,1,0,0,1,1,1,2,1,0.0,1.0,0.0,0.0,0.0,0.0,
727,1,1,0,0,1,1,1,2,1,0.0,1.0,0.0,0.0,0.0,0.0,
219,1,3,0,0,1,3,1,4,3,22.0,0.3333333333333333,1.0,0.0,0.0,1.5,
805,5,5,0,3,5,8,3,13,12,477.0,0.625,2.375,0.484375,1.5,3.5,
118,1,2,0,0,1,2,1,3,2,3.0,0.5,1.0,0.0,0.0,1.0,
280,1,1,0,0,1,1,1,2,1,0.0,1.0,0.0,0.0,0.0,0.0,
488,2,3,0,0,2,3,2,5,4,147.0,0.6666666666666666,1.3333333333333333,0.2222222222222222,0.5,1.5,
424,1,0,0,1,1,1,1,2,1,0.0,1.0,0.0,0.0,0.0,0.0,
515,1,0,0,1,1,1,1,2,1,0.0,1.0,0.0,0.0,0.0,0.0,
910,3,4,0,1,3,5,2,8,7,49.0,0.6,1.6,0.24,0.6666666666666666,2.5,
779,1,2,0,0,1,2,1,3,2,14.0,0.5,1.0,0.0,0.0,1.0,
228,1,0,0,1,1,1,1,2,1,0.0,1.0,0.0,0.0,0.0,0.0,
431,0,1,1,0,1,1,1,2,1,0.0,1.0,0.0,0.0,0.0,0.0,
24,1,1,0,0,1,1,1,2,1,0.0,1.0,0.0,0.0,0.0,0.0,
352,1,0,0,1,1,1,1,2,1,0.0,1.0,0.0,0.0,0.0,0.0,
746,2,0,0,2,2,2,2,4,3,21.0,1.0,1.5,0.25,0.5,1.0,
578,2,1,0,1,2,2,2,4,3,51.0,1.0,1.5,0.25,0.5,1.0,
110,3,2,0,0,3,2,3,5,4,50.0,1.5,2.0,1.0,0.8333333333333333,0.875,
548,2,3,0,0,2,3,2,5,4,80.0,0.6666666666666666,1.3333333333333333,0.2222222222222222,0.5,1.5,
755,4,4,0,0,4,4,3,8,7,55.0,1.0,2.25,0.1875,0.8333333333333333,1.875,
557,1,1,0,0,1,1,1,2,1,0.0,1.0,0.0,0.0,0.0,0.0,
262,1,1,0,0,1,1,1,2,1,0.0,1.0,0.0,0.0,0.0,0.0,
715,6,5,0,2,6,7,6,13,12,384.0,0.8571428571428571,3.5714285714285716,1.959183673469388,1.0666666666666667,2.09375,
696,1,1,0,0,1,1,1,2,1,0.0,1.0,0.0,0.0,0.0,0.0,
596,2,2,0,0,2,2,2,4,3,137.0,1.0,1.5,0.25,0.5,1.0,
258,2,2,0,1,2,3,2,5,4,18.0,0.6666666666666666,1.3333333333333333,0.2222222222222222,0.5,1.5,
365,2,2,0,0,2,2,2,4,3,188.0,1.0,2.0,0.0,1.0,1.0,
439,6,6,0,0,6,6,5,12,11,318.0,1.0,2.8333333333333335,2.138888888888889,1.2333333333333332,2.15625,
565,1,1,0,0,1,1,1,2,1,0.0,1.0,0.0,0.0,0.0,0.0,
173,2,1,0,0,2,1,2,3,2,39.0,2.0,2.0,0.0,1.0,0.5,
344,1,1,0,0,1,1,1,2,1,0.0,1.0,0.0,0.0,0.0,0.0,
168,1,1,0,0,1,1,1,2,1,0.0,1.0,0.0,0.0,0.0,0.0,
502,1,1,0,0,1,1,1,2,1,0.0,1.0,0.0,0.0,0.0,0.0,
616,8,6,0,3,8,9,5,17,16,196.0,0.8888888888888888,2.6666666666666665,1.3333333333333333,1.2357142857142855,3.65625,
906,7,3,0,5,7,8,3,15,14,199.0,0.875,2.5,0.25,1.4,3.5,
814,2,2,0,0,2,2,2,4,3,102.0,1.0,1.5,0.25,0.5,1.0,
145,4,1,0,1,4,2,4,6,5,63.0,2.0,4.0,0.0,1.8333333333333333,0.5,
916,1,1,0,0,1,1,1,2,1,0.0,1.0,0.0,0.0,0.0,0.0,
274,2,2,0,1,2,3,2,5,4,64.0,0.6666666666666666,1.6666666666666667,0.2222222222222222,0.5,1.5,
235,9,8,0,0,9,8,4,17,16,310.0,1.125,3.0,0.75,1.3857142857142855,3.0,
437,1,0,0,1,1,1,1,2,1,0.0,1.0,0.0,0.0,0.0,0.0,
894,1,1,0,1,1,2,1,3,2,82.0,0.5,1.0,0.0,0.0,1.0,
821,1,1,0,0,1,1,1,2,1,0.0,1.0,0.0,0.0,0.0,0.0,
398,2,1,0,0,2,1,2,3,2,32.0,2.0,2.0,0.0,1.0,0.5,
75,1,1,0,0,1,1,1,2,1,0.0,1.0,0.0,0.0,0.0,0.0,
609,1,1,0,0,1,1,1,2,1,0.0,1.0,0.0,0.0,0.0,0.0,
861,1,0,0,2,1,2,1,3,2,51.0,0.5,1.0,0.0,0.0,1.0,
403,1,1,0,0,1,1,1,2,1,0.0,1.0,0.0,0.0,0.0,0.0,
414,2,0,0,1,2,1,2,3,2,86.0,2.0,2.0,0.0,1.0,0.5,
834,17,3,1,5,18,8,16,26,25,921.0,2.25,9.625,19.984375,1.4999861249861248,0.7081298828125,
781,3,1,0,0,3,1,3,4,3,51.0,3.0,3.0,0.0,1.5,0.375,
462,1,1,0,0,1,1,1,2,1,0.0,1.0,0.0,0.0,0.0,0.0,
566,1,1,0,0,1,1,1,2,1,0.0,1.0,0.0,0.0,0.0,0.0,
162,1,1,0,0,1,1,1,2,1,0.0,1.0,0.0,0.0,0.0,0.0,
857,3,4,0,0,3,4,3,7,6,97.0,0.75,1.75,0.6875,0.8333333333333333,1.875,
524,1,1,0,0,1,1,1,2,1,0.0,1.0,0.0,0.0,0.0,0.0,
100,1,1,0,0,1,1,1,2,1,0.0,1.0,0.0,0.0,0.0,0.0,
315,1,1,0,0,1,1,1,2,1,0.0,1.0,0.0,0.0,0.0,0.0,
813,2,1,0,0,2,1,2,3,2,4.0,2.0,2.0,0.0,1.0,0.5,
77,2,1,0,1,2,2,2,4,3,39.0,1.0,2.0,0.0,1.0,1.0,
183,1,2,0,0,1,2,1,3,2,67.0,0.5,1.0,0.0,0.0,1.0,
323,1,1,0,0,1,1,1,2,1,0.0,1.0,0.0,0.0,0.0,0.0,
640,1,2,0,1,1,3,1,4,3,146.0,0.3333333333333333,1.0,0.0,0.0,1.5,
520,1,1,0,0,1,1,1,2,1,0.0,1.0,0.0,0.0,0.0,0.0,
341,1,1,0,0,1,1,1,2,1,0.0,1.0,0.0,0.0,0.0,0.0,
156,1,1,0,0,1,1,1,2,1,0.0,1.0,0.0,0.0,0.0,0.0,
442,1,1,0,0,1,1,1,2,1,0.0,1.0,0.0,0.0,0.0,0.0,
49,2,3,0,0,2,3,2,5,4,78.0,0.6666666666666666,1.3333333333333333,0.2222222222222222,0.5,1.5,
534,1,1,0,0,1,1,1,2,1,0.0,1.0,0.0,0.0,0.0,0.0,
304,19,13,0,4,19,17,9,36,35,503.0,1.1176470588235294,6.0,6.117647058823529,2.4420634920634923,2.6015625,
209,1,0,0,1,1,1,1,2,1,0.0,1.0,0.0,0.0,0.0,0.0,
529,1,1,0,0,1,1,1,2,1,0.0,1.0,0.0,0.0,0.0,0.0,
120,2,1,0,0,2,1,2,3,2,87.0,2.0,2.0,0.0,1.0,0.5,
655,1,1,0,1,1,2,1,3,2,144.0,0.5,1.0,0.0,0.0,1.0,
296,1,1,0,0,1,1,1,2,1,0.0,1.0,0.0,0.0,0.0,0.0,
247,1,1,0,1,1,2,1,3,2,4.0,0.5,1.0,0.0,0.0,1.0,
337,2,0,0,1,2,1,2,3,2,27.0,2.0,2.0,0.0,1.0,0.5,
67,0,1,1,0,1,1,1,2,1,0.0,1.0,0.0,0.0,0.0,0.0,
621,2,2,0,0,2,2,2,4,3,258.0,1.0,2.0,0.0,1.0,1.0,
19,3,2,1,0,4,2,4,6,5,133.0,2.0,4.0,0.0,1.8333333333333333,0.5,
115,2,2,0,1,2,3,2,5,4,37.0,0.6666666666666666,1.6666666666666667,0.2222222222222222,0.5,1.5,
600,6,7,0,1,6,8,5,14,13,396.0,0.75,3.0,2.5,1.2333333333333332,2.96875,
563,1,1,0,0,1,1,1,2,1,0.0,1.0,0.0,0.0,0.0,0.0,
684,2,1,0,0,2,1,2,3,2,12.0,2.0,2.0,0.0,1.0,0.5,
327,1,1,0,0,1,1,1,2,1,0.0,1.0,0.0,0.0,0.0,0.0,
362,1,2,0,0,1,2,1,3,2,22.0,0.5,1.0,0.0,0.0,1.0,
898,4,2,0,2,4,4,4,8,7,113.0,1.0,3.0,0.5,1.1666666666666665,1.5,
740,2,1,0,1,2,2,2,4,3,115.0,1.0,1.5,0.25,0.5,1.0,
130,1,0,0,1,1,1,1,2,1,0.0,1.0,0.0,0.0,0.0,0.0,
401,2,0,0,1,2,1,2,3,2,37.0,2.0,2.0,0.0,1.0,0.5,
479,2,1,0,0,2,1,2,3,2,29.0,2.0,2.0,0.0,1.0,0.5,
605,3,3,0,0,3,3,3,6,5,79.0,1.0,2.0,0.6666666666666666,0.8333333333333333,1.375,
2,1,2,0,0,1,2,1,3,2,39.0,0.5,1.0,0.0,0.0,1.0,
665,2,5,0,1,2,6,2,8,7,170.0,0.3333333333333333,1.1666666666666667,0.1388888888888889,0.5,3.0,
62,1,1,0,0,1,1,1,2,1,0.0,1.0,0.0,0.0,0.0,0.0,
20,1,1,0,0,1,1,1,2,1,0.0,1.0,0.0,0.0,0.0,0.0,
294,1,0,0,1,1,1,1,2,1,0.0,1.0,0.0,0.0,0.0,0.0,
276,3,3,0,1,3,4,3,7,6,21.0,0.75,2.25,0.6875,0.8333333333333333,1.75,
283,3,5,0,1,3,6,3,9,8,153.0,0.5,2.3333333333333335,0.2222222222222222,1.0,2.75,
451,1,0,0,1,1,1,1,2,1,0.0,1.0,0.0,0.0,0.0,0.0,
460,1,0,0,1,1,1,1,2,1,0.0,1.0,0.0,0.0,0.0,0.0,
329,3,1,0,0,3,1,3,4,3,39.0,3.0,3.0,0.0,1.5,0.375,
608,1,1,0,0,1,1,1,2,1,0.0,1.0,0.0,0.0,0.0,0.0,
263,2,1,0,0,2,1,2,3,2,7.0,2.0,2.0,0.0,1.0,0.5,
94,4,4,0,1,4,5,4,9,8,123.0,0.8,3.2,1.3599999999999999,0.9166666666666665,1.625,
404,1,1,0,1,1,2,1,3,2,27.0,0.5,1.0,0.0,0.0,1.0,
420,1,1,1,0,2,1,2,3,2,6.0,2.0,2.0,0.0,1.0,0.5,
306,1,1,0,0,1,1,1,2,1,0.0,1.0,0.0,0.0,0.0,0.0,
551,1,1,0,1,1,2,1,3,2,36.0,0.5,1.0,0.0,0.0,1.0,
171,1,1,0,0,1,1,1,2,1,0.0,1.0,0.0,0.0,0.0,0.0,
188,3,0,0,3,3,3,3,6,5,96.0,1.0,2.0,0.6666666666666666,0.8333333333333333,1.375,
762,1,1,0,0,1,1,1,2,1,0.0,1.0,0.0,0.0,0.0,0.0,
514,1,0,0,1,1,1,1,2,1,0.0,1.0,0.0,0.0,0.0,0.0,
647,2,2,0,0,2,2,2,4,3,62.0,1.0,1.5,0.25,0.5,1.0,
586,2,2,0,0,2,2,2,4,3,23.0,1.0,1.5,0.25,0.5,1.0,
65,1,0,0,1,1,1,1,2,1,0.0,1.0,0.0,0.0,0.0,0.0,
256,1,2,0,0,1,2,1,3,2,9.0,0.5,1.0,0.0,0.0,1.0,
370,0,0,1,1,1,1,1,2,1,0.0,1.0,0.0,0.0,0.0,0.0,
651,2,3,0,0,2,3,2,5,4,42.0,0.6666666666666666,2.0,0.0,1.0,1.5,
725,1,1,0,0,1,1,1,2,1,0.0,1.0,0.0,0.0,0.0,0.0,
633,2,1,0,1,2,2,2,4,3,236.0,1.0,2.0,0.0,1.0,1.0,
756,2,1,0,0,2,1,2,3,2,5.0,2.0,2.0,0.0,1.0,0.5,
155,1,1,0,1,1,2,1,3,2,2.0,0.5,1.0,0.0,0.0,1.0,
102,1,1,0,0,1,1,1,2,1,0.0,1.0,0.0,0.0,0.0,0.0,
677,2,1,0,2,2,3,2,5,4,72.0,0.6666666666666666,1.6666666666666667,0.2222222222222222,0.5,1.5,
169,5,3,0,1,5,4,4,9,8,191.0,1.25,3.0,0.5,0.9833333333333332,1.5,
340,4,2,0,2,4,4,3,8,7,209.0,1.0,2.75,0.1875,1.1666666666666665,1.625,
331,5,2,1,3,6,5,4,11,10,294.0,1.2,3.0,1.6,1.4166666666666665,1.75,
687,2,2,0,0,2,2,2,4,3,45.0,1.0,1.5,0.25,0.5,1.0,
902,2,2,0,0,2,2,2,4,3,34.0,1.0,1.5,0.25,0.5,1.0,
870,1,2,0,1,1,3,1,4,3,81.0,0.3333333333333333,1.0,0.0,0.0,1.5,
5,1,0,0,1,1,1,1,2,1,0.0,1.0,0.0,0.0,0.0,0.0,
738,3,1,0,0,3,1,3,4,3,94.0,3.0,3.0,0.0,1.5,0.375,
128,2,1,0,1,2,2,2,4,3,7.0,1.0,1.5,0.25,0.5,1.0,
334,1,2,0,0,1,2,1,3,2,1.0,0.5,1.0,0.0,0.0,1.0,
690,1,0,0,1,1,1,1,2,1,0.0,1.0,0.0,0.0,0.0,0.0,
757,2,2,0,0,2,2,2,4,3,125.0,1.0,1.5,0.25,0.5,1.0,
338,1,1,0,1,1,2,1,3,2,7.0,0.5,1.0,0.0,0.0,1.0,
358,0,1,1,0,1,1,1,2,1,0.0,1.0,0.0,0.0,0.0,0.0,
476,2,1,0,0,2,1,2,3,2,68.0,2.0,2.0,0.0,1.0,0.5,
295,2,2,0,1,2,3,2,5,4,107.0,0.6666666666666666,1.6666666666666667,0.2222222222222222,0.5,1.5,
829,1,2,0,0,1,2,1,3,2,66.0,0.5,1.0,0.0,0.0,1.0,
733,1,1,0,1,1,2,1,3,2,12.0,0.5,1.0,0.0,0.0,1.0,
54,1,1,0,0,1,1,1,2,1,0.0,1.0,0.0,0.0,0.0,0.0,
189,0,1,1,0,1,1,1,2,1,0.0,1.0,0.0,0.0,0.0,0.0,
266,1,1,0,0,1,1,1,2,1,0.0,1.0,0.0,0.0,0.0,0.0,
572,1,0,0,1,1,1,1,2,1,0.0,1.0,0.0,0.0,0.0,0.0,
43,1,1,0,0,1,1,1,2,1,0.0,1.0,0.0,0.0,0.0,0.0,
750,1,1,0,0,1,1,1,2,1,0.0,1.0,0.0,0.0,0.0,0.0,
303,1,3,0,0,1,3,1,4,3,83.0,0.3333333333333333,1.0,0.0,0.0,1.5,
165,0,1,1,0,1,1,1,2,1,0.0,1.0,0.0,0.0,0.0,0.0,
559,1,0,0,1,1,1,1,2,1,0.0,1.0,0.0,0.0,0.0,0.0,
889,0,0,1,1,1,1,1,2,1,0.0,1.0,0.0,0.0,0.0,0.0,
13,1,1,0,0,1,1,1,2,1,0.0,1.0,0.0,0.0,0.0,0.0,
371,1,0,0,2,1,2,1,3,2,19.0,0.5,1.0,0.0,0.0,1.0,
615,2,1,0,2,2,3,2,5,4,36.0,0.6666666666666666,1.3333333333333333,0.2222222222222222,0.5,1.5,
817,8,6,0,3,8,9,4,17,16,314.0,0.8888888888888888,2.7777777777777777,0.617283950617284,1.3166666666666664,3.5,
577,1,2,0,0,1,2,1,3,2,30.0,0.5,1.0,0.0,0.0,1.0,
85,3,1,0,1,3,2,3,5,4,181.0,1.5,3.0,0.0,1.5,0.75,
378,1,1,0,0,1,1,1,2,1,0.0,1.0,0.0,0.0,0.0,0.0,
224,2,0,0,1,2,1,2,3,2,65.0,2.0,2.0,0.0,1.0,0.5,
561,2,1,0,0,2,1,2,3,2,28.0,2.0,2.0,0.0,1.0,0.5,
335,4,1,0,0,4,1,4,5,4,126.0,4.0,4.0,0.0,1.8333333333333333,0.25,
496,2,2,0,1,2,3,2,5,4,218.0,0.6666666666666666,1.3333333333333333,0.2222222222222222,0.5,1.5,
175,1,1,0,0,1,1,1,2,1,0.0,1.0,0.0,0.0,0.0,0.0,
382,3,5,1,1,4,6,3,10,9,135.0,0.6666666666666666,2.5,0.25,1.1666666666666665,2.625,
852,1,0,0,1,1,1,1,2,1,0.0,1.0,0.0,0.0,0.0,0.0,
249,5,1,1,2,6,3,4,9,8,307.0,2.0,3.0,0.6666666666666666,0.9833333333333332,1.125,
356,3,3,0,1,3,4,3,7,6,84.0,0.75,2.0,0.5,0.8333333333333333,1.875,
385,2,1,0,0,2,1,2,3,2,14.0,2.0,2.0,0.0,1.0,0.5,
29,1,1,0,0,1,1,1,2,1,0.0,1.0,0.0,0.0,0.0,0.0,
604,1,1,0,0,1,1,1,2,1,0.0,1.0,0.0,0.0,0.0,0.0,
763,2,0,0,1,2,1,2,3,2,155.0,2.0,2.0,0.0,1.0,0.5,
891,1,1,0,1,1,2,1,3,2,11.0,0.5,1.0,0.0,0.0,1.0,
245,1,1,0,0,1,1,1,2,1,0.0,1.0,0.0,0.0,0.0,0.0,
4,6,2,1,0,7,2,7,9,8,247.0,3.5,6.5,0.25,1.9499999999999997,0.1484375,
810,5,7,0,0,5,7,4,12,11,202.0,0.7142857142857143,2.2857142857142856,1.0612244897959184,0.9833333333333334,3.0,
841,4,2,1,0,5,2,5,7,6,183.0,2.5,3.0,4.0,1.0333333333333332,0.65625,
208,1,1,0,1,1,2,1,3,2,1.0,0.5,1.0,0.0,0.0,1.0,
622,2,1,0,1,2,2,2,4,3,103.0,1.0,1.5,0.25,0.5,1.0,
562,1,2,0,0,1,2,1,3,2,1.0,0.5,1.0,0.0,0.0,1.0,
172,1,3,0,0,1,3,1,4,3,27.0,0.3333333333333333,1.0,0.0,0.0,1.5,
236,1,1,0,0,1,1,1,2,1,0.0,1.0,0.0,0.0,0.0,0.0,
42,1,0,0,1,1,1,1,2,1,0.0,1.0,0.0,0.0,0.0,0.0,
736,6,3,0,0,6,3,6,9,8,145.0,2.0,4.0,2.0,1.3666666666666667,0.84375,
394,5,6,0,2,5,8,4,13,12,250.0,0.625,3.375,0.234375,1.4999999999999998,2.625,
234,1,1,0,0,1,1,1,2,1,0.0,1.0,0.0,0.0,0.0,0.0,
412,1,2,0,0,1,2,1,3,2,10.0,0.5,1.0,0.0,0.0,1.0,
445,4,1,0,0,4,1,4,5,4,156.0,4.0,4.0,0.0,1.8333333333333333,0.25,
650,2,2,0,1,2,3,2,5,4,155.0,0.6666666666666666,1.3333333333333333,0.2222222222222222,0.5,1.5,
530,4,3,0,2,4,5,3,9,8,88.0,0.8,2.0,0.4,0.8333333333333333,2.375,
848,2,3,0,0,2,3,2,5,4,134.0,0.6666666666666666,2.0,0.0,1.0,1.5,
672,2,1,0,0,2,1,2,3,2,49.0,2.0,2.0,0.0,1.0,0.5,
784,1,1,0,0,1,1,1,2,1,0.0,1.0,0.0,0.0,0.0,0.0,
521,1,1,0,0,1,1,1,2,1,0.0,1.0,0.0,0.0,0.0,0.0,
657,1,1,0,0,1,1,1,2,1,0.0,1.0,0.0,0.0,0.0,0.0,
127,2,3,0,0,2,3,2,5,4,145.0,0.6666666666666666,1.3333333333333333,0.2222222222222222,0.5,1.5,
610,1,1,0,2,1,3,1,4,3,137.0,0.3333333333333333,1.0,0.0,0.0,1.5,
448,1,1,0,0,1,1,1,2,1,0.0,1.0,0.0,0.0,0.0,0.0,
440,1,0,0,1,1,1,1,2,1,0.0,1.0,0.0,0.0,0.0,0.0,
129,9,7,0,3,9,10,6,19,18,221.0,0.9,3.0,1.8,1.2452380952380953,3.71875,
501,1,1,0,1,1,2,1,3,2,15.0,0.5,1.0,0.0,0.0,1.0,
722,1,1,0,0,1,1,1,2,1,0.0,1.0,0.0,0.0,0.0,0.0,
893,1,1,0,0,1,1,1,2,1,0.0,1.0,0.0,0.0,0.0,0.0,
32,1,1,0,0,1,1,1,2,1,0.0,1.0,0.0,0.0,0.0,0.0,
553,1,1,0,0,1,1,1,2,1,0.0,1.0,0.0,0.0,0.0,0.0,
101,1,1,0,0,1,1,1,2,1,0.0,1.0,0.0,0.0,0.0,0.0,
759,2,4,0,0,2,4,2,6,5,316.0,0.5,1.5,0.25,0.5,2.0,
767,1,1,0,0,1,1,1,2,1,0.0,1.0,0.0,0.0,0.0,0.0,
308,1,0,0,1,1,1,1,2,1,0.0,1.0,0.0,0.0,0.0,0.0,
37,7,6,0,3,7,9,6,16,15,167.0,0.7777777777777778,4.222222222222222,1.0617283950617284,1.2333333333333332,2.1875,
290,1,1,0,0,1,1,1,2,1,0.0,1.0,0.0,0.0,0.0,0.0,
899,6,4,0,0,6,4,5,10,9,290.0,1.5,2.5,2.25,1.0333333333333332,1.65625,
278,1,1,0,0,1,1,1,2,1,0.0,1.0,0.0,0.0,0.0,0.0,
281,1,1,0,0,1,1,1,2,1,0.0,1.0,0.0,0.0,0.0,0.0,
816,3,1,0,1,3,2,3,5,4,135.0,1.5,2.5,0.25,1.0,0.875,
544,2,1,0,0,2,1,2,3,2,16.0,2.0,2.0,0.0,1.0,0.5,
519,7,4,0,0,7,4,6,11,10,262.0,1.75,4.25,4.1875,1.2666666666666666,0.9375,
885,2,2,0,0,2,2,2,4,3,24.0,1.0,1.5,0.25,0.5,1.0,
346,2,1,0,0,2,1,2,3,2,136.0,2.0,2.0,0.0,1.0,0.5,
182,1,1,0,0,1,1,1,2,1,0.0,1.0,0.0,0.0,0.0,0.0,
711,1,1,0,0,1,1,1,2,1,0.0,1.0,0.0,0.0,0.0,0.0,
613,1,1,0,0,1,1,1,2,1,0.0,1.0,0.0,0.0,0.0,0.0,
89,2,1,0,0,2,1,2,3,2,2.0,2.0,2.0,0.0,1.0,0.5,
508,2,1,0,0,2,1,2,3,2,16.0,2.0,2.0,0.0,1.0,0.5,
222,1,1,0,0,1,1,1,2,1,0.0,1.0,0.0,0.0,0.0,0.0,
614,1,1,0,0,1,1,1,2,1,0.0,1.0,0.0,0.0,0.0,0.0,
252,3,2,0,0,3,2,3,5,4,128.0,1.5,3.0,0.0,1.5,0.75,
558,2,0,0,1,2,1,2,3,2,47.0,2.0,2.0,0.0,1.0,0.5,
674,2,3,0,1,2,4,2,6,5,108.0,0.5,1.5,0.25,0.5,2.0,
510,2,4,0,0,2,4,2,6,5,114.0,0.5,1.5,0.25,0.5,2.0,
770,1,1,0,0,1,1,1,2,1,0.0,1.0,0.0,0.0,0.0,0.0,
270,2,2,0,1,2,3,2,5,4,25.0,0.6666666666666666,1.6666666666666667,0.2222222222222222,0.5,1.5,
433,1,0,0,1,1,1,1,2,1,0.0,1.0,0.0,0.0,0.0,0.0,
246,1,2,0,0,1,2,1,3,2,16.0,0.5,1.0,0.0,0.0,1.0,
267,1,2,0,1,1,3,1,4,3,115.0,0.3333333333333333,1.0,0.0,0.0,1.5,
86,1,1,0,1,1,2,1,3,2,6.0,0.5,1.0,0.0,0.0,1.0,
788,2,0,0,1,2,1,2,3,2,9.0,2.0,2.0,0.0,1.0,0.5,
113,1,2,0,0,1,2,1,3,2,33.0,0.5,1.0,0.0,0.0,1.0,
10,2,3,0,0,2,3,2,5,4,64.0,0.6666666666666666,2.0,0.0,1.0,1.5,
835,1,0,0,1,1,1,1,2,1,0.0,1.0,0.0,0.0,0.0,0.0,
226,1,1,0,0,1,1,1,2,1,0.0,1.0,0.0,0.0,0.0,0.0,
301,1,2,0,0,1,2,1,3,2,6.0,0.5,1.0,0.0,0.0,1.0,
771,1,1,0,0,1,1,1,2,1,0.0,1.0,0.0,0.0,0.0,0.0,
491,2,1,0,1,2,2,2,4,3,35.0,1.0,1.5,0.25,0.5,1.0,
552,1,1,0,0,1,1,1,2,1,0.0,1.0,0.0,0.0,0.0,0.0,
869,1,0,0,1,1,1,1,2,1,0.0,1.0,0.0,0.0,0.0,0.0,
40,2,0,0,1,2,1,2,3,2,101.0,2.0,2.0,0.0,1.0,0.5,
239,1,0,0,1,1,1,1,2,1,0.0,1.0,0.0,0.0,0.0,0.0,
649,7,6,0,4,7,10,4,17,16,159.0,0.7,3.0,0.8,1.4333333333333331,3.75,
108,1,2,0,0,1,2,1,3,2,10.0,0.5,1.0,0.0,0.0,1.0,
146,1,1,0,0,1,1,1,2,1,0.0,1.0,0.0,0.0,0.0,0.0,
14,5,3,0,1,5,4,5,9,8,228.0,1.25,4.25,1.6875,1.1666666666666665,0.96875,
730,1,1,0,1,1,2,1,3,2,46.0,0.5,1.0,0.0,0.0,1.0,
645,1,3,0,1,1,4,1,5,4,77.0,0.25,1.0,0.0,0.0,2.0,
773,1,1,0,0,1,1,1,2,1,0.0,1.0,0.0,0.0,0.0,0.0,
573,1,1,0,0,1,1,1,2,1,0.0,1.0,0.0,0.0,0.0,0.0,
917,1,1,0,0,1,1,1,2,1,0.0,1.0,0.0,0.0,0.0,0.0,
260,1,1,0,0,1,1,1,2,1,0.0,1.0,0.0,0.0,0.0,0.0,
325,1,0,0,1,1,1,1,2,1,0.0,1.0,0.0,0.0,0.0,0.0,
293,2,2,0,1,2,3,2,5,4,80.0,0.6666666666666666,1.3333333333333333,0.2222222222222222,0.5,1.5,
426,8,6,0,3,8,9,5,17,16,279.0,0.8888888888888888,3.6666666666666665,1.1111111111111114,1.4333333333333333,2.71875,
103,1,1,0,0,1,1,1,2,1,0.0,1.0,0.0,0.0,0.0,0.0,
416,9,11,0,2,9,13,6,22,21,590.0,0.6923076923076923,4.384615384615385,1.775147928994083,1.6333333333333333,3.0625,
503,1,1,0,0,1,1,1,2,1,0.0,1.0,0.0,0.0,0.0,0.0,
250,1,1,0,0,1,1,1,2,1,0.0,1.0,0.0,0.0,0.0,0.0,
353,11,5,0,1,11,6,7,17,16,428.0,1.8333333333333333,3.5,4.916666666666667,1.3984126984126983,2.0234375,
302,4,4,0,0,4,4,4,8,7,163.0,1.0,2.5,0.75,1.1666666666666665,1.75,
709,6,3,1,1,7,4,6,11,10,320.0,1.75,3.75,3.6875,1.2333333333333332,1.125,
68,1,1,0,0,1,1,1,2,1,0.0,1.0,0.0,0.0,0.0,0.0,
314,1,3,0,0,1,3,1,4,3,36.0,0.3333333333333333,1.0,0.0,0.0,1.5,
180,1,1,0,0,1,1,1,2,1,0.0,1.0,0.0,0.0,0.0,0.0,
591,1,1,0,0,1,1,1,2,1,0.0,1.0,0.0,0.0,0.0,0.0,
423,1,1,0,0,1,1,1,2,1,0.0,1.0,0.0,0.0,0.0,0.0,
594,3,6,0,1,3,7,3,10,9,347.0,0.42857142857142855,2.5714285714285716,0.24489795918367346,1.0,3.0,
675,1,3,0,0,1,3,1,4,3,82.0,0.3333333333333333,1.0,0.0,0.0,1.5,
123,2,1,0,1,2,2,2,4,3,57.0,1.0,1.5,0.25,0.5,1.0,
497,3,6,1,0,4,6,3,10,9,371.0,0.6666666666666666,2.6666666666666665,0.5555555555555556,1.1666666666666665,2.375,
291,3,1,0,0,3,1,3,4,3,26.0,3.0,3.0,0.0,1.5,0.375,
138,8,4,0,4,8,8,5,16,15,225.0,1.0,2.75,2.1875,1.069047619047619,2.90625,
728,1,1,0,0,1,1,1,2,1,0.0,1.0,0.0,0.0,0.0,0.0,
630,3,2,0,0,3,2,3,5,4,43.0,1.5,2.5,0.25,1.0,0.875,
555,4,2,0,1,4,3,4,7,6,82.0,1.3333333333333333,2.3333333333333335,1.5555555555555556,0.9166666666666666,1.25,
111,2,1,0,1,2,2,2,4,3,6.0,1.0,2.0,0.0,1.0,1.0,
31,7,3,0,6,7,9,6,16,15,302.0,0.7777777777777778,4.222222222222222,3.5061728395061724,1.2333333333333334,2.28125,
384,1,1,0,0,1,1,1,2,1,0.0,1.0,0.0,0.0,0.0,0.0,
359,3,3,0,1,3,4,3,7,6,306.0,0.75,2.75,0.1875,1.0,1.625,
288,1,3,0,0,1,3,1,4,3,125.0,0.3333333333333333,1.0,0.0,0.0,1.5,
701,1,1,0,0,1,1,1,2,1,0.0,1.0,0.0,0.0,0.0,0.0,
41,3,1,0,0,3,1,3,4,3,55.0,3.0,3.0,0.0,1.5,0.375,
747,2,1,0,1,2,2,2,4,3,107.0,1.0,1.5,0.25,0.5,1.0,
582,1,0,0,1,1,1,1,2,1,0.0,1.0,0.0,0.0,0.0,0.0,
179,1,1,0,0,1,1,1,2,1,0.0,1.0,0.0,0.0,0.0,0.0,
390,10,6,0,4,10,10,5,20,19,346.0,1.0,3.5,0.65,1.8333333333333335,3.15625,
707,2,1,0,0,2,1,2,3,2,5.0,2.0,2.0,0.0,1.0,0.5,
407,1,1,0,1,1,2,1,3,2,23.0,0.5,1.0,0.0,0.0,1.0,
569,2,1,0,0,2,1,2,3,2,115.0,2.0,2.0,0.0,1.0,0.5,
430,1,1,0,0,1,1,1,2,1,0.0,1.0,0.0,0.0,0.0,0.0,
192,1,1,0,0,1,1,1,2,1,0.0,1.0,0.0,0.0,0.0,0.0,
319,2,2,0,0,2,2,2,4,3,89.0,1.0,2.0,0.0,1.0,1.0,
204,1,1,0,0,1,1,1,2,1,0.0,1.0,0.0,0.0,0.0,0.0,
444,1,1,0,0,1,1,1,2,1,0.0,1.0,0.0,0.0,0.0,0.0,
828,2,0,0,2,2,2,2,4,3,76.0,1.0,2.0,0.0,1.0,1.0,
878,2,1,0,0,2,1,2,3,2,14.0,2.0,2.0,0.0,1.0,0.5,
461,1,1,0,0,1,1,1,2,1,0.0,1.0,0.0,0.0,0.0,0.0,
826,0,1,1,0,1,1,1,2,1,0.0,1.0,0.0,0.0,0.0,0.0,
58,1,1,0,0,1,1,1,2,1,0.0,1.0,0.0,0.0,0.0,0.0,
678,1,2,0,0,1,2,1,3,2,2.0,0.5,1.0,0.0,0.0,1.0,
458,2,2,0,0,2,2,2,4,3,125.0,1.0,2.0,0.0,1.0,1.0,
867,2,1,0,1,2,2,2,4,3,48.0,1.0,1.5,0.25,0.5,1.0,
836,1,3,0,0,1,3,1,4,3,55.0,0.3333333333333333,1.0,0.0,0.0,1.5,
200,1,1,0,0,1,1,1,2,1,0.0,1.0,0.0,0.0,0.0,0.0,
207,3,1,0,0,3,1,3,4,3,46.0,3.0,3.0,0.0,1.5,0.375,
726,1,1,0,2,1,3,1,4,3,70.0,0.3333333333333333,1.0,0.0,0.0,1.5,
648,6,5,1,2,7,7,4,14,13,366.0,1.0,2.4285714285714284,1.3877551020408163,1.1833333333333333,2.875,
556,3,1,0,1,3,2,3,5,4,129.0,1.5,3.0,0.0,1.5,0.75,
273,2,1,0,0,2,1,2,3,2,1.0,2.0,2.0,0.0,1.0,0.5,
163,0,0,1,1,1,1,1,2,1,0.0,1.0,0.0,0.0,0.0,0.0,
244,3,2,0,1,3,3,2,6,5,108.0,1.0,2.0,0.0,0.6666666666666666,1.5,
178,1,1,0,0,1,1,1,2,1,0.0,1.0,0.0,0.0,0.0,0.0,
333,1,1,0,1,1,2,1,3,2,25.0,0.5,1.0,0.0,0.0,1.0,
55,2,1,0,1,2,2,2,4,3,105.0,1.0,1.5,0.25,0.5,1.0,
300,1,1,0,0,1,1,1,2,1,0.0,1.0,0.0,0.0,0.0,0.0,
619,1,0,0,1,1,1,1,2,1,0.0,1.0,0.0,0.0,0.0,0.0,
484,1,3,0,0,1,3,1,4,3,84.0,0.3333333333333333,1.0,0.0,0.0,1.5,
511,3,1,0,0,3,1,3,4,3,84.0,3.0,3.0,0.0,1.5,0.375,
626,5,5,0,1,5,6,5,11,10,274.0,0.8333333333333334,2.8333333333333335,2.8055555555555554,1.0333333333333332,2.1875,
90,1,1,0,0,1,1,1,2,1,0.0,1.0,0.0,0.0,0.0,0.0,
355,2,1,0,0,2,1,2,3,2,67.0,2.0,2.0,0.0,1.0,0.5,
607,5,5,0,0,5,5,4,10,9,106.0,1.0,2.8,0.5599999999999999,0.9833333333333334,2.0,
104,6,10,0,0,6,10,6,16,15,408.0,0.6,2.6,3.6400000000000006,1.0666666666666667,3.8125,
705,2,2,0,0,2,2,2,4,3,30.0,1.0,2.0,0.0,1.0,1.0,
490,3,0,0,1,3,1,3,4,3,169.0,3.0,3.0,0.0,1.5,0.375,
872,1,1,0,0,1,1,1,2,1,0.0,1.0,0.0,0.0,0.0,0.0,
473,2,2,0,1,2,3,2,5,4,31.0,0.6666666666666666,1.6666666666666667,0.2222222222222222,0.5,1.5,
583,1,1,0,1,1,2,1,3,2,10.0,0.5,1.0,0.0,0.0,1.0,
468,3,3,0,0,3,3,3,6,5,50.0,1.0,2.0,0.6666666666666666,0.8333333333333333,1.375,
475,2,1,0,0,2,1,2,3,2,8.0,2.0,2.0,0.0,1.0,0.5,
202,1,2,0,0,1,2,1,3,2,109.0,0.5,1.0,0.0,0.0,1.0,
688,1,1,0,0,1,1,1,2,1,0.0,1.0,0.0,0.0,0.0,0.0,
612,2,2,0,0,2,2,2,4,3,60.0,1.0,2.0,0.0,1.0,1.0,
93,3,2,0,0,3,2,3,5,4,138.0,1.5,2.5,0.25,1.0,0.875,
492,5,5,0,2,5,7,3,12,11,154.0,0.7142857142857143,2.7142857142857144,0.2040816326530612,0.8999999999999999,2.875,
538,2,1,0,0,2,1,2,3,2,11.0,2.0,2.0,0.0,1.0,0.5,
221,1,0,0,1,1,1,1,2,1,0.0,1.0,0.0,0.0,0.0,0.0,
547,1,0,0,1,1,1,1,2,1,0.0,1.0,0.0,0.0,0.0,0.0,
744,1,1,0,0,1,1,1,2,1,0.0,1.0,0.0,0.0,0.0,0.0,
739,1,0,0,1,1,1,1,2,1,0.0,1.0,0.0,0.0,0.0,0.0,
310,1,0,0,1,1,1,1,2,1,0.0,1.0,0.0,0.0,0.0,0.0,
158,0,0,1,1,1,1,1,2,1,0.0,1.0,0.0,0.0,0.0,0.0,
78,1,0,0,1,1,1,1,2,1,0.0,1.0,0.0,0.0,0.0,0.0,
374,1,3,0,1,1,4,1,5,4,164.0,0.25,1.0,0.0,0.0,2.0,
345,1,1,0,0,1,1,1,2,1,0.0,1.0,0.0,0.0,0.0,0.0,
375,2,1,0,0,2,1,2,3,2,52.0,2.0,2.0,0.0,1.0,0.5,
446,1,1,0,0,1,1,1,2,1,0.0,1.0,0.0,0.0,0.0,0.0,
883,13,7,0,4,13,11,5,24,23,468.0,1.1818181818181819,3.3636363636363638,1.6859504132231407,1.6686507936507937,3.59375,
846,1,2,0,0,1,2,1,3,2,2.0,0.5,1.0,0.0,0.0,1.0,
215,2,0,0,1,2,1,2,3,2,24.0,2.0,2.0,0.0,1.0,0.5,
76,3,2,0,0,3,2,3,5,4,84.0,1.5,2.5,0.25,1.0,0.875,
585,1,3,0,0,1,3,1,4,3,82.0,0.3333333333333333,1.0,0.0,0.0,1.5,
151,3,1,0,1,3,2,2,5,4,77.0,1.5,2.0,0.0,0.6666666666666666,1.0,
504,1,1,0,0,1,1,1,2,1,0.0,1.0,0.0,0.0,0.0,0.0,
206,0,1,1,0,1,1,1,2,1,0.0,1.0,0.0,0.0,0.0,0.0,
838,1,0,0,1,1,1,1,2,1,0.0,1.0,0.0,0.0,0.0,0.0,
419,3,2,0,0,3,2,3,5,4,34.0,1.5,2.0,1.0,0.8333333333333333,0.875,
489,2,1,0,2,2,3,2,5,4,78.0,0.6666666666666666,2.0,0.0,1.0,1.5,
815,2,2,0,0,2,2,2,4,3,31.0,1.0,1.5,0.25,0.5,1.0,
839,2,1,0,1,2,2,2,4,3,162.0,1.0,2.0,0.0,1.0,1.0,
438,1,2,0,0,1,2,1,3,2,30.0,0.5,1.0,0.0,0.0,1.0,
592,1,1,0,0,1,1,1,2,1,0.0,1.0,0.0,0.0,0.0,0.0,
269,2,4,0,1,2,5,2,7,6,105.0,0.4,1.8,0.16000000000000006,0.5,2.5,
500,5,4,1,1,6,5,4,11,10,127.0,1.2,3.0,0.4,1.4166666666666665,1.875,
865,3,3,0,0,3,3,3,6,5,54.0,1.0,2.0,0.6666666666666666,0.8333333333333333,1.375,
720,7,6,0,1,7,7,4,14,13,178.0,1.0,3.0,1.7142857142857142,1.4333333333333333,2.375,
478,1,1,0,1,1,2,1,3,2,3.0,0.5,1.0,0.0,0.0,1.0,
92,2,1,0,1,2,2,2,4,3,59.0,1.0,1.5,0.25,0.5,1.0,
533,1,2,0,0,1,2,1,3,2,39.0,0.5,1.0,0.0,0.0,1.0,
166,1,1,0,0,1,1,1,2,1,0.0,1.0,0.0,0.0,0.0,0.0,
790,1,1,0,0,1,1,1,2,1,0.0,1.0,0.0,0.0,0.0,0.0,
686,1,1,0,0,1,1,1,2,1,0.0,1.0,0.0,0.0,0.0,0.0,
667,2,1,0,0,2,1,2,3,2,20.0,2.0,2.0,0.0,1.0,0.5,
261,2,1,0,1,2,2,2,4,3,99.0,1.0,1.5,0.25,0.5,1.0,
471,1,0,0,2,1,2,1,3,2,17.0,0.5,1.0,0.0,0.0,1.0,
477,1,0,0,1,1,1,1,2,1,0.0,1.0,0.0,0.0,0.0,0.0,
309,1,1,0,0,1,1,1,2,1,0.0,1.0,0.0,0.0,0.0,0.0,
540,2,2,0,0,2,2,2,4,3,46.0,1.0,2.0,0.0,1.0,1.0,
847,1,2,0,0,1,2,1,3,2,0.0,0.5,1.0,0.0,0.0,1.0,
116,1,1,0,0,1,1,1,2,1,0.0,1.0,0.0,0.0,0.0,0.0,
126,1,0,0,1,1,1,1,2,1,0.0,1.0,0.0,0.0,0.0,0.0,
571,3,0,0,1,3,1,3,4,3,88.0,3.0,3.0,0.0,1.5,0.375,
808,1,1,0,0,1,1,1,2,1,0.0,1.0,0.0,0.0,0.0,0.0,
272,6,4,0,1,6,5,5,11,10,257.0,1.2,2.6,2.64,1.0333333333333332,1.90625,
436,2,2,1,0,3,2,3,5,4,40.0,1.5,3.0,0.0,1.5,0.75,
706,0,1,1,0,1,1,1,2,1,0.0,1.0,0.0,0.0,0.0,0.0,
819,3,6,0,0,3,6,2,9,8,294.0,0.5,1.5,0.25,0.6666666666666666,3.0,
729,1,0,0,1,1,1,1,2,1,0.0,1.0,0.0,0.0,0.0,0.0,
587,11,11,0,2,11,13,6,24,23,419.0,0.8461538461538461,3.6923076923076925,1.4437869822485205,1.9999999999999998,3.9375,
806,1,1,1,0,2,1,2,3,2,13.0,2.0,2.0,0.0,1.0,0.5,
824,1,1,0,1,1,2,1,3,2,5.0,0.5,1.0,0.0,0.0,1.0,
311,5,4,0,0,5,4,4,9,8,183.0,1.25,2.25,1.1875,0.9833333333333334,1.75,
81,1,1,0,0,1,1,1,2,1,0.0,1.0,0.0,0.0,0.0,0.0,
112,1,1,0,0,1,1,1,2,1,0.0,1.0,0.0,0.0,0.0,0.0,
606,3,3,0,0,3,3,3,6,5,154.0,1.0,2.0,0.6666666666666666,0.8333333333333333,1.375,
348,2,4,0,1,2,5,2,7,6,69.0,0.4,1.8,0.16000000000000006,0.5,2.5,
593,3,1,0,0,3,1,3,4,3,44.0,3.0,3.0,0.0,1.5,0.375,
264,1,1,0,0,1,1,1,2,1,0.0,1.0,0.0,0.0,0.0,0.0,
57,1,1,0,0,1,1,1,2,1,0.0,1.0,0.0,0.0,0.0,0.0,
882,2,3,0,0,2,3,2,5,4,57.0,0.6666666666666666,1.3333333333333333,0.2222222222222222,0.5,1.5,
641,2,1,0,1,2,2,2,4,3,18.0,1.0,1.5,0.25,0.5,1.0,
498,1,0,0,1,1,1,1,2,1,0.0,1.0,0.0,0.0,0.0,0.0,
635,1,1,0,0,1,1,1,2,1,0.0,1.0,0.0,0.0,0.0,0.0,
879,3,4,0,0,3,4,3,7,6,219.0,0.75,2.5,0.25,1.0,1.75,
160,3,3,0,3,3,6,2,9,8,175.0,0.5,1.8333333333333333,0.13888888888888887,0.6666666666666666,3.0,
700,3,2,0,0,3,2,3,5,4,126.0,1.5,2.0,1.0,0.8333333333333333,0.875,
699,1,2,0,0,1,2,1,3,2,28.0,0.5,1.0,0.0,0.0,1.0,
517,1,1,0,0,1,1,1,2,1,0.0,1.0,0.0,0.0,0.0,0.0,
389,4,4,0,0,4,4,4,8,7,171.0,1.0,2.5,1.25,0.9166666666666666,1.625,
259,1,0,0,1,1,1,1,2,1,0.0,1.0,0.0,0.0,0.0,0.0,
324,1,1,0,0,1,1,1,2,1,0.0,1.0,0.0,0.0,0.0,0.0,
284,1,0,1,1,2,1,2,3,2,184.0,2.0,2.0,0.0,1.0,0.5,
243,3,2,0,0,3,2,3,5,4,41.0,1.5,2.5,0.25,1.0,0.875,
313,2,1,1,1,3,2,3,5,4,72.0,1.5,2.5,0.25,1.0,0.875,
716,1,1,0,0,1,1,1,2,1,0.0,1.0,0.0,0.0,0.0,0.0,
16,1,1,0,0,1,1,1,2,1,0.0,1.0,0.0,0.0,0.0,0.0,
411,1,1,0,0,1,1,1,2,1,0.0,1.0,0.0,0.0,0.0,0.0,
98,1,1,0,0,1,1,1,2,1,0.0,1.0,0.0,0.0,0.0,0.0,
801,10,7,0,4,10,11,6,21,20,288.0,0.9090909090909091,3.8181818181818183,2.876033057851239,1.5785714285714285,3.34375,
39,1,2,0,0,1,2,1,3,2,38.0,0.5,1.0,0.0,0.0,1.0,
751,1,2,0,0,1,2,1,3,2,24.0,0.5,1.0,0.0,0.0,1.0,
908,1,0,0,2,1,2,1,3,2,63.0,0.5,1.0,0.0,0.0,1.0,
876,1,3,0,1,1,4,1,5,4,64.0,0.25,1.0,0.0,0.0,2.0,
131,1,2,0,0,1,2,1,3,2,129.0,0.5,1.0,0.0,0.0,1.0,
242,1,1,0,0,1,1,1,2,1,0.0,1.0,0.0,0.0,0.0,0.0,
229,1,1,0,1,1,2,1,3,2,35.0,0.5,1.0,0.0,0.0,1.0,
1,1,0,0,1,1,1,1,2,1,0.0,1.0,0.0,0.0,0.0,0.0,
463,1,0,0,1,1,1,1,2,1,0.0,1.0,0.0,0.0,0.0,0.0,
380,6,6,0,2,6,8,4,14,13,344.0,0.75,2.625,0.984375,1.2333333333333332,3.25,
177,0,2,1,1,1,3,1,4,3,33.0,0.3333333333333333,1.0,0.0,0.0,1.5,
50,1,1,0,0,1,1,1,2,1,0.0,1.0,0.0,0.0,0.0,0.0,
721,1,1,0,0,1,1,1,2,1,0.0,1.0,0.0,0.0,0.0,0.0,
392,1,2,0,0,1,2,1,3,2,2.0,0.5,1.0,0.0,0.0,1.0,
44,8,3,0,1,8,4,6,12,11,612.0,2.0,4.75,1.1875,1.4333333333333333,0.78125,
760,4,2,0,1,4,3,3,7,6,129.0,1.3333333333333333,2.3333333333333335,0.22222222222222224,0.8333333333333333,1.375,
366,1,1,0,1,1,2,1,3,2,27.0,0.5,1.0,0.0,0.0,1.0,
797,1,0,0,1,1,1,1,2,1,0.0,1.0,0.0,0.0,0.0,0.0,
695,1,2,0,0,1,2,1,3,2,46.0,0.5,1.0,0.0,0.0,1.0,
522,1,1,0,0,1,1,1,2,1,0.0,1.0,0.0,0.0,0.0,0.0,
862,5,3,0,0,5,3,5,8,7,79.0,1.6666666666666667,4.0,0.6666666666666666,1.4166666666666665,0.78125,
710,7,4,0,1,7,5,5,12,11,400.0,1.4,3.0,1.6,1.2333333333333334,1.90625,
890,1,1,0,0,1,1,1,2,1,0.0,1.0,0.0,0.0,0.0,0.0,
69,1,1,0,0,1,1,1,2,1,0.0,1.0,0.0,0.0,0.0,0.0,
387,1,1,0,0,1,1,1,2,1,0.0,1.0,0.0,0.0,0.0,0.0,
702,1,0,0,1,1,1,1,2,1,0.0,1.0,0.0,0.0,0.0,0.0,
268,1,1,0,0,1,1,1,2,1,0.0,1.0,0.0,0.0,0.0,0.0,
332,2,2,0,0,2,2,2,4,3,105.0,1.0,2.0,0.0,1.0,1.0,
364,1,1,0,0,1,1,1,2,1,0.0,1.0,0.0,0.0,0.0,0.0,
74,1,1,0,0,1,1,1,2,1,0.0,1.0,0.0,0.0,0.0,0.0,
135,2,3,0,1,2,4,2,6,5,92.0,0.5,1.25,0.1875,0.5,2.0,
459,7,6,0,0,7,6,6,13,12,271.0,1.1666666666666667,4.0,1.6666666666666667,1.4333333333333333,1.625,
660,3,5,0,0,3,5,3,8,7,247.0,0.6,2.0,0.4,0.8333333333333333,2.375,
659,1,1,0,0,1,1,1,2,1,0.0,1.0,0.0,0.0,0.0,0.0,
679,5,2,0,0,5,2,5,7,6,189.0,2.5,3.0,4.0,1.0333333333333332,0.65625,
541,3,0,0,2,3,2,3,5,4,211.0,1.5,2.5,0.25,1.0,0.875,
662,1,0,0,1,1,1,1,2,1,0.0,1.0,0.0,0.0,0.0,0.0,
64,1,1,0,0,1,1,1,2,1,0.0,1.0,0.0,0.0,0.0,0.0,
523,9,11,0,3,9,14,5,23,22,362.0,0.6428571428571429,3.142857142857143,1.836734693877551,1.469047619047619,4.84375,
833,2,1,0,0,2,1,2,3,2,18.0,2.0,2.0,0.0,1.0,0.5,
792,1,1,0,0,1,1,1,2,1,0.0,1.0,0.0,0.0,0.0,0.0,
528,1,1,0,0,1,1,1,2,1,0.0,1.0,0.0,0.0,0.0,0.0,
703,1,2,0,0,1,2,1,3,2,37.0,0.5,1.0,0.0,0.0,1.0,
383,1,1,0,0,1,1,1,2,1,0.0,1.0,0.0,0.0,0.0,0.0,
8,1,3,0,0,1,3,1,4,3,118.0,0.3333333333333333,1.0,0.0,0.0,1.5,
60,2,2,0,0,2,2,2,4,3,47.0,1.0,1.5,0.25,0.5,1.0,
778,1,1,0,0,1,1,1,2,1,0.0,1.0,0.0,0.0,0.0,0.0,
21,2,1,0,0,2,1,2,3,2,6.0,2.0,2.0,0.0,1.0,0.5,
376,1,1,0,0,1,1,1,2,1,0.0,1.0,0.0,0.0,0.0,0.0,
286,1,1,1,0,2,1,2,3,2,14.0,2.0,2.0,0.0,1.0,0.5,
512,5,2,0,1,5,3,4,8,7,193.0,1.6666666666666667,3.6666666666666665,0.22222222222222224,1.5,0.875,
918,2,7,0,2,2,9,2,11,10,151.0,0.2222222222222222,1.2222222222222223,0.17283950617283947,0.5,4.5,
881,1,1,0,0,1,1,1,2,1,0.0,1.0,0.0,0.0,0.0,0.0,
800,4,4,0,0,4,4,4,8,7,176.0,1.0,3.0,1.5,0.9166666666666665,1.375,
474,5,4,0,1,5,5,3,10,9,70.0,1.0,1.8,0.9600000000000002,0.8999999999999999,2.25,
787,1,1,0,0,1,1,1,2,1,0.0,1.0,0.0,0.0,0.0,0.0,
122,2,2,1,0,3,2,3,5,4,54.0,1.5,2.0,1.0,0.8333333333333333,0.875,
422,2,2,0,0,2,2,2,4,3,163.0,1.0,1.5,0.25,0.5,1.0,
789,1,0,0,1,1,1,1,2,1,0.0,1.0,0.0,0.0,0.0,0.0,
464,5,3,0,1,5,4,3,9,8,187.0,1.25,2.5,0.25,0.9,1.75,
493,5,4,0,0,5,4,5,9,8,317.0,1.25,3.5,1.25,1.1666666666666665,1.28125,
693,1,1,0,0,1,1,1,2,1,0.0,1.0,0.0,0.0,0.0,0.0,
417,2,0,0,1,2,1,2,3,2,51.0,2.0,2.0,0.0,1.0,0.5,
139,2,1,0,0,2,1,2,3,2,43.0,2.0,2.0,0.0,1.0,0.5,
212,1,2,0,1,1,3,1,4,3,76.0,0.3333333333333333,1.0,0.0,0.0,1.5,
150,3,1,0,2,3,3,3,6,5,162.0,1.0,2.3333333333333335,0.22222222222222224,1.0,1.375,
681,1,1,0,0,1,1,1,2,1,0.0,1.0,0.0,0.0,0.0,0.0,
271,6,3,0,2,6,5,6,11,10,403.0,1.2,3.2,3.7599999999999993,1.0666666666666667,1.59375,
507,1,3,1,0,2,3,2,5,4,107.0,0.6666666666666666,1.3333333333333333,0.2222222222222222,0.5,1.5,
718,1,1,0,0,1,1,1,2,1,0.0,1.0,0.0,0.0,0.0,0.0,
516,2,0,0,1,2,1,2,3,2,8.0,2.0,2.0,0.0,1.0,0.5,
856,2,2,0,1,2,3,2,5,4,111.0,0.6666666666666666,1.3333333333333333,0.2222222222222222,0.5,1.5,
395,3,1,0,0,3,1,3,4,3,115.0,3.0,3.0,0.0,1.5,0.375,
812,1,2,0,1,1,3,1,4,3,43.0,0.3333333333333333,1.0,0.0,0.0,1.5,
637,9,6,0,0,9,6,9,15,14,351.0,1.5,7.0,8.0,1.3940476190476188,0.8203125,
465,3,7,0,2,3,9,3,12,11,305.0,0.3333333333333333,1.6666666666666667,0.6666666666666666,0.8333333333333333,4.25,
896,1,1,0,0,1,1,1,2,1,0.0,1.0,0.0,0.0,0.0,0.0,
161,1,1,0,0,1,1,1,2,1,0.0,1.0,0.0,0.0,0.0,0.0,
719,1,1,0,0,1,1,1,2,1,0.0,1.0,0.0,0.0,0.0,0.0,
570,1,1,0,0,1,1,1,2,1,0.0,1.0,0.0,0.0,0.0,0.0,
795,1,1,0,0,1,1,1,2,1,0.0,1.0,0.0,0.0,0.0,0.0,
761,1,1,0,0,1,1,1,2,1,0.0,1.0,0.0,0.0,0.0,0.0,
106,4,2,0,1,4,3,3,7,6,71.0,1.3333333333333333,2.3333333333333335,0.22222222222222224,0.8333333333333333,1.375,
354,1,1,0,0,1,1,1,2,1,0.0,1.0,0.0,0.0,0.0,0.0,
907,2,2,0,0,2,2,2,4,3,38.0,1.0,2.0,0.0,1.0,1.0,
537,1,1,0,0,1,1,1,2,1,0.0,1.0,0.0,0.0,0.0,0.0,
141,1,1,0,0,1,1,1,2,1,0.0,1.0,0.0,0.0,0.0,0.0,
646,3,2,0,1,3,3,3,6,5,100.0,1.0,2.0,0.6666666666666666,0.8333333333333333,1.375,
620,4,3,0,3,4,6,3,10,9,139.0,0.6666666666666666,1.6666666666666667,0.5555555555555556,0.8333333333333333,2.875,
287,2,1,0,0,2,1,2,3,2,24.0,2.0,2.0,0.0,1.0,0.5,
752,2,3,0,0,2,3,2,5,4,87.0,0.6666666666666666,1.6666666666666667,0.2222222222222222,0.5,1.5,
629,2,1,0,0,2,1,2,3,2,43.0,2.0,2.0,0.0,1.0,0.5,
343,1,1,0,0,1,1,1,2,1,0.0,1.0,0.0,0.0,0.0,0.0,
360,5,5,0,1,5,6,3,11,10,163.0,0.8333333333333334,2.0,0.6666666666666666,0.9,2.75,
114,2,2,0,0,2,2,2,4,3,102.0,1.0,2.0,0.0,1.0,1.0,
216,3,1,0,2,3,3,3,6,5,37.0,1.0,2.0,0.6666666666666666,0.8333333333333333,1.375,
119,3,1,0,1,3,2,3,5,4,77.0,1.5,2.5,0.25,1.0,0.875,
774,1,0,0,2,1,2,1,3,2,40.0,0.5,1.0,0.0,0.0,1.0,
661,2,1,0,0,2,1,2,3,2,23.0,2.0,2.0,0.0,1.0,0.5,
671,1,4,0,0,1,4,1,5,4,165.0,0.25,1.0,0.0,0.0,2.0,
855,1,0,0,1,1,1,1,2,1,0.0,1.0,0.0,0.0,0.0,0.0,
888,1,0,0,1,1,1,1,2,1,0.0,1.0,0.0,0.0,0.0,0.0,
749,3,2,0,2,3,4,3,7,6,71.0,0.75,2.0,0.5,0.8333333333333333,1.875,
149,1,1,0,0,1,1,1,2,1,0.0,1.0,0.0,0.0,0.0,0.0,
823,2,2,0,0,2,2,2,4,3,76.0,1.0,1.5,0.25,0.5,1.0,
618,4,0,0,1,4,1,4,5,4,113.0,4.0,4.0,0.0,1.8333333333333333,0.25,
455,1,1,0,1,1,2,1,3,2,33.0,0.5,1.0,0.0,0.0,1.0,
769,2,3,0,0,2,3,2,5,4,58.0,0.6666666666666666,1.6666666666666667,0.2222222222222222,0.5,1.5,
527,3,3,0,0,3,3,3,6,5,145.0,1.0,1.6666666666666667,0.888888888888889,0.8333333333333333,1.375,
692,1,1,0,0,1,1,1,2,1,0.0,1.0,0.0,0.0,0.0,0.0,
513,1,2,0,0,1,2,1,3,2,50.0,0.5,1.0,0.0,0.0,1.0,
831,3,5,0,0,3,5,2,8,7,99.0,0.6,1.4,0.24,0.6666666666666666,2.5,
405,1,0,0,1,1,1,1,2,1,0.0,1.0,0.0,0.0,0.0,0.0,
133,1,2,0,0,1,2,1,3,2,76.0,0.5,1.0,0.0,0.0,1.0,
240,3,1,0,2,3,3,3,6,5,82.0,1.0,1.6666666666666667,0.888888888888889,0.8333333333333333,1.375,
764,2,6,1,0,3,6,2,9,8,123.0,0.5,1.3333333333333333,0.22222222222222224,0.6666666666666666,3.0,
397,2,1,0,1,2,2,2,4,3,159.0,1.0,1.5,0.25,0.5,1.0,
434,1,1,0,0,1,1,1,2,1,0.0,1.0,0.0,0.0,0.0,0.0,
72,1,1,0,0,1,1,1,2,1,0.0,1.0,0.0,0.0,0.0,0.0,
350,2,3,0,0,2,3,2,5,4,88.0,0.6666666666666666,1.6666666666666667,0.2222222222222222,0.5,1.5,
793,6,3,1,1,7,4,5,11,10,131.0,1.75,3.25,1.1875,1.069047619047619,1.40625,
11,1,2,0,0,1,2,1,3,2,39.0,0.5,1.0,0.0,0.0,1.0,
663,1,1,0,0,1,1,1,2,1,0.0,1.0,0.0,0.0,0.0,0.0,
843,3,6,1,2,4,8,2,12,11,223.0,0.5,1.75,0.1875,1.0,4.0,
305,8,3,0,2,8,5,6,13,12,158.0,1.6,3.4,2.64,1.1023809523809522,1.59375,
873,2,0,0,2,2,2,2,4,3,45.0,1.0,1.5,0.25,0.5,1.0,
579,1,0,0,1,1,1,1,2,1,0.0,1.0,0.0,0.0,0.0,0.0,
777,2,2,0,0,2,2,2,4,3,117.0,1.0,1.5,0.25,0.5,1.0,
402,1,4,0,1,1,5,1,6,5,124.0,0.2,1.0,0.0,0.0,2.5,
23,2,2,0,0,2,2,2,4,3,122.0,1.0,2.0,0.0,1.0,1.0,
682,1,1,0,0,1,1,1,2,1,0.0,1.0,0.0,0.0,0.0,0.0,
193,2,2,1,0,3,2,3,5,4,79.0,1.5,2.0,1.0,0.8333333333333333,0.875,
201,3,1,0,1,3,2,3,5,4,90.0,1.5,2.5,0.25,1.0,0.875,
174,9,11,0,4,9,15,6,24,23,389.0,0.6,3.7333333333333334,1.9288888888888887,1.6,4.21875,
144,10,9,1,4,11,13,5,24,23,408.0,0.8461538461538461,3.3076923076923075,1.289940828402367,1.8023809523809524,4.3125,
584,1,1,0,0,1,1,1,2,1,0.0,1.0,0.0,0.0,0.0,0.0,
121,1,1,0,0,1,1,1,2,1,0.0,1.0,0.0,0.0,0.0,0.0,
913,1,1,0,0,1,1,1,2,1,0.0,1.0,0.0,0.0,0.0,0.0,
532,2,2,0,0,2,2,2,4,3,27.0,1.0,2.0,0.0,1.0,1.0,
743,1,0,0,1,1,1,1,2,1,0.0,1.0,0.0,0.0,0.0,0.0,
427,0,1,1,0,1,1,1,2,1,0.0,1.0,0.0,0.0,0.0,0.0,
148,1,0,0,1,1,1,1,2,1,0.0,1.0,0.0,0.0,0.0,0.0,
12,1,1,0,1,1,2,1,3,2,27.0,0.5,1.0,0.0,0.0,1.0,
689,1,1,0,0,1,1,1,2,1,0.0,1.0,0.0,0.0,0.0,0.0,
381,1,0,0,1,1,1,1,2,1,0.0,1.0,0.0,0.0,0.0,0.0,
470,1,2,0,0,1,2,1,3,2,57.0,0.5,1.0,0.0,0.0,1.0,
