ObID,HRI,HRL,LRI,LRL,Internals,Leaves,Height,Vertices,Size,Duration,RatioIL,MeanBar,StdBar,Beta1,Beta2,
27,1,2,0,1,1,3,1,4,3,28.0,0.3333333333333333,1.0,0.0,0.0,1.5,
566,2,5,0,1,2,6,2,8,7,145.0,0.3333333333333333,1.1666666666666667,0.13888888888888887,0.5,3.0,
125,1,1,0,0,1,1,1,2,1,0.0,1.0,0.0,0.0,0.0,0.0,
490,0,1,1,0,1,1,1,2,1,0.0,1.0,0.0,0.0,0.0,0.0,
160,2,0,1,2,3,2,3,5,4,74.0,1.5,2.5,0.25,1.0,0.875,
398,2,1,0,4,2,5,2,7,6,61.0,0.4,1.4,0.24,0.5,2.5,
493,2,0,0,4,2,4,2,6,5,64.0,0.5,1.25,0.1875,0.5,2.0,
615,1,0,0,1,1,1,1,2,1,0.0,1.0,0.0,0.0,0.0,0.0,
51,1,1,0,0,1,1,1,2,1,0.0,1.0,0.0,0.0,0.0,0.0,
669,1,0,0,5,1,5,1,6,5,100.0,0.2,1.0,0.0,0.0,2.5,
32,1,1,0,0,1,1,1,2,1,0.0,1.0,0.0,0.0,0.0,0.0,
58,0,1,1,0,1,1,1,2,1,0.0,1.0,0.0,0.0,0.0,0.0,
637,1,1,1,1,2,2,2,4,3,23.0,1.0,2.0,0.0,1.0,1.0,
6,1,2,1,0,2,2,2,4,3,80.0,1.0,1.5,0.25,0.5,1.0,
107,1,1,0,2,1,3,1,4,3,58.0,0.3333333333333333,1.0,0.0,0.0,1.5,
18,1,1,0,1,1,2,1,3,2,15.0,0.5,1.0,0.0,0.0,1.0,
463,1,0,0,1,1,1,1,2,1,0.0,1.0,0.0,0.0,0.0,0.0,
606,1,1,0,0,1,1,1,2,1,0.0,1.0,0.0,0.0,0.0,0.0,
422,3,1,0,1,3,2,3,5,4,90.0,1.5,3.0,0.0,1.5,0.75,
475,4,2,0,3,4,5,3,9,8,196.0,0.8,2.0,0.8,1.1666666666666665,2.25,
118,1,1,0,0,1,1,1,2,1,0.0,1.0,0.0,0.0,0.0,0.0,
670,1,0,0,2,1,2,1,3,2,30.0,0.5,1.0,0.0,0.0,1.0,
581,1,1,0,0,1,1,1,2,1,0.0,1.0,0.0,0.0,0.0,0.0,
541,4,1,0,2,4,3,4,7,6,226.0,1.3333333333333333,2.3333333333333335,1.5555555555555556,0.9166666666666665,1.25,
128,1,1,0,2,1,3,1,4,3,10.0,0.3333333333333333,1.0,0.0,0.0,1.5,
444,11,3,4,15,15,18,7,33,32,395.0,0.8333333333333334,4.444444444444445,2.0246913580246915,1.788095238095238,4.1796875,
256,2,1,0,1,2,2,2,4,3,30.0,1.0,1.5,0.25,0.5,1.0,
521,2,1,0,1,2,2,2,4,3,21.0,1.0,1.5,0.25,0.5,1.0,
687,34,23,3,37,37,60,10,97,96,861.0,0.6166666666666667,7.333333333333333,4.78888888888889,3.7061688311688314,5.20703125,
609,1,0,0,1,1,1,1,2,1,0.0,1.0,0.0,0.0,0.0,0.0,
124,1,1,1,1,2,2,2,4,3,127.0,1.0,2.0,0.0,1.0,1.0,
683,2,0,0,2,2,2,2,4,3,11.0,1.0,1.5,0.25,0.5,1.0,
196,2,0,0,1,2,1,2,3,2,14.0,2.0,2.0,0.0,1.0,0.5,
126,3,1,1,1,4,2,4,6,5,92.0,2.0,3.5,0.25,1.3333333333333333,0.625,
91,1,1,0,0,1,1,1,2,1,0.0,1.0,0.0,0.0,0.0,0.0,
450,2,2,0,0,2,2,2,4,3,39.0,1.0,1.5,0.25,0.5,1.0,
255,2,1,0,2,2,3,2,5,4,70.0,0.6666666666666666,1.3333333333333333,0.2222222222222222,0.5,1.5,
677,4,0,0,4,4,4,4,8,7,128.0,1.0,2.5,1.25,0.9166666666666666,1.625,
82,1,0,1,2,2,2,2,4,3,47.0,1.0,2.0,0.0,1.0,1.0,
452,1,0,0,1,1,1,1,2,1,0.0,1.0,0.0,0.0,0.0,0.0,
172,1,0,0,1,1,1,1,2,1,0.0,1.0,0.0,0.0,0.0,0.0,
407,1,0,0,1,1,1,1,2,1,0.0,1.0,0.0,0.0,0.0,0.0,
367,1,1,0,0,1,1,1,2,1,0.0,1.0,0.0,0.0,0.0,0.0,
691,1,1,0,2,1,3,1,4,3,31.0,0.3333333333333333,1.0,0.0,0.0,1.5,
144,1,1,0,0,1,1,1,2,1,0.0,1.0,0.0,0.0,0.0,0.0,
48,2,0,0,2,2,2,2,4,3,43.0,1.0,2.0,0.0,1.0,1.0,
202,1,0,0,1,1,1,1,2,1,0.0,1.0,0.0,0.0,0.0,0.0,
368,2,0,0,2,2,2,2,4,3,54.0,1.0,1.5,0.25,0.5,1.0,
678,1,0,0,1,1,1,1,2,1,0.0,1.0,0.0,0.0,0.0,0.0,
573,6,8,0,4,6,12,3,18,17,381.0,0.5,1.8333333333333333,0.9722222222222223,1.0999999999999999,5.375,
376,5,4,0,3,5,7,4,12,11,209.0,0.7142857142857143,3.4285714285714284,0.5306122448979592,1.1666666666666665,2.25,
580,1,0,0,1,1,1,1,2,1,0.0,1.0,0.0,0.0,0.0,0.0,
577,2,1,0,2,2,3,2,5,4,37.0,0.6666666666666666,1.6666666666666667,0.2222222222222222,0.5,1.5,
28,0,0,1,2,1,2,1,3,2,0.0,0.5,1.0,0.0,0.0,1.0,
387,0,0,1,1,1,1,1,2,1,0.0,1.0,0.0,0.0,0.0,0.0,
522,2,2,1,2,3,4,3,7,6,222.0,0.75,3.0,0.0,1.5,1.5,
485,1,1,1,0,2,1,2,3,2,11.0,2.0,2.0,0.0,1.0,0.5,
213,4,1,0,7,4,8,4,12,11,107.0,0.5,2.75,1.4375,0.9166666666666665,3.0,
243,6,7,0,9,6,16,4,22,21,273.0,0.375,2.875,0.609375,1.4166666666666665,6.125,
629,6,5,0,2,6,7,5,13,12,173.0,0.8571428571428571,2.7142857142857144,1.63265306122449,1.0333333333333332,2.78125,
437,1,1,0,1,1,2,1,3,2,48.0,0.5,1.0,0.0,0.0,1.0,
201,1,1,0,1,1,2,1,3,2,4.0,0.5,1.0,0.0,0.0,1.0,
482,1,0,0,1,1,1,1,2,1,0.0,1.0,0.0,0.0,0.0,0.0,
302,13,10,2,10,15,20,5,35,34,412.0,0.75,3.25,1.7875,2.0392857142857146,6.78125,
99,1,2,0,0,1,2,1,3,2,41.0,0.5,1.0,0.0,0.0,1.0,
627,3,3,0,1,3,4,3,7,6,112.0,0.75,2.5,0.25,1.0,1.75,
423,1,1,0,0,1,1,1,2,1,0.0,1.0,0.0,0.0,0.0,0.0,
88,1,1,0,3,1,4,1,5,4,21.0,0.25,1.0,0.0,0.0,2.0,
46,1,1,0,0,1,1,1,2,1,0.0,1.0,0.0,0.0,0.0,0.0,
537,1,0,0,1,1,1,1,2,1,0.0,1.0,0.0,0.0,0.0,0.0,
622,1,1,0,2,1,3,1,4,3,39.0,0.3333333333333333,1.0,0.0,0.0,1.5,
294,16,6,0,10,16,16,8,32,31,412.0,1.0,5.1875,2.90234375,1.9876984126984127,2.875,
169,1,1,1,0,2,1,2,3,2,44.0,2.0,2.0,0.0,1.0,0.5,
109,2,1,0,0,2,1,2,3,2,22.0,2.0,2.0,0.0,1.0,0.5,
260,1,0,0,1,1,1,1,2,1,0.0,1.0,0.0,0.0,0.0,0.0,
608,2,2,0,0,2,2,2,4,3,55.0,1.0,1.5,0.25,0.5,1.0,
131,3,3,0,1,3,4,2,7,6,61.0,0.75,1.5,0.25,0.6666666666666666,2.0,
321,1,1,0,0,1,1,1,2,1,0.0,1.0,0.0,0.0,0.0,0.0,
592,1,0,0,1,1,1,1,2,1,0.0,1.0,0.0,0.0,0.0,0.0,
90,2,1,0,2,2,3,2,5,4,78.0,0.6666666666666666,1.3333333333333333,0.2222222222222222,0.5,1.5,
150,5,1,2,5,7,6,6,13,12,244.0,1.1666666666666667,4.666666666666667,0.5555555555555555,1.6166666666666665,1.15625,
199,0,0,1,1,1,1,1,2,1,0.0,1.0,0.0,0.0,0.0,0.0,
513,3,1,0,4,3,5,2,8,7,94.0,0.6,1.6,0.24,0.6666666666666666,2.5,
286,5,1,0,2,5,3,5,8,7,68.0,1.6666666666666667,2.3333333333333335,3.555555555555556,1.0333333333333332,1.15625,
157,3,2,0,1,3,3,3,6,5,78.0,1.0,2.0,0.6666666666666666,0.8333333333333333,1.375,
478,1,0,0,1,1,1,1,2,1,0.0,1.0,0.0,0.0,0.0,0.0,
486,2,0,0,3,2,3,2,5,4,61.0,0.6666666666666666,2.0,0.0,1.0,1.5,
419,1,2,0,1,1,3,1,4,3,18.0,0.3333333333333333,1.0,0.0,0.0,1.5,
209,1,0,0,3,1,3,1,4,3,20.0,0.3333333333333333,1.0,0.0,0.0,1.5,
571,1,0,0,1,1,1,1,2,1,0.0,1.0,0.0,0.0,0.0,0.0,
563,1,0,0,2,1,2,1,3,2,21.0,0.5,1.0,0.0,0.0,1.0,
548,1,0,0,1,1,1,1,2,1,0.0,1.0,0.0,0.0,0.0,0.0,
383,1,0,0,1,1,1,1,2,1,0.0,1.0,0.0,0.0,0.0,0.0,
362,3,1,0,1,3,2,2,5,4,16.0,1.5,2.0,0.0,0.6666666666666666,1.0,
262,3,2,1,3,4,5,4,9,8,119.0,0.8,2.8,0.96,1.1666666666666665,2.0,
205,7,3,1,8,8,11,6,19,18,326.0,0.7272727272727273,4.363636363636363,2.231404958677686,1.4333333333333333,2.5,
364,1,0,0,1,1,1,1,2,1,0.0,1.0,0.0,0.0,0.0,0.0,
519,3,0,1,3,4,3,4,7,6,163.0,1.3333333333333333,2.0,2.0,0.9166666666666666,1.25,
323,1,1,0,0,1,1,1,2,1,0.0,1.0,0.0,0.0,0.0,0.0,
276,0,0,1,2,1,2,1,3,2,7.0,0.5,1.0,0.0,0.0,1.0,
73,7,1,0,7,7,8,4,15,14,188.0,0.875,2.5,0.75,1.1833333333333336,3.375,
363,1,0,0,1,1,1,1,2,1,0.0,1.0,0.0,0.0,0.0,0.0,
396,2,0,1,2,3,2,3,5,4,89.0,1.5,2.0,1.0,0.8333333333333333,0.875,
182,2,0,2,1,4,1,4,5,4,223.0,4.0,4.0,0.0,1.8333333333333333,0.25,
353,1,0,0,2,1,2,1,3,2,11.0,0.5,1.0,0.0,0.0,1.0,
461,1,1,0,0,1,1,1,2,1,0.0,1.0,0.0,0.0,0.0,0.0,
9,1,1,0,1,1,2,1,3,2,103.0,0.5,1.0,0.0,0.0,1.0,
492,1,1,0,0,1,1,1,2,1,0.0,1.0,0.0,0.0,0.0,0.0,
164,0,0,1,1,1,1,1,2,1,0.0,1.0,0.0,0.0,0.0,0.0,
87,1,0,0,1,1,1,1,2,1,0.0,1.0,0.0,0.0,0.0,0.0,
379,1,1,0,0,1,1,1,2,1,0.0,1.0,0.0,0.0,0.0,0.0,
111,1,6,1,0,2,6,2,8,7,86.0,0.3333333333333333,1.3333333333333333,0.22222222222222224,0.5,3.0,
86,0,0,1,1,1,1,1,2,1,0.0,1.0,0.0,0.0,0.0,0.0,
401,1,0,0,1,1,1,1,2,1,0.0,1.0,0.0,0.0,0.0,0.0,
97,1,1,0,0,1,1,1,2,1,0.0,1.0,0.0,0.0,0.0,0.0,
247,1,0,0,2,1,2,1,3,2,39.0,0.5,1.0,0.0,0.0,1.0,
103,1,0,0,1,1,1,1,2,1,0.0,1.0,0.0,0.0,0.0,0.0,
451,1,2,0,1,1,3,1,4,3,42.0,0.3333333333333333,1.0,0.0,0.0,1.5,
361,1,0,0,1,1,1,1,2,1,0.0,1.0,0.0,0.0,0.0,0.0,
36,16,7,2,12,18,19,9,37,36,786.0,0.9473684210526315,4.684210526315789,4.637119113573408,1.9874098124098125,4.275390625,
179,5,4,0,4,5,8,4,13,12,74.0,0.625,2.375,0.734375,0.9833333333333334,3.5,
330,1,1,1,1,2,2,2,4,3,136.0,1.0,1.5,0.25,0.5,1.0,
129,2,0,0,3,2,3,2,5,4,5.0,0.6666666666666666,1.3333333333333333,0.2222222222222222,0.5,1.5,
644,1,0,0,1,1,1,1,2,1,0.0,1.0,0.0,0.0,0.0,0.0,
11,3,3,0,0,3,3,3,6,5,50.0,1.0,3.0,0.0,1.5,1.125,
273,1,0,0,2,1,2,1,3,2,50.0,0.5,1.0,0.0,0.0,1.0,
173,5,3,0,6,5,9,5,14,13,275.0,0.5555555555555556,3.7777777777777777,0.3950617283950617,1.4166666666666665,2.53125,
512,1,2,0,1,1,3,1,4,3,67.0,0.3333333333333333,1.0,0.0,0.0,1.5,
480,2,1,0,4,2,5,2,7,6,72.0,0.4,1.4,0.24,0.5,2.5,
191,1,1,1,0,2,1,2,3,2,59.0,2.0,2.0,0.0,1.0,0.5,
258,1,1,2,2,3,3,3,6,5,66.0,1.0,1.6666666666666667,0.888888888888889,0.8333333333333333,1.375,
562,1,1,0,1,1,2,1,3,2,17.0,0.5,1.0,0.0,0.0,1.0,
384,1,0,0,1,1,1,1,2,1,0.0,1.0,0.0,0.0,0.0,0.0,
445,1,2,0,0,1,2,1,3,2,13.0,0.5,1.0,0.0,0.0,1.0,
574,1,1,0,1,1,2,1,3,2,18.0,0.5,1.0,0.0,0.0,1.0,
263,1,1,0,1,1,2,1,3,2,97.0,0.5,1.0,0.0,0.0,1.0,
531,1,0,1,2,2,2,2,4,3,86.0,1.0,1.5,0.25,0.5,1.0,
409,0,1,1,0,1,1,1,2,1,0.0,1.0,0.0,0.0,0.0,0.0,
551,1,0,0,2,1,2,1,3,2,22.0,0.5,1.0,0.0,0.0,1.0,
331,4,3,1,5,5,8,3,13,12,168.0,0.625,1.75,0.4375,1.0833333333333333,3.875,
545,0,0,1,3,1,3,1,4,3,67.0,0.3333333333333333,1.0,0.0,0.0,1.5,
583,3,1,0,5,3,6,3,9,8,120.0,0.5,2.3333333333333335,0.5555555555555556,0.8333333333333333,2.625,
305,1,1,0,3,1,4,1,5,4,42.0,0.25,1.0,0.0,0.0,2.0,
659,5,5,4,11,9,16,6,25,24,280.0,0.5625,3.0,2.375,1.4357142857142855,5.8125,
459,3,5,0,4,3,9,3,12,11,221.0,0.3333333333333333,2.7777777777777777,0.1728395061728395,1.0,3.625,
60,3,3,1,0,4,3,4,7,6,50.0,1.3333333333333333,2.3333333333333335,1.5555555555555554,0.9166666666666666,1.25,
249,1,1,0,0,1,1,1,2,1,0.0,1.0,0.0,0.0,0.0,0.0,
193,2,1,0,1,2,2,2,4,3,29.0,1.0,1.5,0.25,0.5,1.0,
346,1,0,0,1,1,1,1,2,1,0.0,1.0,0.0,0.0,0.0,0.0,
50,2,2,0,1,2,3,2,5,4,71.0,0.6666666666666666,1.3333333333333333,0.2222222222222222,0.5,1.5,
417,6,9,1,6,7,15,6,22,21,295.0,0.4666666666666667,3.533333333333333,3.1822222222222223,1.2333333333333332,4.5625,
675,2,1,0,1,2,2,2,4,3,135.0,1.0,2.0,0.0,1.0,1.0,
487,4,6,0,3,4,9,3,13,12,216.0,0.4444444444444444,1.6666666666666667,0.4444444444444444,0.8333333333333333,4.375,
127,2,1,0,1,2,2,2,4,3,26.0,1.0,2.0,0.0,1.0,1.0,
400,3,2,1,5,4,7,2,11,10,136.0,0.5714285714285714,1.7142857142857142,0.20408163265306126,1.0,3.5,
585,1,0,0,1,1,1,1,2,1,0.0,1.0,0.0,0.0,0.0,0.0,
215,2,1,0,0,2,1,2,3,2,3.0,2.0,2.0,0.0,1.0,0.5,
30,1,0,0,1,1,1,1,2,1,0.0,1.0,0.0,0.0,0.0,0.0,
561,1,0,0,1,1,1,1,2,1,0.0,1.0,0.0,0.0,0.0,0.0,
300,1,1,0,1,1,2,1,3,2,81.0,0.5,1.0,0.0,0.0,1.0,
543,0,1,1,0,1,1,1,2,1,0.0,1.0,0.0,0.0,0.0,0.0,
261,2,1,0,1,2,2,2,4,3,77.0,1.0,1.5,0.25,0.5,1.0,
268,1,0,0,1,1,1,1,2,1,0.0,1.0,0.0,0.0,0.0,0.0,
148,1,0,0,1,1,1,1,2,1,0.0,1.0,0.0,0.0,0.0,0.0,
405,1,0,0,1,1,1,1,2,1,0.0,1.0,0.0,0.0,0.0,0.0,
149,2,3,0,1,2,4,2,6,5,68.0,0.5,1.5,0.25,0.5,2.0,
558,1,0,0,1,1,1,1,2,1,0.0,1.0,0.0,0.0,0.0,0.0,
654,2,1,0,4,2,5,2,7,6,93.0,0.4,1.4,0.24,0.5,2.5,
395,2,2,1,2,3,4,3,7,6,147.0,0.75,2.0,1.0,0.8333333333333333,1.75,
651,1,1,0,0,1,1,1,2,1,0.0,1.0,0.0,0.0,0.0,0.0,
547,2,0,2,2,4,2,4,6,5,475.0,2.0,3.5,0.25,1.3333333333333333,0.625,
630,2,1,0,1,2,2,2,4,3,6.0,1.0,1.5,0.25,0.5,1.0,
110,18,9,3,21,21,30,13,51,50,638.0,0.7,7.866666666666666,16.182222222222226,1.7352675102675101,4.2158203125,
43,1,0,0,1,1,1,1,2,1,0.0,1.0,0.0,0.0,0.0,0.0,
78,2,1,0,5,2,6,2,8,7,98.0,0.3333333333333333,1.1666666666666667,0.13888888888888887,0.5,3.0,
232,1,0,0,1,1,1,1,2,1,0.0,1.0,0.0,0.0,0.0,0.0,
206,1,3,0,0,1,3,1,4,3,27.0,0.3333333333333333,1.0,0.0,0.0,1.5,
214,0,1,1,0,1,1,1,2,1,0.0,1.0,0.0,0.0,0.0,0.0,
666,2,2,1,4,3,6,3,9,8,225.0,0.5,2.0,0.6666666666666666,0.8333333333333333,2.75,
425,1,0,0,1,1,1,1,2,1,0.0,1.0,0.0,0.0,0.0,0.0,
418,1,0,0,2,1,2,1,3,2,37.0,0.5,1.0,0.0,0.0,1.0,
696,0,0,1,1,1,1,1,2,1,0.0,1.0,0.0,0.0,0.0,0.0,
239,0,0,1,1,1,1,1,2,1,0.0,1.0,0.0,0.0,0.0,0.0,
104,1,0,0,1,1,1,1,2,1,0.0,1.0,0.0,0.0,0.0,0.0,
295,1,0,0,1,1,1,1,2,1,0.0,1.0,0.0,0.0,0.0,0.0,
198,13,8,2,15,15,23,12,38,37,778.0,0.6521739130434783,7.521739130434782,8.94517958412098,1.5314213564213566,2.56591796875,
307,1,1,0,0,1,1,1,2,1,0.0,1.0,0.0,0.0,0.0,0.0,
645,1,1,1,0,2,1,2,3,2,96.0,2.0,2.0,0.0,1.0,0.5,
230,2,0,0,1,2,1,2,3,2,36.0,2.0,2.0,0.0,1.0,0.5,
676,1,1,0,1,1,2,1,3,2,12.0,0.5,1.0,0.0,0.0,1.0,
428,1,1,2,1,3,2,2,5,4,97.0,1.5,2.0,0.0,0.6666666666666666,1.0,
686,1,2,1,1,2,3,2,5,4,21.0,0.6666666666666666,1.6666666666666667,0.2222222222222222,0.5,1.5,
12,10,0,1,9,11,9,5,20,19,401.0,1.2222222222222223,2.888888888888889,1.432098765432099,1.8023809523809524,3.5625,
653,1,0,0,2,1,2,1,3,2,10.0,0.5,1.0,0.0,0.0,1.0,
464,1,1,0,0,1,1,1,2,1,0.0,1.0,0.0,0.0,0.0,0.0,
159,2,1,0,2,2,3,2,5,4,48.0,0.6666666666666666,1.6666666666666667,0.2222222222222222,0.5,1.5,
370,1,2,0,1,1,3,1,4,3,128.0,0.3333333333333333,1.0,0.0,0.0,1.5,
530,1,1,0,0,1,1,1,2,1,0.0,1.0,0.0,0.0,0.0,0.0,
390,2,1,0,0,2,1,2,3,2,65.0,2.0,2.0,0.0,1.0,0.5,
53,1,0,0,2,1,2,1,3,2,6.0,0.5,1.0,0.0,0.0,1.0,
546,1,2,0,2,1,4,1,5,4,84.0,0.25,1.0,0.0,0.0,2.0,
271,1,1,1,1,2,2,2,4,3,270.0,1.0,1.5,0.25,0.5,1.0,
371,1,1,0,1,1,2,1,3,2,10.0,0.5,1.0,0.0,0.0,1.0,
165,1,1,0,0,1,1,1,2,1,0.0,1.0,0.0,0.0,0.0,0.0,
391,1,0,0,2,1,2,1,3,2,65.0,0.5,1.0,0.0,0.0,1.0,
632,5,1,0,6,5,7,5,12,11,207.0,0.7142857142857143,3.4285714285714284,2.816326530612245,1.0333333333333332,2.09375,
525,3,2,0,2,3,4,3,7,6,171.0,0.75,1.75,0.6875,0.8333333333333333,1.875,
250,1,1,0,0,1,1,1,2,1,0.0,1.0,0.0,0.0,0.0,0.0,
142,1,1,0,0,1,1,1,2,1,0.0,1.0,0.0,0.0,0.0,0.0,
38,1,1,0,1,1,2,1,3,2,1.0,0.5,1.0,0.0,0.0,1.0,
119,3,1,0,1,3,2,2,5,4,74.0,1.5,2.0,0.0,0.6666666666666666,1.0,
47,6,5,0,8,6,13,4,19,18,231.0,0.46153846153846156,2.6923076923076925,0.9822485207100594,1.4166666666666665,5.125,
240,2,3,1,0,3,3,2,6,5,91.0,1.0,1.6666666666666667,0.2222222222222222,0.6666666666666666,1.5,
140,4,1,0,2,4,3,4,7,6,65.0,1.3333333333333333,2.3333333333333335,1.5555555555555556,0.9166666666666665,1.25,
528,0,1,1,0,1,1,1,2,1,0.0,1.0,0.0,0.0,0.0,0.0,
166,4,1,0,4,4,5,3,9,8,80.0,0.8,2.0,0.8,0.8333333333333333,2.25,
310,3,1,0,4,3,5,3,8,7,133.0,0.6,1.6,0.64,0.8333333333333333,2.375,
80,1,2,0,0,1,2,1,3,2,33.0,0.5,1.0,0.0,0.0,1.0,
446,2,0,2,2,4,2,4,6,5,303.0,2.0,4.0,0.0,1.8333333333333333,0.5,
575,1,0,0,1,1,1,1,2,1,0.0,1.0,0.0,0.0,0.0,0.0,
576,1,0,0,1,1,1,1,2,1,0.0,1.0,0.0,0.0,0.0,0.0,
156,0,0,1,1,1,1,1,2,1,0.0,1.0,0.0,0.0,0.0,0.0,
532,2,1,0,1,2,2,2,4,3,128.0,1.0,2.0,0.0,1.0,1.0,
114,1,1,0,2,1,3,1,4,3,75.0,0.3333333333333333,1.0,0.0,0.0,1.5,
553,2,1,0,1,2,2,2,4,3,31.0,1.0,1.5,0.25,0.5,1.0,
507,3,4,1,3,4,7,3,11,10,131.0,0.5714285714285714,1.5714285714285714,0.5306122448979591,0.8333333333333333,3.375,
133,1,0,0,2,1,2,1,3,2,43.0,0.5,1.0,0.0,0.0,1.0,
141,1,0,0,1,1,1,1,2,1,0.0,1.0,0.0,0.0,0.0,0.0,
174,5,1,0,3,5,4,4,9,8,86.0,1.25,2.0,1.5,0.9833333333333334,1.75,
188,1,0,0,1,1,1,1,2,1,0.0,1.0,0.0,0.0,0.0,0.0,
570,0,0,1,1,1,1,1,2,1,0.0,1.0,0.0,0.0,0.0,0.0,
652,1,0,0,1,1,1,1,2,1,0.0,1.0,0.0,0.0,0.0,0.0,
288,1,1,0,0,1,1,1,2,1,0.0,1.0,0.0,0.0,0.0,0.0,
85,1,1,0,0,1,1,1,2,1,0.0,1.0,0.0,0.0,0.0,0.0,
555,2,0,0,2,2,2,2,4,3,26.0,1.0,2.0,0.0,1.0,1.0,
278,2,5,0,2,2,7,2,9,8,61.0,0.2857142857142857,1.8571428571428572,0.12244897959183675,0.5,3.5,
649,4,1,0,1,4,2,4,6,5,116.0,2.0,3.0,1.0,1.1666666666666665,0.75,
132,5,2,1,4,6,6,4,12,11,151.0,1.0,2.1666666666666665,1.472222222222222,1.4166666666666665,2.5,
633,1,1,0,1,1,2,1,3,2,22.0,0.5,1.0,0.0,0.0,1.0,
328,2,1,1,0,3,1,3,4,3,133.0,3.0,3.0,0.0,1.5,0.375,
195,0,0,1,1,1,1,1,2,1,0.0,1.0,0.0,0.0,0.0,0.0,
595,1,3,0,1,1,4,1,5,4,79.0,0.25,1.0,0.0,0.0,2.0,
447,1,1,0,2,1,3,1,4,3,86.0,0.3333333333333333,1.0,0.0,0.0,1.5,
665,0,1,1,0,1,1,1,2,1,0.0,1.0,0.0,0.0,0.0,0.0,
661,1,0,0,1,1,1,1,2,1,0.0,1.0,0.0,0.0,0.0,0.0,
542,1,1,0,0,1,1,1,2,1,0.0,1.0,0.0,0.0,0.0,0.0,
185,1,0,0,1,1,1,1,2,1,0.0,1.0,0.0,0.0,0.0,0.0,
220,1,1,0,1,1,2,1,3,2,53.0,0.5,1.0,0.0,0.0,1.0,
254,0,0,1,1,1,1,1,2,1,0.0,1.0,0.0,0.0,0.0,0.0,
375,1,0,0,1,1,1,1,2,1,0.0,1.0,0.0,0.0,0.0,0.0,
96,1,0,0,2,1,2,1,3,2,7.0,0.5,1.0,0.0,0.0,1.0,
623,15,8,3,9,18,17,13,35,34,807.0,1.0588235294117647,5.705882352941177,11.854671280276815,1.6341380841380841,3.3526611328125,
94,17,12,7,25,24,37,12,61,60,1367.0,0.6486486486486487,6.216216216216216,6.2235208181154125,2.3756132756132757,5.3681640625,
293,0,0,2,1,2,1,2,3,2,43.0,2.0,2.0,0.0,1.0,0.5,
322,16,10,2,17,18,27,8,45,44,517.0,0.6666666666666666,4.37037037037037,2.603566529492456,1.9195526695526695,6.6640625,
71,1,1,0,1,1,2,1,3,2,52.0,0.5,1.0,0.0,0.0,1.0,
266,1,2,0,1,1,3,1,4,3,10.0,0.3333333333333333,1.0,0.0,0.0,1.5,
514,2,2,0,1,2,3,2,5,4,252.0,0.6666666666666666,1.3333333333333333,0.2222222222222222,0.5,1.5,
227,1,1,0,1,1,2,1,3,2,10.0,0.5,1.0,0.0,0.0,1.0,
39,3,2,0,2,3,4,2,7,6,54.0,0.75,1.75,0.1875,0.6666666666666666,2.0,
516,1,0,0,2,1,2,1,3,2,56.0,0.5,1.0,0.0,0.0,1.0,
98,1,0,0,1,1,1,1,2,1,0.0,1.0,0.0,0.0,0.0,0.0,
225,3,1,0,2,3,3,3,6,5,36.0,1.0,1.6666666666666667,0.888888888888889,0.8333333333333333,1.375,
55,5,4,1,3,6,7,4,13,12,199.0,0.8571428571428571,2.5714285714285716,0.5306122448979592,0.9833333333333334,3.0,
671,9,5,0,9,9,14,7,23,22,582.0,0.6428571428571429,5.214285714285714,1.7397959183673462,1.633333333333333,2.296875,
404,1,0,0,1,1,1,1,2,1,0.0,1.0,0.0,0.0,0.0,0.0,
424,0,0,1,1,1,1,1,2,1,0.0,1.0,0.0,0.0,0.0,0.0,
246,1,1,0,0,1,1,1,2,1,0.0,1.0,0.0,0.0,0.0,0.0,
403,6,3,1,10,7,13,4,20,19,486.0,0.5384615384615384,2.923076923076923,0.5325443786982249,1.4833333333333332,4.875,
641,1,1,0,1,1,2,1,3,2,47.0,0.5,1.0,0.0,0.0,1.0,
170,5,4,0,2,5,6,4,11,10,150.0,0.8333333333333334,2.6666666666666665,1.5555555555555554,1.1666666666666665,2.25,
694,18,7,4,12,22,19,10,41,40,499.0,1.1578947368421053,5.947368421052632,7.207756232686982,2.7099206349206346,3.08203125,
625,2,2,0,0,2,2,2,4,3,29.0,1.0,1.5,0.25,0.5,1.0,
155,7,3,0,5,7,8,5,15,14,256.0,0.875,3.5,0.75,1.2333333333333334,2.53125,
552,0,0,1,1,1,1,1,2,1,0.0,1.0,0.0,0.0,0.0,0.0,
650,0,0,1,1,1,1,1,2,1,0.0,1.0,0.0,0.0,0.0,0.0,
349,1,1,1,0,2,1,2,3,2,11.0,2.0,2.0,0.0,1.0,0.5,
177,10,4,1,9,11,13,6,24,23,265.0,0.8461538461538461,4.384615384615385,0.6982248520710059,2.3333333333333335,2.875,
2,1,1,0,0,1,1,1,2,1,0.0,1.0,0.0,0.0,0.0,0.0,
344,4,2,0,2,4,4,3,8,7,78.0,1.0,2.0,0.5,0.8333333333333333,1.875,
66,1,1,0,0,1,1,1,2,1,0.0,1.0,0.0,0.0,0.0,0.0,
7,1,1,0,0,1,1,1,2,1,0.0,1.0,0.0,0.0,0.0,0.0,
347,1,1,0,0,1,1,1,2,1,0.0,1.0,0.0,0.0,0.0,0.0,
33,1,1,0,1,1,2,1,3,2,0.0,0.5,1.0,0.0,0.0,1.0,
317,1,0,0,1,1,1,1,2,1,0.0,1.0,0.0,0.0,0.0,0.0,
511,11,11,0,5,11,16,5,27,26,240.0,0.6875,3.25,1.1875,1.7119047619047618,5.4375,
458,2,1,0,0,2,1,2,3,2,5.0,2.0,2.0,0.0,1.0,0.5,
567,1,2,0,3,1,5,1,6,5,65.0,0.2,1.0,0.0,0.0,2.5,
275,1,0,0,2,1,2,1,3,2,1.0,0.5,1.0,0.0,0.0,1.0,
314,1,0,0,1,1,1,1,2,1,0.0,1.0,0.0,0.0,0.0,0.0,
554,1,0,0,1,1,1,1,2,1,0.0,1.0,0.0,0.0,0.0,0.0,
470,1,0,0,1,1,1,1,2,1,0.0,1.0,0.0,0.0,0.0,0.0,
476,1,1,0,1,1,2,1,3,2,51.0,0.5,1.0,0.0,0.0,1.0,
234,1,1,0,1,1,2,1,3,2,1.0,0.5,1.0,0.0,0.0,1.0,
236,1,1,0,2,1,3,1,4,3,75.0,0.3333333333333333,1.0,0.0,0.0,1.5,
408,1,0,0,2,1,2,1,3,2,22.0,0.5,1.0,0.0,0.0,1.0,
520,1,1,0,0,1,1,1,2,1,0.0,1.0,0.0,0.0,0.0,0.0,
602,2,0,0,3,2,3,2,5,4,49.0,0.6666666666666666,1.3333333333333333,0.2222222222222222,0.5,1.5,
372,17,10,2,12,19,22,10,41,40,633.0,0.8636363636363636,5.590909090909091,7.150826446280993,2.189357864357864,4.158203125,
360,1,0,0,1,1,1,1,2,1,0.0,1.0,0.0,0.0,0.0,0.0,
270,1,0,0,1,1,1,1,2,1,0.0,1.0,0.0,0.0,0.0,0.0,
4,1,1,0,0,1,1,1,2,1,0.0,1.0,0.0,0.0,0.0,0.0,
359,2,1,0,1,2,2,2,4,3,32.0,1.0,1.5,0.25,0.5,1.0,
449,2,2,0,1,2,3,2,5,4,95.0,0.6666666666666666,2.0,0.0,1.0,1.5,
197,2,1,1,1,3,2,2,5,4,55.0,1.5,2.0,0.0,0.6666666666666666,1.0,
667,2,1,1,3,3,4,2,7,6,60.0,0.75,1.75,0.1875,0.6666666666666666,2.0,
672,1,0,0,1,1,1,1,2,1,0.0,1.0,0.0,0.0,0.0,0.0,
604,1,0,0,2,1,2,1,3,2,37.0,0.5,1.0,0.0,0.0,1.0,
343,0,0,1,1,1,1,1,2,1,0.0,1.0,0.0,0.0,0.0,0.0,
345,4,2,0,3,4,5,4,9,8,185.0,0.8,2.8,0.96,0.9166666666666666,1.875,
287,1,0,0,1,1,1,1,2,1,0.0,1.0,0.0,0.0,0.0,0.0,
607,1,0,0,2,1,2,1,3,2,9.0,0.5,1.0,0.0,0.0,1.0,
308,1,0,0,2,1,2,1,3,2,43.0,0.5,1.0,0.0,0.0,1.0,
414,1,0,0,2,1,2,1,3,2,109.0,0.5,1.0,0.0,0.0,1.0,
568,1,0,0,1,1,1,1,2,1,0.0,1.0,0.0,0.0,0.0,0.0,
589,1,1,0,0,1,1,1,2,1,0.0,1.0,0.0,0.0,0.0,0.0,
208,2,1,0,3,2,4,2,6,5,218.0,0.5,1.25,0.1875,0.5,2.0,
524,2,0,0,1,2,1,2,3,2,9.0,2.0,2.0,0.0,1.0,0.5,
699,1,0,0,1,1,1,1,2,1,0.0,1.0,0.0,0.0,0.0,0.0,
10,7,6,4,9,11,15,7,26,25,326.0,0.7333333333333333,3.3333333333333335,1.8222222222222222,1.5547619047619046,5.2421875,
203,19,13,3,26,22,39,10,61,60,694.0,0.5641025641025641,4.6923076923076925,5.700197238658778,2.3902597402597405,9.255859375,
373,1,0,0,1,1,1,1,2,1,0.0,1.0,0.0,0.0,0.0,0.0,
402,2,1,0,0,2,1,2,3,2,19.0,2.0,2.0,0.0,1.0,0.5,
673,2,1,0,1,2,2,2,4,3,45.0,1.0,1.5,0.25,0.5,1.0,
44,1,0,0,1,1,1,1,2,1,0.0,1.0,0.0,0.0,0.0,0.0,
610,1,0,0,1,1,1,1,2,1,0.0,1.0,0.0,0.0,0.0,0.0,
369,3,2,0,0,3,2,3,5,4,102.0,1.5,2.0,1.0,0.8333333333333333,0.875,
238,5,4,2,7,7,11,5,18,17,329.0,0.6363636363636364,3.1818181818181817,1.0578512396694217,1.4833333333333332,3.78125,
508,1,0,0,1,1,1,1,2,1,0.0,1.0,0.0,0.0,0.0,0.0,
462,3,0,0,3,3,3,3,6,5,90.0,1.0,1.6666666666666667,0.888888888888889,0.8333333333333333,1.375,
69,2,1,0,1,2,2,2,4,3,13.0,1.0,1.5,0.25,0.5,1.0,
386,0,0,1,1,1,1,1,2,1,0.0,1.0,0.0,0.0,0.0,0.0,
115,1,1,0,0,1,1,1,2,1,0.0,1.0,0.0,0.0,0.0,0.0,
680,1,1,0,1,1,2,1,3,2,7.0,0.5,1.0,0.0,0.0,1.0,
550,3,3,0,3,3,6,3,9,8,202.0,0.5,2.5,0.25,1.0,2.625,
56,2,4,1,1,3,5,3,8,7,180.0,0.6,1.8,0.9600000000000002,0.8333333333333333,2.25,
453,0,0,1,1,1,1,1,2,1,0.0,1.0,0.0,0.0,0.0,0.0,
496,1,0,0,1,1,1,1,2,1,0.0,1.0,0.0,0.0,0.0,0.0,
556,1,1,0,3,1,4,1,5,4,84.0,0.25,1.0,0.0,0.0,2.0,
130,1,2,0,0,1,2,1,3,2,3.0,0.5,1.0,0.0,0.0,1.0,
544,0,1,1,0,1,1,1,2,1,0.0,1.0,0.0,0.0,0.0,0.0,
301,1,0,0,2,1,2,1,3,2,27.0,0.5,1.0,0.0,0.0,1.0,
412,1,0,0,1,1,1,1,2,1,0.0,1.0,0.0,0.0,0.0,0.0,
221,9,6,2,10,11,16,6,27,26,354.0,0.6875,3.5,3.0,1.7547619047619045,4.9375,
590,1,0,0,2,1,2,1,3,2,9.0,0.5,1.0,0.0,0.0,1.0,
456,3,0,0,3,3,3,3,6,5,78.0,1.0,2.3333333333333335,0.22222222222222224,1.0,1.375,
154,2,1,0,1,2,2,2,4,3,62.0,1.0,2.0,0.0,1.0,1.0,
613,1,1,0,2,1,3,1,4,3,31.0,0.3333333333333333,1.0,0.0,0.0,1.5,
312,2,3,0,2,2,5,2,7,6,42.0,0.4,1.4,0.24,0.5,2.5,
334,1,0,0,1,1,1,1,2,1,0.0,1.0,0.0,0.0,0.0,0.0,
67,1,1,0,0,1,1,1,2,1,0.0,1.0,0.0,0.0,0.0,0.0,
211,1,0,0,2,1,2,1,3,2,0.0,0.5,1.0,0.0,0.0,1.0,
356,1,0,0,1,1,1,1,2,1,0.0,1.0,0.0,0.0,0.0,0.0,
539,1,0,0,4,1,4,1,5,4,127.0,0.25,1.0,0.0,0.0,2.0,
15,1,0,0,1,1,1,1,2,1,0.0,1.0,0.0,0.0,0.0,0.0,
283,2,0,0,1,2,1,2,3,2,8.0,2.0,2.0,0.0,1.0,0.5,
274,1,1,0,0,1,1,1,2,1,0.0,1.0,0.0,0.0,0.0,0.0,
690,2,1,0,1,2,2,2,4,3,34.0,1.0,1.5,0.25,0.5,1.0,
435,1,2,0,1,1,3,1,4,3,101.0,0.3333333333333333,1.0,0.0,0.0,1.5,
324,0,1,1,0,1,1,1,2,1,0.0,1.0,0.0,0.0,0.0,0.0,
25,1,1,0,1,1,2,1,3,2,22.0,0.5,1.0,0.0,0.0,1.0,
187,6,5,1,7,7,12,5,19,18,357.0,0.5833333333333334,4.0,1.3333333333333333,1.4333333333333333,3.03125,
399,1,1,0,0,1,1,1,2,1,0.0,1.0,0.0,0.0,0.0,0.0,
603,1,1,0,3,1,4,1,5,4,54.0,0.25,1.0,0.0,0.0,2.0,
509,1,0,1,2,2,2,2,4,3,22.0,1.0,1.5,0.25,0.5,1.0,
14,17,12,2,21,19,33,11,52,51,602.0,0.5757575757575758,5.515151515151516,6.916437098255285,1.9152597402597404,6.31982421875,
70,2,1,0,2,2,3,2,5,4,56.0,0.6666666666666666,1.3333333333333333,0.2222222222222222,0.5,1.5,
204,1,1,0,0,1,1,1,2,1,0.0,1.0,0.0,0.0,0.0,0.0,
572,1,1,0,0,1,1,1,2,1,0.0,1.0,0.0,0.0,0.0,0.0,
504,4,1,1,5,5,6,3,11,10,232.0,0.8333333333333334,1.8333333333333333,0.8055555555555557,1.0833333333333333,2.75,
697,1,0,0,1,1,1,1,2,1,0.0,1.0,0.0,0.0,0.0,0.0,
494,3,1,0,2,3,3,2,6,5,153.0,1.0,1.6666666666666667,0.2222222222222222,0.6666666666666666,1.5,
682,1,0,0,2,1,2,1,3,2,19.0,0.5,1.0,0.0,0.0,1.0,
112,1,1,0,1,1,2,1,3,2,3.0,0.5,1.0,0.0,0.0,1.0,
298,1,1,0,0,1,1,1,2,1,0.0,1.0,0.0,0.0,0.0,0.0,
68,1,0,0,1,1,1,1,2,1,0.0,1.0,0.0,0.0,0.0,0.0,
394,3,1,0,3,3,4,2,7,6,52.0,0.75,1.75,0.1875,0.6666666666666666,2.0,
472,2,2,0,2,2,4,2,6,5,57.0,0.5,1.5,0.25,0.5,2.0,
448,1,0,0,1,1,1,1,2,1,0.0,1.0,0.0,0.0,0.0,0.0,
267,5,3,0,8,5,11,3,16,15,111.0,0.45454545454545453,2.4545454545454546,0.42975206611570244,1.0833333333333333,4.75,
259,2,0,0,3,2,3,2,5,4,43.0,0.6666666666666666,1.6666666666666667,0.2222222222222222,0.5,1.5,
427,2,1,0,0,2,1,2,3,2,33.0,2.0,2.0,0.0,1.0,0.5,
42,6,2,0,11,6,13,4,19,18,357.0,0.46153846153846156,1.7692307692307692,0.6390532544378699,1.1833333333333333,6.25,
565,1,2,0,1,1,3,1,4,3,12.0,0.3333333333333333,1.0,0.0,0.0,1.5,
468,1,1,0,0,1,1,1,2,1,0.0,1.0,0.0,0.0,0.0,0.0,
101,2,0,1,2,3,2,3,5,4,36.0,1.5,2.0,1.0,0.8333333333333333,0.875,
61,4,5,0,6,4,11,4,15,14,165.0,0.36363636363636365,2.272727272727273,0.7438016528925622,0.9166666666666665,4.875,
436,2,1,0,2,2,3,2,5,4,195.0,0.6666666666666666,1.6666666666666667,0.2222222222222222,0.5,1.5,
279,3,2,0,1,3,3,3,6,5,36.0,1.0,1.6666666666666667,0.888888888888889,0.8333333333333333,1.375,
251,2,1,0,2,2,3,2,5,4,109.0,0.6666666666666666,1.3333333333333333,0.2222222222222222,0.5,1.5,
5,0,1,1,1,1,2,1,3,2,94.0,0.5,1.0,0.0,0.0,1.0,
411,2,1,0,0,2,1,2,3,2,14.0,2.0,2.0,0.0,1.0,0.5,
660,1,1,0,1,1,2,1,3,2,4.0,0.5,1.0,0.0,0.0,1.0,
374,1,1,0,0,1,1,1,2,1,0.0,1.0,0.0,0.0,0.0,0.0,
3,2,1,0,1,2,2,2,4,3,16.0,1.0,1.5,0.25,0.5,1.0,
582,2,0,0,2,2,2,2,4,3,30.0,1.0,1.5,0.25,0.5,1.0,
23,1,0,0,2,1,2,1,3,2,3.0,0.5,1.0,0.0,0.0,1.0,
588,2,2,0,2,2,4,2,6,5,24.0,0.5,1.25,0.1875,0.5,2.0,
54,3,1,0,6,3,7,3,10,9,256.0,0.42857142857142855,1.8571428571428572,0.40816326530612246,0.8333333333333333,3.375,
605,21,8,0,10,21,18,9,39,38,369.0,1.1666666666666667,6.111111111111111,3.0987654320987668,2.4329365079365077,2.259765625,
617,1,0,0,2,1,2,1,3,2,15.0,0.5,1.0,0.0,0.0,1.0,
326,2,0,0,1,2,1,2,3,2,53.0,2.0,2.0,0.0,1.0,0.5,
560,1,1,0,0,1,1,1,2,1,0.0,1.0,0.0,0.0,0.0,0.0,
431,1,2,0,0,1,2,1,3,2,12.0,0.5,1.0,0.0,0.0,1.0,
491,1,1,0,0,1,1,1,2,1,0.0,1.0,0.0,0.0,0.0,0.0,
474,4,1,1,1,5,2,5,7,6,241.0,2.5,3.5,2.25,1.1666666666666665,0.65625,
527,1,1,0,2,1,3,1,4,3,26.0,0.3333333333333333,1.0,0.0,0.0,1.5,
189,1,1,0,0,1,1,1,2,1,0.0,1.0,0.0,0.0,0.0,0.0,
658,3,0,0,2,3,2,3,5,4,50.0,1.5,3.0,0.0,1.5,0.75,
158,4,5,1,5,5,10,4,15,14,168.0,0.5,2.6,1.04,1.1666666666666665,4.0,
117,2,3,0,0,2,3,2,5,4,14.0,0.6666666666666666,1.3333333333333333,0.2222222222222222,0.5,1.5,
612,1,0,0,1,1,1,1,2,1,0.0,1.0,0.0,0.0,0.0,0.0,
631,0,1,1,0,1,1,1,2,1,0.0,1.0,0.0,0.0,0.0,0.0,
481,1,1,0,0,1,1,1,2,1,0.0,1.0,0.0,0.0,0.0,0.0,
153,4,0,0,1,4,1,4,5,4,193.0,4.0,4.0,0.0,1.8333333333333333,0.25,
473,3,1,0,0,3,1,3,4,3,57.0,3.0,3.0,0.0,1.5,0.375,
596,2,1,1,5,3,6,2,9,8,68.0,0.5,1.5,0.25,0.6666666666666666,3.0,
222,1,2,0,0,1,2,1,3,2,2.0,0.5,1.0,0.0,0.0,1.0,
26,1,0,0,2,1,2,1,3,2,18.0,0.5,1.0,0.0,0.0,1.0,
438,1,1,0,0,1,1,1,2,1,0.0,1.0,0.0,0.0,0.0,0.0,
252,2,1,0,1,2,2,2,4,3,55.0,1.0,1.5,0.25,0.5,1.0,
1,1,0,0,1,1,1,1,2,1,0.0,1.0,0.0,0.0,0.0,0.0,
503,2,0,0,3,2,3,2,5,4,140.0,0.6666666666666666,1.3333333333333333,0.2222222222222222,0.5,1.5,
535,4,3,1,9,5,12,2,17,16,337.0,0.4166666666666667,1.4166666666666667,0.24305555555555555,1.3333333333333333,6.0,
357,1,0,0,1,1,1,1,2,1,0.0,1.0,0.0,0.0,0.0,0.0,
146,1,0,0,1,1,1,1,2,1,0.0,1.0,0.0,0.0,0.0,0.0,
336,1,0,0,3,1,3,1,4,3,17.0,0.3333333333333333,1.0,0.0,0.0,1.5,
171,1,1,0,1,1,2,1,3,2,29.0,0.5,1.0,0.0,0.0,1.0,
598,0,1,1,0,1,1,1,2,1,0.0,1.0,0.0,0.0,0.0,0.0,
72,0,1,2,0,2,1,2,3,2,154.0,2.0,2.0,0.0,1.0,0.5,
497,1,0,0,1,1,1,1,2,1,0.0,1.0,0.0,0.0,0.0,0.0,
84,6,4,1,6,7,10,5,17,16,423.0,0.7,3.2,1.1600000000000001,1.069047619047619,3.53125,
388,2,2,0,1,2,3,2,5,4,15.0,0.6666666666666666,1.3333333333333333,0.2222222222222222,0.5,1.5,
34,1,0,0,1,1,1,1,2,1,0.0,1.0,0.0,0.0,0.0,0.0,
49,1,1,0,2,1,3,1,4,3,108.0,0.3333333333333333,1.0,0.0,0.0,1.5,
355,3,2,0,4,3,6,3,9,8,137.0,0.5,3.0,0.0,1.5,2.25,
20,1,2,0,1,1,3,1,4,3,59.0,0.3333333333333333,1.0,0.0,0.0,1.5,
432,1,1,0,0,1,1,1,2,1,0.0,1.0,0.0,0.0,0.0,0.0,
200,1,2,0,0,1,2,1,3,2,21.0,0.5,1.0,0.0,0.0,1.0,
306,1,1,0,1,1,2,1,3,2,1.0,0.5,1.0,0.0,0.0,1.0,
41,3,1,0,2,3,3,3,6,5,90.0,1.0,2.3333333333333335,0.8888888888888888,0.8333333333333333,1.25,
59,1,1,0,0,1,1,1,2,1,0.0,1.0,0.0,0.0,0.0,0.0,
377,6,6,0,4,6,10,4,16,15,149.0,0.6,3.0,0.2,1.4166666666666665,3.75,
640,3,1,0,4,3,5,3,8,7,150.0,0.6,2.0,0.4,0.8333333333333333,2.375,
430,1,1,0,1,1,2,1,3,2,34.0,0.5,1.0,0.0,0.0,1.0,
123,1,1,0,0,1,1,1,2,1,0.0,1.0,0.0,0.0,0.0,0.0,
168,2,3,0,2,2,5,2,7,6,26.0,0.4,1.6,0.24,0.5,2.5,
194,2,3,0,1,2,4,2,6,5,53.0,0.5,1.5,0.25,0.5,2.0,
217,0,0,1,1,1,1,1,2,1,0.0,1.0,0.0,0.0,0.0,0.0,
469,3,0,0,5,3,5,2,8,7,281.0,0.6,1.8,0.16,0.6666666666666666,2.5,
93,5,2,0,2,5,4,5,9,8,90.0,1.25,3.25,2.1875,1.0333333333333332,1.28125,
136,1,0,0,1,1,1,1,2,1,0.0,1.0,0.0,0.0,0.0,0.0,
108,1,3,0,2,1,5,1,6,5,154.0,0.2,1.0,0.0,0.0,2.5,
337,1,1,0,3,1,4,1,5,4,59.0,0.25,1.0,0.0,0.0,2.0,
695,1,1,1,1,2,2,2,4,3,59.0,1.0,1.5,0.25,0.5,1.0,
515,1,2,0,0,1,2,1,3,2,25.0,0.5,1.0,0.0,0.0,1.0,
163,2,0,0,6,2,6,2,8,7,144.0,0.3333333333333333,2.0,0.0,1.0,3.0,
100,1,0,0,1,1,1,1,2,1,0.0,1.0,0.0,0.0,0.0,0.0,
296,4,5,1,2,5,7,4,12,11,63.0,0.7142857142857143,2.857142857142857,0.4081632653061224,1.1666666666666665,2.75,
663,5,4,0,3,5,7,5,12,11,280.0,0.7142857142857143,2.7142857142857144,2.4897959183673466,1.0333333333333332,2.6875,
219,1,1,0,0,1,1,1,2,1,0.0,1.0,0.0,0.0,0.0,0.0,
237,2,0,0,2,2,2,2,4,3,29.0,1.0,2.0,0.0,1.0,1.0,
484,1,2,1,2,2,4,2,6,5,95.0,0.5,1.25,0.1875,0.5,2.0,
538,1,0,0,2,1,2,1,3,2,31.0,0.5,1.0,0.0,0.0,1.0,
354,1,2,0,0,1,2,1,3,2,85.0,0.5,1.0,0.0,0.0,1.0,
441,1,0,0,1,1,1,1,2,1,0.0,1.0,0.0,0.0,0.0,0.0,
479,6,1,1,6,7,7,6,14,13,210.0,1.0,2.5714285714285716,2.2448979591836733,1.1023809523809525,2.96875,
280,2,1,0,0,2,1,2,3,2,1.0,2.0,2.0,0.0,1.0,0.5,
600,3,3,1,2,4,5,4,9,8,118.0,0.8,2.6,1.04,0.9166666666666665,2.0,
311,1,1,0,2,1,3,1,4,3,78.0,0.3333333333333333,1.0,0.0,0.0,1.5,
646,1,0,0,1,1,1,1,2,1,0.0,1.0,0.0,0.0,0.0,0.0,
502,4,1,0,4,4,5,4,9,8,155.0,0.8,2.6,1.8399999999999999,0.9166666666666665,1.875,
611,1,2,0,2,1,4,1,5,4,150.0,0.25,1.0,0.0,0.0,2.0,
662,1,0,0,1,1,1,1,2,1,0.0,1.0,0.0,0.0,0.0,0.0,
151,1,0,0,1,1,1,1,2,1,0.0,1.0,0.0,0.0,0.0,0.0,
284,0,0,1,1,1,1,1,2,1,0.0,1.0,0.0,0.0,0.0,0.0,
190,2,2,0,0,2,2,2,4,3,48.0,1.0,1.5,0.25,0.5,1.0,
647,1,0,0,1,1,1,1,2,1,0.0,1.0,0.0,0.0,0.0,0.0,
143,0,0,1,1,1,1,1,2,1,0.0,1.0,0.0,0.0,0.0,0.0,
303,3,0,0,2,3,2,3,5,4,32.0,1.5,2.0,1.0,0.8333333333333333,0.875,
636,1,0,0,1,1,1,1,2,1,0.0,1.0,0.0,0.0,0.0,0.0,
299,3,1,0,1,3,2,3,5,4,76.0,1.5,2.5,0.25,1.0,0.875,
624,2,1,0,1,2,2,2,4,3,76.0,1.0,1.5,0.25,0.5,1.0,
313,1,0,0,1,1,1,1,2,1,0.0,1.0,0.0,0.0,0.0,0.0,
614,5,2,0,1,5,3,5,8,7,288.0,1.6666666666666667,3.3333333333333335,2.8888888888888893,1.0333333333333332,0.90625,
228,2,1,0,0,2,1,2,3,2,43.0,2.0,2.0,0.0,1.0,0.5,
207,1,0,0,3,1,3,1,4,3,52.0,0.3333333333333333,1.0,0.0,0.0,1.5,
460,0,0,1,1,1,1,1,2,1,0.0,1.0,0.0,0.0,0.0,0.0,
233,1,0,0,1,1,1,1,2,1,0.0,1.0,0.0,0.0,0.0,0.0,
62,3,1,0,3,3,4,3,7,6,110.0,0.75,3.0,0.0,1.5,1.5,
281,4,4,0,4,4,8,3,12,11,194.0,0.5,1.5,0.5,0.8333333333333333,3.875,
145,0,0,1,1,1,1,1,2,1,0.0,1.0,0.0,0.0,0.0,0.0,
471,1,1,0,1,1,2,1,3,2,22.0,0.5,1.0,0.0,0.0,1.0,
540,2,3,0,3,2,6,2,8,7,184.0,0.3333333333333333,1.3333333333333333,0.22222222222222224,0.5,3.0,
327,1,0,0,1,1,1,1,2,1,0.0,1.0,0.0,0.0,0.0,0.0,
501,3,2,1,0,4,2,3,6,5,119.0,2.0,3.0,0.0,1.1666666666666665,0.75,
161,8,5,0,8,8,13,5,21,20,290.0,0.6153846153846154,2.4615384615384617,1.7869822485207096,1.2357142857142855,5.28125,
392,1,0,0,1,1,1,1,2,1,0.0,1.0,0.0,0.0,0.0,0.0,
290,1,2,0,0,1,2,1,3,2,4.0,0.5,1.0,0.0,0.0,1.0,
122,5,5,0,9,5,14,4,19,18,118.0,0.35714285714285715,2.642857142857143,0.6581632653061222,1.1666666666666665,5.625,
668,1,1,0,0,1,1,1,2,1,0.0,1.0,0.0,0.0,0.0,0.0,
289,1,1,0,1,1,2,1,3,2,25.0,0.5,1.0,0.0,0.0,1.0,
45,3,4,0,5,3,9,2,12,11,261.0,0.3333333333333333,1.3333333333333333,0.22222222222222227,0.6666666666666666,4.5,
113,1,0,0,1,1,1,1,2,1,0.0,1.0,0.0,0.0,0.0,0.0,
440,2,0,0,1,2,1,2,3,2,5.0,2.0,2.0,0.0,1.0,0.5,
22,1,0,0,3,1,3,1,4,3,51.0,0.3333333333333333,1.0,0.0,0.0,1.5,
248,1,0,0,1,1,1,1,2,1,0.0,1.0,0.0,0.0,0.0,0.0,
385,1,1,0,0,1,1,1,2,1,0.0,1.0,0.0,0.0,0.0,0.0,
684,1,0,0,1,1,1,1,2,1,0.0,1.0,0.0,0.0,0.0,0.0,
297,1,0,0,1,1,1,1,2,1,0.0,1.0,0.0,0.0,0.0,0.0,
350,1,0,0,1,1,1,1,2,1,0.0,1.0,0.0,0.0,0.0,0.0,
264,1,0,0,3,1,3,1,4,3,44.0,0.3333333333333333,1.0,0.0,0.0,1.5,
348,1,0,0,1,1,1,1,2,1,0.0,1.0,0.0,0.0,0.0,0.0,
244,12,4,1,11,13,15,8,28,27,459.0,0.8666666666666667,3.6,3.5733333333333333,1.5313492063492065,4.9296875,
639,1,1,0,0,1,1,1,2,1,0.0,1.0,0.0,0.0,0.0,0.0,
64,1,1,0,0,1,1,1,2,1,0.0,1.0,0.0,0.0,0.0,0.0,
557,1,2,0,3,1,5,1,6,5,184.0,0.2,1.0,0.0,0.0,2.5,
29,2,1,0,2,2,3,2,5,4,58.0,0.6666666666666666,1.3333333333333333,0.2222222222222222,0.5,1.5,
235,5,2,0,1,5,3,5,8,7,75.0,1.6666666666666667,2.3333333333333335,3.555555555555556,1.0333333333333332,1.15625,
329,2,1,0,6,2,7,2,9,8,102.0,0.2857142857142857,1.1428571428571428,0.12244897959183677,0.5,3.5,
8,1,1,0,0,1,1,1,2,1,0.0,1.0,0.0,0.0,0.0,0.0,
21,3,2,0,2,3,4,3,7,6,186.0,0.75,2.0,0.5,0.8333333333333333,1.875,
426,31,17,7,28,38,45,10,83,82,823.0,0.8444444444444444,5.488888888888889,6.205432098765434,3.16454378954379,8.205078125,
518,1,1,0,0,1,1,1,2,1,0.0,1.0,0.0,0.0,0.0,0.0,
689,1,0,0,1,1,1,1,2,1,0.0,1.0,0.0,0.0,0.0,0.0,
139,1,1,0,1,1,2,1,3,2,3.0,0.5,1.0,0.0,0.0,1.0,
500,1,0,0,2,1,2,1,3,2,33.0,0.5,1.0,0.0,0.0,1.0,
116,1,1,0,0,1,1,1,2,1,0.0,1.0,0.0,0.0,0.0,0.0,
410,1,0,0,1,1,1,1,2,1,0.0,1.0,0.0,0.0,0.0,0.0,
601,0,1,1,1,1,2,1,3,2,66.0,0.5,1.0,0.0,0.0,1.0,
105,1,1,0,0,1,1,1,2,1,0.0,1.0,0.0,0.0,0.0,0.0,
393,5,0,0,7,5,7,3,12,11,174.0,0.7142857142857143,2.0,0.5714285714285714,0.9,3.25,
316,4,3,0,4,4,7,4,11,10,232.0,0.5714285714285714,1.5714285714285714,1.102040816326531,0.9166666666666665,3.25,
587,1,1,0,1,1,2,1,3,2,18.0,0.5,1.0,0.0,0.0,1.0,
24,5,0,0,6,5,6,4,11,10,129.0,0.8333333333333334,1.8333333333333333,1.138888888888889,0.9833333333333334,2.75,
335,1,2,0,2,1,4,1,5,4,51.0,0.25,1.0,0.0,0.0,2.0,
415,1,2,0,0,1,2,1,3,2,31.0,0.5,1.0,0.0,0.0,1.0,
52,1,0,0,1,1,1,1,2,1,0.0,1.0,0.0,0.0,0.0,0.0,
167,1,0,0,1,1,1,1,2,1,0.0,1.0,0.0,0.0,0.0,0.0,
226,6,4,0,5,6,9,4,15,14,361.0,0.6666666666666666,3.0,1.5555555555555556,1.1833333333333333,3.125,
309,2,1,0,0,2,1,2,3,2,32.0,2.0,2.0,0.0,1.0,0.5,
618,1,0,0,1,1,1,1,2,1,0.0,1.0,0.0,0.0,0.0,0.0,
0,4,2,1,5,5,7,5,12,11,107.0,0.7142857142857143,4.142857142857143,0.6938775510204083,1.4166666666666665,1.71875,
257,0,1,1,0,1,1,1,2,1,0.0,1.0,0.0,0.0,0.0,0.0,
365,1,0,0,1,1,1,1,2,1,0.0,1.0,0.0,0.0,0.0,0.0,
389,2,0,0,3,2,3,2,5,4,85.0,0.6666666666666666,1.3333333333333333,0.2222222222222222,0.5,1.5,
176,0,0,1,1,1,1,1,2,1,0.0,1.0,0.0,0.0,0.0,0.0,
466,1,0,0,2,1,2,1,3,2,32.0,0.5,1.0,0.0,0.0,1.0,
245,10,6,2,12,12,18,7,30,29,256.0,0.6666666666666666,3.3333333333333335,2.333333333333333,1.3734126984126986,6.0234375,
655,1,1,0,2,1,3,1,4,3,63.0,0.3333333333333333,1.0,0.0,0.0,1.5,
265,1,0,0,1,1,1,1,2,1,0.0,1.0,0.0,0.0,0.0,0.0,
489,4,3,2,11,6,14,6,20,19,498.0,0.42857142857142855,3.357142857142857,4.229591836734693,1.0666666666666667,4.1875,
102,1,0,0,1,1,1,1,2,1,0.0,1.0,0.0,0.0,0.0,0.0,
621,3,0,1,2,4,2,4,6,5,215.0,2.0,2.5,2.25,0.9166666666666665,0.75,
253,1,0,0,1,1,1,1,2,1,0.0,1.0,0.0,0.0,0.0,0.0,
380,1,1,0,2,1,3,1,4,3,49.0,0.3333333333333333,1.0,0.0,0.0,1.5,
498,0,1,1,0,1,1,1,2,1,0.0,1.0,0.0,0.0,0.0,0.0,
465,3,2,0,4,3,6,2,9,8,246.0,0.5,1.5,0.25,0.6666666666666666,3.0,
231,11,2,1,10,12,12,7,24,23,268.0,1.0,5.083333333333333,3.9097222222222228,1.7035714285714285,2.25,
433,1,2,0,1,1,3,1,4,3,65.0,0.3333333333333333,1.0,0.0,0.0,1.5,
304,1,1,0,0,1,1,1,2,1,0.0,1.0,0.0,0.0,0.0,0.0,
685,1,0,0,1,1,1,1,2,1,0.0,1.0,0.0,0.0,0.0,0.0,
121,1,0,0,1,1,1,1,2,1,0.0,1.0,0.0,0.0,0.0,0.0,
594,1,1,1,0,2,1,2,3,2,83.0,2.0,2.0,0.0,1.0,0.5,
285,4,1,0,4,4,5,4,9,8,231.0,0.8,3.0,0.8,1.1666666666666665,1.875,
65,1,1,1,3,2,4,2,6,5,78.0,0.5,1.25,0.1875,0.5,2.0,
81,3,3,0,3,3,6,3,9,8,234.0,0.5,1.6666666666666667,0.5555555555555557,0.8333333333333333,2.875,
599,1,0,0,2,1,2,1,3,2,88.0,0.5,1.0,0.0,0.0,1.0,
223,9,4,2,14,11,18,8,29,28,330.0,0.6111111111111112,4.944444444444445,2.9413580246913584,1.7214285714285713,3.640625,
692,3,2,0,2,3,4,3,7,6,110.0,0.75,2.75,0.1875,1.0,1.625,
358,1,1,0,2,1,3,1,4,3,36.0,0.3333333333333333,1.0,0.0,0.0,1.5,
420,1,1,0,0,1,1,1,2,1,0.0,1.0,0.0,0.0,0.0,0.0,
693,2,1,0,4,2,5,2,7,6,217.0,0.4,1.6,0.24,0.5,2.5,
19,1,0,0,2,1,2,1,3,2,6.0,0.5,1.0,0.0,0.0,1.0,
510,4,2,0,0,4,2,4,6,5,52.0,2.0,3.0,1.0,1.1666666666666665,0.75,
333,3,3,0,4,3,7,2,10,9,135.0,0.42857142857142855,1.2857142857142858,0.20408163265306126,0.6666666666666666,3.5,
578,17,15,1,22,18,37,7,55,54,374.0,0.4864864864864865,3.7567567567567566,2.1300219138056975,2.5666666666666664,10.5859375,
135,3,1,0,0,3,1,3,4,3,56.0,3.0,3.0,0.0,1.5,0.375,
352,1,0,0,1,1,1,1,2,1,0.0,1.0,0.0,0.0,0.0,0.0,
242,1,0,0,2,1,2,1,3,2,42.0,0.5,1.0,0.0,0.0,1.0,
378,1,0,0,1,1,1,1,2,1,0.0,1.0,0.0,0.0,0.0,0.0,
421,4,2,1,3,5,5,4,10,9,157.0,1.0,2.4,1.0400000000000003,0.9833333333333334,2.125,
76,1,0,0,2,1,2,1,3,2,34.0,0.5,1.0,0.0,0.0,1.0,
679,12,7,2,20,14,27,6,41,40,402.0,0.5185185185185185,4.074074074074074,2.21673525377229,2.207142857142857,6.9375,
442,15,12,1,14,16,26,8,42,41,677.0,0.6153846153846154,5.884615384615385,3.9482248520710055,2.5976190476190477,3.8828125,
63,5,6,1,9,6,15,3,21,20,259.0,0.4,1.7333333333333334,0.7288888888888891,1.1,7.0,
180,1,0,0,2,1,2,1,3,2,60.0,0.5,1.0,0.0,0.0,1.0,
292,7,5,0,6,7,11,5,18,17,211.0,0.6363636363636364,3.0,2.1818181818181817,1.4833333333333334,3.96875,
138,10,8,0,9,10,17,5,27,26,398.0,0.5882352941176471,3.3529411764705883,0.6989619377162629,2.033333333333333,5.6875,
455,1,1,0,2,1,3,1,4,3,89.0,0.3333333333333333,1.0,0.0,0.0,1.5,
559,1,1,1,1,2,2,2,4,3,57.0,1.0,2.0,0.0,1.0,1.0,
147,4,1,0,2,4,3,4,7,6,216.0,1.3333333333333333,3.6666666666666665,0.22222222222222224,1.3333333333333333,0.875,
529,1,0,0,1,1,1,1,2,1,0.0,1.0,0.0,0.0,0.0,0.0,
634,3,0,0,2,3,2,3,5,4,90.0,1.5,3.0,0.0,1.5,0.75,
648,0,0,1,1,1,1,1,2,1,0.0,1.0,0.0,0.0,0.0,0.0,
619,1,1,0,0,1,1,1,2,1,0.0,1.0,0.0,0.0,0.0,0.0,
467,4,1,0,4,4,5,4,9,8,130.0,0.8,2.2,0.96,0.9166666666666665,2.25,
224,1,0,0,1,1,1,1,2,1,0.0,1.0,0.0,0.0,0.0,0.0,
439,1,0,0,1,1,1,1,2,1,0.0,1.0,0.0,0.0,0.0,0.0,
120,1,1,0,0,1,1,1,2,1,0.0,1.0,0.0,0.0,0.0,0.0,
584,1,1,0,0,1,1,1,2,1,0.0,1.0,0.0,0.0,0.0,0.0,
83,4,1,0,3,4,4,4,8,7,179.0,1.0,3.25,1.6875,0.9166666666666665,1.25,
92,1,1,0,1,1,2,1,3,2,25.0,0.5,1.0,0.0,0.0,1.0,
366,4,1,1,2,5,3,5,8,7,100.0,1.6666666666666667,4.0,0.6666666666666666,1.4166666666666665,0.78125,
77,1,2,0,1,1,3,1,4,3,115.0,0.3333333333333333,1.0,0.0,0.0,1.5,
57,1,2,0,1,1,3,1,4,3,25.0,0.3333333333333333,1.0,0.0,0.0,1.5,
443,0,0,1,1,1,1,1,2,1,0.0,1.0,0.0,0.0,0.0,0.0,
506,1,0,0,1,1,1,1,2,1,0.0,1.0,0.0,0.0,0.0,0.0,
505,8,5,0,7,8,12,4,20,19,245.0,0.6666666666666666,2.5,0.75,1.6333333333333333,5.125,
319,0,0,1,1,1,1,1,2,1,0.0,1.0,0.0,0.0,0.0,0.0,
192,2,2,0,1,2,3,2,5,4,70.0,0.6666666666666666,2.0,0.0,1.0,1.5,
186,1,0,0,1,1,1,1,2,1,0.0,1.0,0.0,0.0,0.0,0.0,
688,1,2,0,1,1,3,1,4,3,50.0,0.3333333333333333,1.0,0.0,0.0,1.5,
162,1,0,0,1,1,1,1,2,1,0.0,1.0,0.0,0.0,0.0,0.0,
593,2,0,0,3,2,3,2,5,4,137.0,0.6666666666666666,1.3333333333333333,0.2222222222222222,0.5,1.5,
229,1,0,0,1,1,1,1,2,1,0.0,1.0,0.0,0.0,0.0,0.0,
434,1,0,0,1,1,1,1,2,1,0.0,1.0,0.0,0.0,0.0,0.0,
657,2,2,0,2,2,4,2,6,5,106.0,0.5,1.25,0.1875,0.5,2.0,
342,1,0,0,1,1,1,1,2,1,0.0,1.0,0.0,0.0,0.0,0.0,
212,1,3,0,1,1,4,1,5,4,50.0,0.25,1.0,0.0,0.0,2.0,
341,6,3,0,1,6,4,4,10,9,165.0,1.5,3.25,0.1875,0.9833333333333333,1.375,
454,3,3,0,4,3,7,2,10,9,219.0,0.42857142857142855,1.5714285714285714,0.24489795918367346,0.6666666666666666,3.5,
656,10,10,1,5,11,15,7,26,25,319.0,0.7333333333333333,4.2,3.893333333333332,1.7785714285714285,3.8828125,
483,0,0,1,1,1,1,1,2,1,0.0,1.0,0.0,0.0,0.0,0.0,
325,1,0,0,1,1,1,1,2,1,0.0,1.0,0.0,0.0,0.0,0.0,
674,2,0,0,2,2,2,2,4,3,81.0,1.0,1.5,0.25,0.5,1.0,
549,2,0,0,3,2,3,2,5,4,102.0,0.6666666666666666,1.3333333333333333,0.2222222222222222,0.5,1.5,
79,5,1,1,4,6,5,4,11,10,236.0,1.2,2.4,1.0400000000000003,0.9833333333333333,2.125,
642,1,1,0,0,1,1,1,2,1,0.0,1.0,0.0,0.0,0.0,0.0,
181,1,1,0,0,1,1,1,2,1,0.0,1.0,0.0,0.0,0.0,0.0,
340,1,1,0,0,1,1,1,2,1,0.0,1.0,0.0,0.0,0.0,0.0,
338,1,0,0,1,1,1,1,2,1,0.0,1.0,0.0,0.0,0.0,0.0,
332,1,1,0,1,1,2,1,3,2,47.0,0.5,1.0,0.0,0.0,1.0,
320,1,3,0,3,1,6,1,7,6,259.0,0.16666666666666666,1.0,0.0,0.0,3.0,
74,8,4,1,7,9,11,5,20,19,451.0,0.8181818181818182,3.272727272727273,1.1074380165289257,1.5999999999999999,3.65625,
17,3,2,0,4,3,6,3,9,8,135.0,0.5,2.1666666666666665,0.13888888888888887,1.0,2.875,
210,3,0,0,5,3,5,3,8,7,143.0,0.6,2.2,0.96,0.8333333333333333,2.125,
569,4,0,0,5,4,5,3,9,8,155.0,0.8,1.8,0.56,0.8333333333333333,2.375,
16,4,1,0,3,4,4,3,8,7,37.0,1.0,2.5,0.25,0.8333333333333333,1.75,
272,1,1,0,0,1,1,1,2,1,0.0,1.0,0.0,0.0,0.0,0.0,
40,1,0,0,1,1,1,1,2,1,0.0,1.0,0.0,0.0,0.0,0.0,
89,3,2,0,1,3,3,2,6,5,24.0,1.0,2.0,0.0,0.6666666666666666,1.5,
218,0,0,1,1,1,1,1,2,1,0.0,1.0,0.0,0.0,0.0,0.0,
597,2,1,0,1,2,2,2,4,3,80.0,1.0,2.0,0.0,1.0,1.0,
416,3,4,1,4,4,8,2,12,11,249.0,0.5,1.625,0.234375,1.0,4.0,
429,1,1,0,1,1,2,1,3,2,25.0,0.5,1.0,0.0,0.0,1.0,
381,1,1,0,0,1,1,1,2,1,0.0,1.0,0.0,0.0,0.0,0.0,
351,2,0,0,1,2,1,2,3,2,25.0,2.0,2.0,0.0,1.0,0.5,
31,1,0,0,2,1,2,1,3,2,39.0,0.5,1.0,0.0,0.0,1.0,
586,3,3,0,3,3,6,2,9,8,154.0,0.5,1.3333333333333333,0.2222222222222223,0.6666666666666666,3.0,
241,3,1,0,2,3,3,2,6,5,105.0,1.0,1.6666666666666667,0.2222222222222222,0.6666666666666666,1.5,
635,1,1,0,0,1,1,1,2,1,0.0,1.0,0.0,0.0,0.0,0.0,
106,2,0,0,3,2,3,2,5,4,73.0,0.6666666666666666,1.6666666666666667,0.2222222222222222,0.5,1.5,
382,1,1,0,0,1,1,1,2,1,0.0,1.0,0.0,0.0,0.0,0.0,
95,3,0,0,3,3,3,3,6,5,118.0,1.0,2.6666666666666665,0.22222222222222224,1.0,1.25,
35,1,0,0,2,1,2,1,3,2,43.0,0.5,1.0,0.0,0.0,1.0,
315,0,0,1,1,1,1,1,2,1,0.0,1.0,0.0,0.0,0.0,0.0,
643,1,1,0,1,1,2,1,3,2,20.0,0.5,1.0,0.0,0.0,1.0,
13,1,0,0,1,1,1,1,2,1,0.0,1.0,0.0,0.0,0.0,0.0,
698,1,0,0,1,1,1,1,2,1,0.0,1.0,0.0,0.0,0.0,0.0,
564,1,0,0,1,1,1,1,2,1,0.0,1.0,0.0,0.0,0.0,0.0,
184,2,2,0,2,2,4,2,6,5,89.0,0.5,1.75,0.1875,0.5,2.0,
523,1,0,0,1,1,1,1,2,1,0.0,1.0,0.0,0.0,0.0,0.0,
269,5,1,0,2,5,3,3,8,7,63.0,1.6666666666666667,3.0,0.0,1.4999999999999998,1.125,
75,1,1,0,2,1,3,1,4,3,45.0,0.3333333333333333,1.0,0.0,0.0,1.5,
626,5,1,0,5,5,6,5,11,10,251.0,0.8333333333333334,3.8333333333333335,1.8055555555555554,1.0333333333333332,1.5625,
488,18,13,3,21,21,34,9,55,54,426.0,0.6176470588235294,4.205882352941177,3.987024221453287,1.999131424131424,9.400390625,
638,4,4,0,5,4,9,3,13,12,350.0,0.4444444444444444,2.4444444444444446,0.4691358024691356,1.1666666666666665,3.875,
477,1,1,0,0,1,1,1,2,1,0.0,1.0,0.0,0.0,0.0,0.0,
681,4,2,1,2,5,4,5,9,8,149.0,1.25,2.5,2.25,1.0333333333333332,1.65625,
526,0,0,1,1,1,1,1,2,1,0.0,1.0,0.0,0.0,0.0,0.0,
533,1,1,0,0,1,1,1,2,1,0.0,1.0,0.0,0.0,0.0,0.0,
152,1,1,0,0,1,1,1,2,1,0.0,1.0,0.0,0.0,0.0,0.0,
216,2,0,0,2,2,2,2,4,3,76.0,1.0,2.0,0.0,1.0,1.0,
534,0,0,1,1,1,1,1,2,1,0.0,1.0,0.0,0.0,0.0,0.0,
406,0,0,1,1,1,1,1,2,1,0.0,1.0,0.0,0.0,0.0,0.0,
517,4,1,0,2,4,3,3,7,6,133.0,1.3333333333333333,2.3333333333333335,0.22222222222222224,0.8333333333333333,1.375,
457,1,0,0,1,1,1,1,2,1,0.0,1.0,0.0,0.0,0.0,0.0,
134,2,1,0,1,2,2,2,4,3,116.0,1.0,2.0,0.0,1.0,1.0,
620,18,9,2,18,20,27,11,47,46,549.0,0.7407407407407407,7.296296296296297,5.986282578875171,2.3051948051948052,2.49365234375,
495,1,1,0,0,1,1,1,2,1,0.0,1.0,0.0,0.0,0.0,0.0,
37,5,3,1,7,6,10,4,16,15,215.0,0.6,2.6,1.44,1.1833333333333333,3.875,
413,1,1,0,0,1,1,1,2,1,0.0,1.0,0.0,0.0,0.0,0.0,
339,2,1,0,2,2,3,2,5,4,45.0,0.6666666666666666,2.0,0.0,1.0,1.5,
183,0,0,1,1,1,1,1,2,1,0.0,1.0,0.0,0.0,0.0,0.0,
664,1,0,0,1,1,1,1,2,1,0.0,1.0,0.0,0.0,0.0,0.0,
536,0,1,1,0,1,1,1,2,1,0.0,1.0,0.0,0.0,0.0,0.0,
397,5,2,0,4,5,6,3,11,10,111.0,0.8333333333333334,1.8333333333333333,0.8055555555555555,1.0833333333333333,2.75,
579,4,2,0,2,4,4,4,8,7,198.0,1.0,3.25,0.1875,1.3333333333333333,1.375,
616,5,3,0,5,5,8,4,13,12,220.0,0.625,3.25,1.6875,1.1666666666666665,2.5,
178,1,1,0,0,1,1,1,2,1,0.0,1.0,0.0,0.0,0.0,0.0,
291,3,1,0,1,3,2,3,5,4,98.0,1.5,2.0,1.0,0.8333333333333333,0.875,
137,1,0,0,1,1,1,1,2,1,0.0,1.0,0.0,0.0,0.0,0.0,
318,16,10,5,18,21,28,10,49,48,640.0,0.75,5.535714285714286,6.534438775510203,2.168795093795094,5.251953125,
282,1,0,0,1,1,1,1,2,1,0.0,1.0,0.0,0.0,0.0,0.0,
628,1,0,0,5,1,5,1,6,5,108.0,0.2,1.0,0.0,0.0,2.5,
499,2,1,1,2,3,3,3,6,5,67.0,1.0,2.3333333333333335,0.8888888888888888,0.8333333333333333,1.25,
175,2,0,0,2,2,2,2,4,3,19.0,1.0,2.0,0.0,1.0,1.0,
591,1,0,0,1,1,1,1,2,1,0.0,1.0,0.0,0.0,0.0,0.0,
277,1,0,0,1,1,1,1,2,1,0.0,1.0,0.0,0.0,0.0,0.0,
