ObID,HRI,HRL,LRI,LRL,Internals,Leaves,Height,Vertices,Size,Duration,RatioIL,MeanBar,StdBar,Beta1,Beta2,
53,3,1,0,2,3,3,3,6,5,33.0,1.0,2.6666666666666665,0.22222222222222224,1.0,1.25,
324,3,1,1,5,4,6,2,10,9,327.0,0.6666666666666666,1.5,0.25,1.0,3.0,
318,1,0,0,1,1,1,1,2,1,0.0,1.0,0.0,0.0,0.0,0.0,
171,0,0,1,1,1,1,1,2,1,0.0,1.0,0.0,0.0,0.0,0.0,
572,1,0,0,1,1,1,1,2,1,0.0,1.0,0.0,0.0,0.0,0.0,
626,2,1,0,6,2,7,2,9,8,116.0,0.2857142857142857,1.5714285714285714,0.24489795918367346,0.5,3.5,
413,10,7,1,6,11,13,5,24,23,356.0,0.8461538461538461,3.3076923076923075,1.289940828402367,2.0,4.3125,
28,2,1,0,1,2,2,2,4,3,9.0,1.0,1.5,0.25,0.5,1.0,
63,2,2,0,1,2,3,2,5,4,51.0,0.6666666666666666,2.0,0.0,1.0,1.5,
162,1,2,0,2,1,4,1,5,4,163.0,0.25,1.0,0.0,0.0,2.0,
455,1,1,0,0,1,1,1,2,1,0.0,1.0,0.0,0.0,0.0,0.0,
349,2,2,0,2,2,4,2,6,5,16.0,0.5,1.5,0.25,0.5,2.0,
348,1,0,0,2,1,2,1,3,2,19.0,0.5,1.0,0.0,0.0,1.0,
602,0,0,1,1,1,1,1,2,1,0.0,1.0,0.0,0.0,0.0,0.0,
676,3,0,0,4,3,4,3,7,6,105.0,0.75,2.25,0.1875,1.0,1.875,
420,1,0,0,1,1,1,1,2,1,0.0,1.0,0.0,0.0,0.0,0.0,
105,3,2,0,5,3,7,3,10,9,279.0,0.42857142857142855,1.2857142857142858,0.489795918367347,0.8333333333333333,3.375,
106,3,3,1,5,4,8,3,12,11,244.0,0.5,2.125,0.109375,0.8333333333333333,3.875,
570,2,1,0,2,2,3,2,5,4,79.0,0.6666666666666666,1.6666666666666667,0.2222222222222222,0.5,1.5,
344,1,0,0,2,1,2,1,3,2,44.0,0.5,1.0,0.0,0.0,1.0,
474,2,4,0,2,2,6,2,8,7,340.0,0.3333333333333333,1.5,0.25,0.5,3.0,
80,10,8,3,10,13,18,7,31,30,441.0,0.7222222222222222,3.8333333333333335,2.25,2.1214285714285714,5.3359375,
487,2,0,0,4,2,4,2,6,5,89.0,0.5,2.0,0.0,1.0,2.0,
581,1,1,0,0,1,1,1,2,1,0.0,1.0,0.0,0.0,0.0,0.0,
121,1,1,0,0,1,1,1,2,1,0.0,1.0,0.0,0.0,0.0,0.0,
45,14,9,3,17,17,26,8,43,42,323.0,0.6538461538461539,3.269230769230769,3.504437869822486,1.8536435786435788,9.28125,
588,8,7,3,8,11,15,6,26,25,346.0,0.7333333333333333,3.8,2.4266666666666667,1.769047619047619,4.53125,
238,1,1,0,0,1,1,1,2,1,0.0,1.0,0.0,0.0,0.0,0.0,
212,2,3,0,2,2,5,2,7,6,91.0,0.4,1.2,0.16000000000000006,0.5,2.5,
203,0,0,1,1,1,1,1,2,1,0.0,1.0,0.0,0.0,0.0,0.0,
165,3,5,1,7,4,12,3,16,15,352.0,0.3333333333333333,2.3333333333333335,0.2222222222222222,1.1666666666666665,5.5,
305,1,4,0,2,1,6,1,7,6,317.0,0.16666666666666666,1.0,0.0,0.0,3.0,
502,2,1,1,1,3,2,3,5,4,101.0,1.5,2.0,1.0,0.8333333333333333,0.875,
97,2,0,0,2,2,2,2,4,3,217.0,1.0,1.5,0.25,0.5,1.0,
475,5,1,1,3,6,4,6,10,9,109.0,1.5,4.25,1.1875,1.3666666666666665,0.96875,
92,1,0,0,1,1,1,1,2,1,0.0,1.0,0.0,0.0,0.0,0.0,
12,2,1,0,2,2,3,2,5,4,115.0,0.6666666666666666,1.6666666666666667,0.2222222222222222,0.5,1.5,
615,5,2,0,4,5,6,4,11,10,132.0,0.8333333333333334,2.1666666666666665,0.8055555555555555,0.9833333333333334,2.75,
148,2,1,0,5,2,6,2,8,7,73.0,0.3333333333333333,1.3333333333333333,0.22222222222222224,0.5,3.0,
492,0,0,1,1,1,1,1,2,1,0.0,1.0,0.0,0.0,0.0,0.0,
507,4,3,1,1,5,4,4,9,8,104.0,1.25,3.0,0.5,1.1666666666666665,1.5,
129,2,0,0,2,2,2,2,4,3,72.0,1.0,2.0,0.0,1.0,1.0,
542,2,0,0,1,2,1,2,3,2,11.0,2.0,2.0,0.0,1.0,0.5,
551,3,0,0,2,3,2,3,5,4,39.0,1.5,2.5,0.25,1.0,0.875,
398,1,0,0,2,1,2,1,3,2,20.0,0.5,1.0,0.0,0.0,1.0,
563,3,1,1,0,4,1,4,5,4,52.0,4.0,4.0,0.0,1.8333333333333333,0.25,
258,1,1,0,0,1,1,1,2,1,0.0,1.0,0.0,0.0,0.0,0.0,
575,2,3,0,1,2,4,2,6,5,116.0,0.5,1.25,0.1875,0.5,2.0,
547,4,4,1,1,5,5,4,10,9,169.0,1.0,2.8,0.5599999999999999,1.1666666666666665,2.0,
663,8,7,0,7,8,14,5,22,21,311.0,0.5714285714285714,2.857142857142857,0.9795918367346939,1.269047619047619,5.40625,
595,1,0,0,1,1,1,1,2,1,0.0,1.0,0.0,0.0,0.0,0.0,
566,1,0,0,1,1,1,1,2,1,0.0,1.0,0.0,0.0,0.0,0.0,
208,3,1,2,4,5,5,3,10,9,67.0,1.0,2.2,0.96,0.9,2.125,
56,2,1,0,0,2,1,2,3,2,8.0,2.0,2.0,0.0,1.0,0.5,
213,2,1,0,2,2,3,2,5,4,52.0,0.6666666666666666,1.6666666666666667,0.2222222222222222,0.5,1.5,
513,2,2,0,6,2,8,2,10,9,151.0,0.25,1.75,0.1875,0.5,4.0,
478,1,0,0,2,1,2,1,3,2,14.0,0.5,1.0,0.0,0.0,1.0,
226,1,0,0,1,1,1,1,2,1,0.0,1.0,0.0,0.0,0.0,0.0,
184,1,0,0,1,1,1,1,2,1,0.0,1.0,0.0,0.0,0.0,0.0,
289,1,0,0,1,1,1,1,2,1,0.0,1.0,0.0,0.0,0.0,0.0,
268,1,0,0,1,1,1,1,2,1,0.0,1.0,0.0,0.0,0.0,0.0,
660,2,0,0,1,2,1,2,3,2,38.0,2.0,2.0,0.0,1.0,0.5,
14,4,1,0,1,4,2,4,6,5,103.0,2.0,3.5,0.25,1.3333333333333333,0.625,
169,1,0,0,1,1,1,1,2,1,0.0,1.0,0.0,0.0,0.0,0.0,
70,1,0,1,2,2,2,2,4,3,222.0,1.0,2.0,0.0,1.0,1.0,
510,1,1,0,0,1,1,1,2,1,0.0,1.0,0.0,0.0,0.0,0.0,
244,2,0,0,1,2,1,2,3,2,19.0,2.0,2.0,0.0,1.0,0.5,
545,1,0,0,1,1,1,1,2,1,0.0,1.0,0.0,0.0,0.0,0.0,
488,7,0,0,3,7,3,6,10,9,152.0,2.3333333333333335,4.0,2.6666666666666665,1.1023809523809525,0.84375,
406,3,1,0,6,3,7,2,10,9,145.0,0.42857142857142855,1.4285714285714286,0.24489795918367346,0.6666666666666666,3.5,
501,0,0,1,1,1,1,1,2,1,0.0,1.0,0.0,0.0,0.0,0.0,
30,0,0,1,1,1,1,1,2,1,0.0,1.0,0.0,0.0,0.0,0.0,
259,6,3,1,8,7,11,5,18,17,386.0,0.6363636363636364,3.1818181818181817,0.87603305785124,1.069047619047619,3.78125,
273,1,1,0,0,1,1,1,2,1,0.0,1.0,0.0,0.0,0.0,0.0,
239,4,0,0,3,4,3,4,7,6,43.0,1.3333333333333333,3.0,0.6666666666666666,1.1666666666666665,1.125,
325,1,0,0,1,1,1,1,2,1,0.0,1.0,0.0,0.0,0.0,0.0,
437,4,1,0,4,4,5,4,9,8,76.0,0.8,2.4,1.44,0.9166666666666666,2.0,
428,2,0,0,2,2,2,2,4,3,7.0,1.0,1.5,0.25,0.5,1.0,
457,1,1,0,0,1,1,1,2,1,0.0,1.0,0.0,0.0,0.0,0.0,
648,1,1,0,0,1,1,1,2,1,0.0,1.0,0.0,0.0,0.0,0.0,
217,4,4,0,4,4,8,3,12,11,106.0,0.5,2.125,0.609375,0.8333333333333333,3.625,
27,1,0,0,1,1,1,1,2,1,0.0,1.0,0.0,0.0,0.0,0.0,
302,1,1,0,0,1,1,1,2,1,0.0,1.0,0.0,0.0,0.0,0.0,
341,1,0,0,3,1,3,1,4,3,104.0,0.3333333333333333,1.0,0.0,0.0,1.5,
255,1,1,0,0,1,1,1,2,1,0.0,1.0,0.0,0.0,0.0,0.0,
395,1,1,0,2,1,3,1,4,3,21.0,0.3333333333333333,1.0,0.0,0.0,1.5,
295,1,0,0,3,1,3,1,4,3,39.0,0.3333333333333333,1.0,0.0,0.0,1.5,
480,2,1,0,0,2,1,2,3,2,47.0,2.0,2.0,0.0,1.0,0.5,
517,2,0,0,2,2,2,2,4,3,45.0,1.0,1.5,0.25,0.5,1.0,
584,0,1,1,0,1,1,1,2,1,0.0,1.0,0.0,0.0,0.0,0.0,
556,2,1,0,2,2,3,2,5,4,181.0,0.6666666666666666,1.3333333333333333,0.2222222222222222,0.5,1.5,
240,1,0,0,1,1,1,1,2,1,0.0,1.0,0.0,0.0,0.0,0.0,
450,1,1,0,3,1,4,1,5,4,52.0,0.25,1.0,0.0,0.0,2.0,
297,3,1,0,2,3,3,3,6,5,79.0,1.0,2.3333333333333335,0.8888888888888888,0.8333333333333333,1.25,
397,2,0,0,1,2,1,2,3,2,22.0,2.0,2.0,0.0,1.0,0.5,
574,0,0,1,1,1,1,1,2,1,0.0,1.0,0.0,0.0,0.0,0.0,
408,0,0,1,1,1,1,1,2,1,0.0,1.0,0.0,0.0,0.0,0.0,
191,0,0,1,1,1,1,1,2,1,0.0,1.0,0.0,0.0,0.0,0.0,
146,1,0,0,1,1,1,1,2,1,0.0,1.0,0.0,0.0,0.0,0.0,
401,2,2,0,6,2,8,2,10,9,161.0,0.25,1.125,0.109375,0.5,4.0,
132,6,6,1,11,7,17,4,24,23,206.0,0.4117647058823529,2.823529411764706,0.8512110726643599,1.4833333333333332,6.625,
631,1,1,1,1,2,2,2,4,3,69.0,1.0,2.0,0.0,1.0,1.0,
16,1,1,0,1,1,2,1,3,2,3.0,0.5,1.0,0.0,0.0,1.0,
598,1,1,0,0,1,1,1,2,1,0.0,1.0,0.0,0.0,0.0,0.0,
376,0,0,1,1,1,1,1,2,1,0.0,1.0,0.0,0.0,0.0,0.0,
550,1,0,0,1,1,1,1,2,1,0.0,1.0,0.0,0.0,0.0,0.0,
78,1,1,0,1,1,2,1,3,2,7.0,0.5,1.0,0.0,0.0,1.0,
646,1,1,0,1,1,2,1,3,2,96.0,0.5,1.0,0.0,0.0,1.0,
629,3,3,0,2,3,5,2,8,7,117.0,0.6,1.8,0.16,0.6666666666666666,2.5,
164,1,2,0,0,1,2,1,3,2,27.0,0.5,1.0,0.0,0.0,1.0,
443,2,0,0,1,2,1,2,3,2,14.0,2.0,2.0,0.0,1.0,0.5,
520,6,8,0,8,6,16,4,22,21,192.0,0.375,2.5625,0.74609375,1.4166666666666665,6.5,
272,3,1,0,3,3,4,2,7,6,48.0,0.75,1.75,0.1875,0.6666666666666666,2.0,
145,1,1,0,0,1,1,1,2,1,0.0,1.0,0.0,0.0,0.0,0.0,
134,16,7,2,21,18,28,10,46,45,458.0,0.6428571428571429,4.892857142857143,7.452806122448978,1.976298701298701,6.8125,
25,2,0,0,1,2,1,2,3,2,6.0,2.0,2.0,0.0,1.0,0.5,
81,1,1,0,1,1,2,1,3,2,14.0,0.5,1.0,0.0,0.0,1.0,
313,1,2,1,0,2,2,2,4,3,50.0,1.0,2.0,0.0,1.0,1.0,
384,1,0,0,1,1,1,1,2,1,0.0,1.0,0.0,0.0,0.0,0.0,
328,1,0,0,1,1,1,1,2,1,0.0,1.0,0.0,0.0,0.0,0.0,
612,4,0,0,3,4,3,4,7,6,126.0,1.3333333333333333,3.0,2.0,0.9166666666666665,1.0,
84,3,1,0,0,3,1,3,4,3,98.0,3.0,3.0,0.0,1.5,0.375,
670,0,1,1,0,1,1,1,2,1,0.0,1.0,0.0,0.0,0.0,0.0,
179,2,1,0,1,2,2,2,4,3,79.0,1.0,1.5,0.25,0.5,1.0,
337,0,0,1,1,1,1,1,2,1,0.0,1.0,0.0,0.0,0.0,0.0,
473,1,0,0,3,1,3,1,4,3,15.0,0.3333333333333333,1.0,0.0,0.0,1.5,
79,2,1,0,2,2,3,2,5,4,25.0,0.6666666666666666,1.6666666666666667,0.2222222222222222,0.5,1.5,
104,3,2,0,2,3,4,3,7,6,89.0,0.75,3.0,0.0,1.5,1.5,
331,3,1,0,2,3,3,3,6,5,70.0,1.0,2.6666666666666665,0.22222222222222224,1.0,1.25,
55,1,1,0,3,1,4,1,5,4,33.0,0.25,1.0,0.0,0.0,2.0,
515,1,1,0,0,1,1,1,2,1,0.0,1.0,0.0,0.0,0.0,0.0,
176,15,9,1,14,16,23,9,39,38,530.0,0.6956521739130435,5.086956521739131,2.9489603024574667,1.9202380952380953,4.189453125,
656,1,1,0,2,1,3,1,4,3,124.0,0.3333333333333333,1.0,0.0,0.0,1.5,
521,1,1,0,0,1,1,1,2,1,0.0,1.0,0.0,0.0,0.0,0.0,
89,2,0,0,2,2,2,2,4,3,18.0,1.0,1.5,0.25,0.5,1.0,
645,1,0,0,1,1,1,1,2,1,0.0,1.0,0.0,0.0,0.0,0.0,
350,1,0,0,1,1,1,1,2,1,0.0,1.0,0.0,0.0,0.0,0.0,
194,4,5,0,6,4,11,3,15,14,194.0,0.36363636363636365,2.4545454545454546,0.24793388429752064,1.1666666666666665,4.875,
209,2,0,0,4,2,4,2,6,5,53.0,0.5,1.25,0.1875,0.5,2.0,
564,1,2,0,2,1,4,1,5,4,73.0,0.25,1.0,0.0,0.0,2.0,
347,21,14,3,19,24,33,11,57,56,505.0,0.7272727272727273,6.03030303030303,5.362718089990817,2.5528860028860025,4.7353515625,
299,3,2,0,3,3,5,2,8,7,177.0,0.6,1.4,0.24,0.6666666666666666,2.5,
69,4,1,0,3,4,4,4,8,7,168.0,1.0,2.75,1.1875,0.9166666666666665,1.5,
317,1,1,0,3,1,4,1,5,4,68.0,0.25,1.0,0.0,0.0,2.0,
549,4,2,0,4,4,6,2,10,9,46.0,0.6666666666666666,1.6666666666666667,0.22222222222222224,1.0,3.0,
48,2,1,1,7,3,8,3,11,10,393.0,0.375,1.25,0.4375,0.8333333333333333,3.875,
674,1,0,0,2,1,2,1,3,2,31.0,0.5,1.0,0.0,0.0,1.0,
62,8,6,1,12,9,18,7,27,26,421.0,0.5,2.5555555555555554,3.2469135802469133,1.2511904761904762,6.9921875,
483,1,1,0,0,1,1,1,2,1,0.0,1.0,0.0,0.0,0.0,0.0,
543,1,3,2,3,3,6,2,9,8,140.0,0.5,1.3333333333333333,0.22222222222222224,0.6666666666666666,3.0,
73,4,3,0,5,4,8,3,12,11,130.0,0.5,2.0,0.5,0.8333333333333333,3.75,
66,2,1,1,0,3,1,3,4,3,11.0,3.0,3.0,0.0,1.5,0.375,
152,0,0,1,1,1,1,1,2,1,0.0,1.0,0.0,0.0,0.0,0.0,
269,1,0,0,1,1,1,1,2,1,0.0,1.0,0.0,0.0,0.0,0.0,
577,4,3,0,4,4,7,4,11,10,146.0,0.5714285714285714,1.8571428571428572,1.2653061224489797,0.9166666666666665,3.125,
282,4,2,0,6,4,8,4,12,11,322.0,0.5,2.125,0.609375,0.9166666666666665,3.75,
383,1,0,0,1,1,1,1,2,1,0.0,1.0,0.0,0.0,0.0,0.0,
140,11,9,0,7,11,16,6,27,26,340.0,0.6875,3.6875,1.83984375,1.5607142857142857,4.59375,
518,1,2,0,1,1,3,1,4,3,109.0,0.3333333333333333,1.0,0.0,0.0,1.5,
15,1,0,0,2,1,2,1,3,2,21.0,0.5,1.0,0.0,0.0,1.0,
199,7,4,1,9,8,13,5,21,20,428.0,0.6153846153846154,2.769230769230769,1.2544378698224854,1.4333333333333333,5.03125,
605,1,1,0,0,1,1,1,2,1,0.0,1.0,0.0,0.0,0.0,0.0,
583,1,0,0,1,1,1,1,2,1,0.0,1.0,0.0,0.0,0.0,0.0,
316,0,1,3,0,3,1,3,4,3,148.0,3.0,3.0,0.0,1.5,0.375,
425,1,0,0,1,1,1,1,2,1,0.0,1.0,0.0,0.0,0.0,0.0,
493,1,1,0,0,1,1,1,2,1,0.0,1.0,0.0,0.0,0.0,0.0,
234,2,1,1,4,3,5,2,8,7,43.0,0.6,1.4,0.24,0.6666666666666666,2.5,
291,3,2,0,5,3,7,2,10,9,81.0,0.42857142857142855,1.4285714285714286,0.24489795918367346,0.6666666666666666,3.5,
198,0,0,1,1,1,1,1,2,1,0.0,1.0,0.0,0.0,0.0,0.0,
172,7,3,0,4,7,7,3,14,13,175.0,1.0,2.4285714285714284,0.5306122448979592,1.5833333333333333,3.0,
230,1,1,0,0,1,1,1,2,1,0.0,1.0,0.0,0.0,0.0,0.0,
327,2,0,0,1,2,1,2,3,2,95.0,2.0,2.0,0.0,1.0,0.5,
405,1,1,0,2,1,3,1,4,3,9.0,0.3333333333333333,1.0,0.0,0.0,1.5,
300,1,2,0,1,1,3,1,4,3,18.0,0.3333333333333333,1.0,0.0,0.0,1.5,
233,0,0,1,1,1,1,1,2,1,0.0,1.0,0.0,0.0,0.0,0.0,
200,3,2,2,6,5,8,3,13,12,301.0,0.625,1.5,0.5,1.0833333333333333,3.875,
128,3,0,0,1,3,1,3,4,3,29.0,3.0,3.0,0.0,1.5,0.375,
652,1,0,0,1,1,1,1,2,1,0.0,1.0,0.0,0.0,0.0,0.0,
227,1,1,0,1,1,2,1,3,2,21.0,0.5,1.0,0.0,0.0,1.0,
624,1,1,1,2,2,3,2,5,4,105.0,0.6666666666666666,1.6666666666666667,0.2222222222222222,0.5,1.5,
673,13,8,2,17,15,25,8,40,39,528.0,0.6,3.44,4.4064000000000005,1.8884920634920634,8.6484375,
334,0,0,1,1,1,1,1,2,1,0.0,1.0,0.0,0.0,0.0,0.0,
323,1,0,2,1,3,1,3,4,3,68.0,3.0,3.0,0.0,1.5,0.375,
531,2,1,0,1,2,2,2,4,3,27.0,1.0,1.5,0.25,0.5,1.0,
414,2,0,0,1,2,1,2,3,2,45.0,2.0,2.0,0.0,1.0,0.5,
0,1,1,0,1,1,2,1,3,2,14.0,0.5,1.0,0.0,0.0,1.0,
426,2,1,0,2,2,3,2,5,4,85.0,0.6666666666666666,1.3333333333333333,0.2222222222222222,0.5,1.5,
257,3,0,0,3,3,3,3,6,5,98.0,1.0,2.0,0.6666666666666666,0.8333333333333333,1.375,
46,13,3,1,17,14,20,7,34,33,629.0,0.7,3.5,3.05,1.7952380952380953,6.671875,
625,4,1,1,2,5,3,4,8,7,277.0,1.6666666666666667,3.6666666666666665,0.22222222222222224,1.5,0.875,
458,3,1,0,2,3,3,3,6,5,54.0,1.0,3.0,0.0,1.5,1.125,
351,1,0,0,1,1,1,1,2,1,0.0,1.0,0.0,0.0,0.0,0.0,
580,0,1,1,0,1,1,1,2,1,0.0,1.0,0.0,0.0,0.0,0.0,
642,1,2,1,1,2,3,2,5,4,67.0,0.6666666666666666,1.3333333333333333,0.2222222222222222,0.5,1.5,
667,1,1,0,0,1,1,1,2,1,0.0,1.0,0.0,0.0,0.0,0.0,
49,2,2,0,2,2,4,2,6,5,39.0,0.5,1.25,0.1875,0.5,2.0,
177,4,1,1,1,5,2,4,7,6,156.0,2.5,3.5,0.25,1.1666666666666665,0.625,
42,1,0,0,1,1,1,1,2,1,0.0,1.0,0.0,0.0,0.0,0.0,
44,1,1,0,0,1,1,1,2,1,0.0,1.0,0.0,0.0,0.0,0.0,
190,1,1,0,1,1,2,1,3,2,29.0,0.5,1.0,0.0,0.0,1.0,
451,1,1,0,1,1,2,1,3,2,3.0,0.5,1.0,0.0,0.0,1.0,
43,1,0,0,1,1,1,1,2,1,0.0,1.0,0.0,0.0,0.0,0.0,
533,3,4,1,6,4,10,3,14,13,329.0,0.4,2.3,0.8099999999999999,1.1666666666666665,4.25,
265,1,0,0,1,1,1,1,2,1,0.0,1.0,0.0,0.0,0.0,0.0,
638,3,2,0,6,3,8,2,11,10,184.0,0.375,1.25,0.1875,0.6666666666666666,4.0,
142,2,1,0,2,2,3,2,5,4,67.0,0.6666666666666666,1.3333333333333333,0.2222222222222222,0.5,1.5,
608,1,1,0,2,1,3,1,4,3,72.0,0.3333333333333333,1.0,0.0,0.0,1.5,
377,1,3,0,0,1,3,1,4,3,47.0,0.3333333333333333,1.0,0.0,0.0,1.5,
465,3,4,0,1,3,5,3,8,7,74.0,0.6,2.4,0.24,1.0,2.25,
640,10,3,0,5,10,8,5,18,17,207.0,1.25,3.25,1.9375,1.3785714285714286,2.53125,
88,1,0,0,2,1,2,1,3,2,60.0,0.5,1.0,0.0,0.0,1.0,
617,1,2,0,2,1,4,1,5,4,111.0,0.25,1.0,0.0,0.0,2.0,
202,2,1,0,1,2,2,2,4,3,47.0,1.0,2.0,0.0,1.0,1.0,
67,1,1,0,2,1,3,1,4,3,33.0,0.3333333333333333,1.0,0.0,0.0,1.5,
60,1,0,0,2,1,2,1,3,2,90.0,0.5,1.0,0.0,0.0,1.0,
183,1,1,1,4,2,5,2,7,6,105.0,0.4,1.4,0.24,0.5,2.5,
647,3,3,0,6,3,9,3,12,11,159.0,0.3333333333333333,1.5555555555555556,0.6913580246913581,0.8333333333333333,4.25,
57,1,0,2,1,3,1,3,4,3,32.0,3.0,3.0,0.0,1.5,0.375,
456,0,0,1,1,1,1,1,2,1,0.0,1.0,0.0,0.0,0.0,0.0,
464,2,1,0,1,2,2,2,4,3,16.0,1.0,1.5,0.25,0.5,1.0,
345,4,2,1,3,5,5,3,10,9,241.0,1.0,2.6,0.24,1.0833333333333333,2.125,
576,2,2,0,1,2,3,2,5,4,28.0,0.6666666666666666,2.0,0.0,1.0,1.5,
651,1,3,0,3,1,6,1,7,6,115.0,0.16666666666666666,1.0,0.0,0.0,3.0,
452,0,0,1,1,1,1,1,2,1,0.0,1.0,0.0,0.0,0.0,0.0,
370,4,2,0,4,4,6,4,10,9,74.0,0.6666666666666666,3.1666666666666665,0.8055555555555555,1.1666666666666665,2.125,
562,2,0,0,1,2,1,2,3,2,3.0,2.0,2.0,0.0,1.0,0.5,
178,1,2,0,3,1,5,1,6,5,37.0,0.2,1.0,0.0,0.0,2.5,
150,1,0,0,1,1,1,1,2,1,0.0,1.0,0.0,0.0,0.0,0.0,
112,1,1,0,0,1,1,1,2,1,0.0,1.0,0.0,0.0,0.0,0.0,
509,12,6,0,12,12,18,7,30,29,388.0,0.6666666666666666,4.722222222222222,2.3117283950617282,1.7273809523809525,3.609375,
404,0,0,1,1,1,1,1,2,1,0.0,1.0,0.0,0.0,0.0,0.0,
415,1,0,0,1,1,1,1,2,1,0.0,1.0,0.0,0.0,0.0,0.0,
5,1,1,0,0,1,1,1,2,1,0.0,1.0,0.0,0.0,0.0,0.0,
386,2,1,0,3,2,4,2,6,5,127.0,0.5,1.5,0.25,0.5,2.0,
587,1,0,0,1,1,1,1,2,1,0.0,1.0,0.0,0.0,0.0,0.0,
535,1,0,0,3,1,3,1,4,3,77.0,0.3333333333333333,1.0,0.0,0.0,1.5,
590,1,0,0,1,1,1,1,2,1,0.0,1.0,0.0,0.0,0.0,0.0,
506,2,1,2,0,4,1,4,5,4,46.0,4.0,4.0,0.0,1.8333333333333333,0.25,
137,1,1,0,0,1,1,1,2,1,0.0,1.0,0.0,0.0,0.0,0.0,
375,3,1,1,5,4,6,2,10,9,137.0,0.6666666666666666,1.8333333333333333,0.13888888888888887,1.0,3.0,
286,2,1,0,1,2,2,2,4,3,61.0,1.0,2.0,0.0,1.0,1.0,
585,1,3,1,0,2,3,2,5,4,43.0,0.6666666666666666,1.6666666666666667,0.2222222222222222,0.5,1.5,
525,1,1,0,1,1,2,1,3,2,1.0,0.5,1.0,0.0,0.0,1.0,
354,1,1,0,0,1,1,1,2,1,0.0,1.0,0.0,0.0,0.0,0.0,
96,1,1,0,2,1,3,1,4,3,56.0,0.3333333333333333,1.0,0.0,0.0,1.5,
541,1,1,0,0,1,1,1,2,1,0.0,1.0,0.0,0.0,0.0,0.0,
586,0,0,1,1,1,1,1,2,1,0.0,1.0,0.0,0.0,0.0,0.0,
561,1,0,0,1,1,1,1,2,1,0.0,1.0,0.0,0.0,0.0,0.0,
95,7,1,0,7,7,8,4,15,14,356.0,0.875,2.0,1.0,1.1833333333333331,3.625,
399,1,0,0,1,1,1,1,2,1,0.0,1.0,0.0,0.0,0.0,0.0,
623,9,5,0,4,9,9,5,18,17,304.0,1.0,3.0,0.6666666666666666,1.833333333333333,3.40625,
32,2,2,0,2,2,4,2,6,5,137.0,0.5,1.5,0.25,0.5,2.0,
292,1,3,1,1,2,4,2,6,5,56.0,0.5,1.25,0.1875,0.5,2.0,
528,3,2,0,0,3,2,3,5,4,30.0,1.5,3.0,0.0,1.5,0.75,
444,1,0,1,1,2,1,2,3,2,39.0,2.0,2.0,0.0,1.0,0.5,
649,1,1,0,0,1,1,1,2,1,0.0,1.0,0.0,0.0,0.0,0.0,
155,1,0,0,1,1,1,1,2,1,0.0,1.0,0.0,0.0,0.0,0.0,
359,2,1,1,2,3,3,3,6,5,261.0,1.0,2.3333333333333335,0.22222222222222224,1.0,1.375,
99,1,1,0,0,1,1,1,2,1,0.0,1.0,0.0,0.0,0.0,0.0,
367,1,2,0,0,1,2,1,3,2,46.0,0.5,1.0,0.0,0.0,1.0,
309,1,2,0,0,1,2,1,3,2,2.0,0.5,1.0,0.0,0.0,1.0,
186,2,0,0,1,2,1,2,3,2,13.0,2.0,2.0,0.0,1.0,0.5,
261,1,0,0,1,1,1,1,2,1,0.0,1.0,0.0,0.0,0.0,0.0,
308,1,0,0,1,1,1,1,2,1,0.0,1.0,0.0,0.0,0.0,0.0,
58,2,3,0,1,2,4,2,6,5,215.0,0.5,1.75,0.1875,0.5,2.0,
20,2,0,0,2,2,2,2,4,3,34.0,1.0,1.5,0.25,0.5,1.0,
364,1,1,0,2,1,3,1,4,3,29.0,0.3333333333333333,1.0,0.0,0.0,1.5,
131,3,1,0,3,3,4,2,7,6,171.0,0.75,1.5,0.25,0.6666666666666666,2.0,
630,1,1,0,0,1,1,1,2,1,0.0,1.0,0.0,0.0,0.0,0.0,
390,6,3,0,4,6,7,4,13,12,131.0,0.8571428571428571,2.5714285714285716,0.5306122448979593,1.2333333333333334,3.0,
610,4,3,0,8,4,11,3,15,14,273.0,0.36363636363636365,1.4545454545454546,0.42975206611570244,0.8333333333333333,5.375,
668,1,3,1,0,2,3,2,5,4,82.0,0.6666666666666666,2.0,0.0,1.0,1.5,
72,1,0,0,2,1,2,1,3,2,58.0,0.5,1.0,0.0,0.0,1.0,
489,0,0,2,1,2,1,2,3,2,63.0,2.0,2.0,0.0,1.0,0.5,
120,1,0,0,2,1,2,1,3,2,62.0,0.5,1.0,0.0,0.0,1.0,
677,1,1,0,0,1,1,1,2,1,0.0,1.0,0.0,0.0,0.0,0.0,
616,4,2,0,1,4,3,4,7,6,124.0,1.3333333333333333,2.6666666666666665,1.5555555555555554,0.9166666666666666,1.125,
264,2,2,0,3,2,5,2,7,6,122.0,0.4,1.8,0.16,0.5,2.5,
161,0,0,1,1,1,1,1,2,1,0.0,1.0,0.0,0.0,0.0,0.0,
491,4,5,1,5,5,10,4,15,14,190.0,0.5,3.4,0.24000000000000005,1.1666666666666665,3.25,
526,0,0,1,1,1,1,1,2,1,0.0,1.0,0.0,0.0,0.0,0.0,
449,2,0,1,2,3,2,3,5,4,109.0,1.5,2.5,0.25,1.0,0.875,
314,3,2,0,2,3,4,3,7,6,156.0,0.75,2.0,0.5,0.8333333333333333,1.875,
335,1,0,0,2,1,2,1,3,2,0.0,0.5,1.0,0.0,0.0,1.0,
519,5,5,0,3,5,8,4,13,12,136.0,0.625,3.0,1.0,1.1666666666666665,2.875,
34,2,0,0,4,2,4,2,6,5,143.0,0.5,1.75,0.1875,0.5,2.0,
603,5,2,0,11,5,13,3,18,17,224.0,0.38461538461538464,2.0,0.46153846153846156,0.9,6.125,
653,1,1,0,0,1,1,1,2,1,0.0,1.0,0.0,0.0,0.0,0.0,
103,1,0,0,1,1,1,1,2,1,0.0,1.0,0.0,0.0,0.0,0.0,
91,1,1,1,3,2,4,2,6,5,91.0,0.5,1.25,0.1875,0.5,2.0,
534,1,1,0,0,1,1,1,2,1,0.0,1.0,0.0,0.0,0.0,0.0,
422,1,0,0,2,1,2,1,3,2,16.0,0.5,1.0,0.0,0.0,1.0,
512,5,1,0,3,5,4,5,9,8,202.0,1.25,3.5,1.25,1.1666666666666665,1.28125,
388,2,1,0,2,2,3,2,5,4,25.0,0.6666666666666666,1.3333333333333333,0.2222222222222222,0.5,1.5,
75,0,0,2,1,2,1,2,3,2,27.0,2.0,2.0,0.0,1.0,0.5,
235,1,1,0,0,1,1,1,2,1,0.0,1.0,0.0,0.0,0.0,0.0,
597,0,0,1,1,1,1,1,2,1,0.0,1.0,0.0,0.0,0.0,0.0,
139,2,1,0,2,2,3,2,5,4,148.0,0.6666666666666666,1.6666666666666667,0.2222222222222222,0.5,1.5,
87,1,0,0,1,1,1,1,2,1,0.0,1.0,0.0,0.0,0.0,0.0,
418,1,0,0,2,1,2,1,3,2,10.0,0.5,1.0,0.0,0.0,1.0,
170,1,0,0,1,1,1,1,2,1,0.0,1.0,0.0,0.0,0.0,0.0,
262,1,0,0,1,1,1,1,2,1,0.0,1.0,0.0,0.0,0.0,0.0,
332,1,2,0,1,1,3,1,4,3,52.0,0.3333333333333333,1.0,0.0,0.0,1.5,
360,1,1,0,0,1,1,1,2,1,0.0,1.0,0.0,0.0,0.0,0.0,
460,0,0,1,1,1,1,1,2,1,0.0,1.0,0.0,0.0,0.0,0.0,
17,3,5,1,4,4,9,3,13,12,207.0,0.4444444444444444,1.6666666666666667,0.6666666666666666,0.8333333333333333,4.25,
100,2,0,1,3,3,3,3,6,5,86.0,1.0,2.6666666666666665,0.22222222222222224,1.0,1.25,
606,0,0,1,1,1,1,1,2,1,0.0,1.0,0.0,0.0,0.0,0.0,
141,1,0,0,1,1,1,1,2,1,0.0,1.0,0.0,0.0,0.0,0.0,
453,3,0,0,4,3,4,3,7,6,68.0,0.75,2.5,0.75,0.8333333333333333,1.625,
618,2,0,0,1,2,1,2,3,2,24.0,2.0,2.0,0.0,1.0,0.5,
306,2,2,0,0,2,2,2,4,3,35.0,1.0,1.5,0.25,0.5,1.0,
294,1,0,0,1,1,1,1,2,1,0.0,1.0,0.0,0.0,0.0,0.0,
662,0,0,1,1,1,1,1,2,1,0.0,1.0,0.0,0.0,0.0,0.0,
650,1,0,0,1,1,1,1,2,1,0.0,1.0,0.0,0.0,0.0,0.0,
372,1,1,0,0,1,1,1,2,1,0.0,1.0,0.0,0.0,0.0,0.0,
461,3,1,0,1,3,2,3,5,4,68.0,1.5,3.0,0.0,1.5,0.75,
326,4,2,0,1,4,3,4,7,6,111.0,1.3333333333333333,3.6666666666666665,0.22222222222222224,1.3333333333333333,0.875,
671,3,4,0,4,3,8,2,11,10,155.0,0.375,1.625,0.234375,0.6666666666666666,4.0,
10,1,2,0,1,1,3,1,4,3,8.0,0.3333333333333333,1.0,0.0,0.0,1.5,
352,0,0,2,1,2,1,2,3,2,174.0,2.0,2.0,0.0,1.0,0.5,
467,2,3,2,2,4,5,4,9,8,63.0,0.8,2.4,1.4400000000000002,0.9166666666666666,2.0,
24,2,0,0,3,2,3,2,5,4,83.0,0.6666666666666666,1.3333333333333333,0.2222222222222222,0.5,1.5,
52,2,0,0,3,2,3,2,5,4,126.0,0.6666666666666666,1.6666666666666667,0.2222222222222222,0.5,1.5,
102,2,1,1,1,3,2,3,5,4,39.0,1.5,2.5,0.25,1.0,0.875,
666,1,0,1,3,2,3,2,5,4,160.0,0.6666666666666666,1.3333333333333333,0.2222222222222222,0.5,1.5,
110,1,1,0,1,1,2,1,3,2,56.0,0.5,1.0,0.0,0.0,1.0,
371,6,2,0,10,6,12,4,18,17,456.0,0.5,2.0833333333333335,1.5763888888888886,1.1833333333333333,5.125,
569,1,1,0,4,1,5,1,6,5,48.0,0.2,1.0,0.0,0.0,2.5,
557,2,3,0,2,2,5,2,7,6,79.0,0.4,1.4,0.24,0.5,2.5,
3,1,5,2,3,3,8,3,11,10,261.0,0.375,1.25,0.4375,0.8333333333333333,3.875,
614,1,0,0,2,1,2,1,3,2,5.0,0.5,1.0,0.0,0.0,1.0,
288,1,1,0,0,1,1,1,2,1,0.0,1.0,0.0,0.0,0.0,0.0,
168,2,0,0,2,2,2,2,4,3,115.0,1.0,1.5,0.25,0.5,1.0,
421,1,1,0,1,1,2,1,3,2,12.0,0.5,1.0,0.0,0.0,1.0,
263,1,1,0,0,1,1,1,2,1,0.0,1.0,0.0,0.0,0.0,0.0,
391,1,0,0,1,1,1,1,2,1,0.0,1.0,0.0,0.0,0.0,0.0,
280,2,0,0,1,2,1,2,3,2,35.0,2.0,2.0,0.0,1.0,0.5,
356,0,0,1,1,1,1,1,2,1,0.0,1.0,0.0,0.0,0.0,0.0,
601,2,1,0,0,2,1,2,3,2,25.0,2.0,2.0,0.0,1.0,0.5,
246,2,1,0,0,2,1,2,3,2,12.0,2.0,2.0,0.0,1.0,0.5,
182,8,3,0,15,8,18,5,26,25,336.0,0.4444444444444444,3.5555555555555554,1.0246913580246912,1.7333333333333332,5.46875,
427,1,1,0,1,1,2,1,3,2,25.0,0.5,1.0,0.0,0.0,1.0,
680,3,1,1,2,4,3,3,7,6,71.0,1.3333333333333333,2.6666666666666665,0.22222222222222224,1.1666666666666665,1.25,
90,3,2,1,4,4,6,3,10,9,174.0,0.6666666666666666,1.6666666666666667,0.5555555555555557,0.8333333333333333,2.875,
35,1,0,0,1,1,1,1,2,1,0.0,1.0,0.0,0.0,0.0,0.0,
362,1,1,0,0,1,1,1,2,1,0.0,1.0,0.0,0.0,0.0,0.0,
589,1,1,0,1,1,2,1,3,2,16.0,0.5,1.0,0.0,0.0,1.0,
216,1,1,0,0,1,1,1,2,1,0.0,1.0,0.0,0.0,0.0,0.0,
123,2,1,1,1,3,2,3,5,4,40.0,1.5,2.5,0.25,1.0,0.875,
111,0,1,1,0,1,1,1,2,1,0.0,1.0,0.0,0.0,0.0,0.0,
39,1,0,1,2,2,2,2,4,3,142.0,1.0,1.5,0.25,0.5,1.0,
442,1,1,0,0,1,1,1,2,1,0.0,1.0,0.0,0.0,0.0,0.0,
107,4,4,0,3,4,7,3,11,10,177.0,0.5714285714285714,2.0,0.5714285714285714,0.8333333333333333,3.25,
634,2,1,0,0,2,1,2,3,2,41.0,2.0,2.0,0.0,1.0,0.5,
447,1,0,0,1,1,1,1,2,1,0.0,1.0,0.0,0.0,0.0,0.0,
358,0,0,1,1,1,1,1,2,1,0.0,1.0,0.0,0.0,0.0,0.0,
664,3,2,0,1,3,3,3,6,5,71.0,1.0,1.6666666666666667,0.888888888888889,0.8333333333333333,1.375,
681,13,16,1,15,14,31,5,45,44,509.0,0.45161290322580644,3.3225806451612905,0.9281997918834546,1.8115079365079363,10.375,
298,1,0,0,1,1,1,1,2,1,0.0,1.0,0.0,0.0,0.0,0.0,
29,1,0,0,1,1,1,1,2,1,0.0,1.0,0.0,0.0,0.0,0.0,
101,6,5,0,3,6,8,5,14,13,223.0,0.75,3.375,2.734375,1.2833333333333332,2.46875,
237,1,1,0,1,1,2,1,3,2,52.0,0.5,1.0,0.0,0.0,1.0,
522,3,1,1,6,4,7,3,11,10,163.0,0.5714285714285714,1.4285714285714286,0.5306122448979592,0.8333333333333333,3.375,
252,4,1,0,0,4,1,4,5,4,39.0,4.0,4.0,0.0,1.8333333333333333,0.25,
486,1,3,0,0,1,3,1,4,3,17.0,0.3333333333333333,1.0,0.0,0.0,1.5,
627,1,1,0,1,1,2,1,3,2,32.0,0.5,1.0,0.0,0.0,1.0,
204,1,1,0,1,1,2,1,3,2,30.0,0.5,1.0,0.0,0.0,1.0,
592,0,0,1,1,1,1,1,2,1,0.0,1.0,0.0,0.0,0.0,0.0,
304,1,0,0,2,1,2,1,3,2,6.0,0.5,1.0,0.0,0.0,1.0,
118,9,1,0,6,9,7,6,16,15,289.0,1.2857142857142858,3.5714285714285716,2.5306122448979593,1.5999999999999999,2.125,
600,2,0,0,3,2,3,2,5,4,66.0,0.6666666666666666,1.3333333333333333,0.2222222222222222,0.5,1.5,
396,2,2,0,0,2,2,2,4,3,16.0,1.0,1.5,0.25,0.5,1.0,
236,1,1,0,0,1,1,1,2,1,0.0,1.0,0.0,0.0,0.0,0.0,
126,1,0,0,1,1,1,1,2,1,0.0,1.0,0.0,0.0,0.0,0.0,
214,1,0,0,1,1,1,1,2,1,0.0,1.0,0.0,0.0,0.0,0.0,
530,3,4,1,3,4,7,4,11,10,282.0,0.5714285714285714,1.4285714285714286,1.1020408163265303,0.9166666666666666,3.25,
633,1,1,0,0,1,1,1,2,1,0.0,1.0,0.0,0.0,0.0,0.0,
76,7,2,0,4,7,6,7,13,12,285.0,1.1666666666666667,4.0,4.0,1.1261904761904762,1.6171875,
353,1,0,0,1,1,1,1,2,1,0.0,1.0,0.0,0.0,0.0,0.0,
98,0,1,1,0,1,1,1,2,1,0.0,1.0,0.0,0.0,0.0,0.0,
31,3,2,1,2,4,4,4,8,7,82.0,1.0,2.25,1.6875,0.9166666666666665,1.625,
619,0,0,1,1,1,1,1,2,1,0.0,1.0,0.0,0.0,0.0,0.0,
538,1,0,1,2,2,2,2,4,3,100.0,1.0,1.5,0.25,0.5,1.0,
206,7,4,1,11,8,15,5,23,22,424.0,0.5333333333333333,2.533333333333333,1.9822222222222219,1.069047619047619,5.9375,
133,1,0,0,1,1,1,1,2,1,0.0,1.0,0.0,0.0,0.0,0.0,
59,1,3,0,1,1,4,1,5,4,38.0,0.25,1.0,0.0,0.0,2.0,
253,2,1,0,2,2,3,2,5,4,29.0,0.6666666666666666,1.3333333333333333,0.2222222222222222,0.5,1.5,
319,5,1,1,6,6,7,3,13,12,157.0,0.8571428571428571,1.8571428571428572,0.6938775510204082,1.3333333333333333,3.25,
571,3,4,1,4,4,8,3,12,11,299.0,0.5,1.375,0.484375,0.8333333333333333,3.875,
322,7,6,0,11,7,17,5,24,23,175.0,0.4117647058823529,3.411764705882353,1.7716262975778547,1.2,5.6875,
47,1,1,0,0,1,1,1,2,1,0.0,1.0,0.0,0.0,0.0,0.0,
61,53,27,5,50,58,77,17,135,134,764.0,0.7532467532467533,8.779220779220779,12.223983808399387,3.8177814402659607,5.459754943847656,
143,0,0,1,1,1,1,1,2,1,0.0,1.0,0.0,0.0,0.0,0.0,
490,3,3,1,4,4,7,3,11,10,290.0,0.5714285714285714,1.7142857142857142,0.489795918367347,0.8333333333333333,3.375,
468,1,0,1,2,2,2,2,4,3,47.0,1.0,1.5,0.25,0.5,1.0,
495,2,0,0,2,2,2,2,4,3,33.0,1.0,2.0,0.0,1.0,1.0,
320,13,4,0,9,13,13,5,26,25,180.0,1.0,3.5384615384615383,1.633136094674556,1.5813492063492063,4.0,
392,1,1,0,0,1,1,1,2,1,0.0,1.0,0.0,0.0,0.0,0.0,
463,2,0,0,1,2,1,2,3,2,6.0,2.0,2.0,0.0,1.0,0.5,
499,1,0,2,1,3,1,3,4,3,96.0,3.0,3.0,0.0,1.5,0.375,
277,2,0,0,4,2,4,2,6,5,27.0,0.5,1.75,0.1875,0.5,2.0,
540,1,1,0,0,1,1,1,2,1,0.0,1.0,0.0,0.0,0.0,0.0,
438,0,1,1,0,1,1,1,2,1,0.0,1.0,0.0,0.0,0.0,0.0,
343,0,1,1,0,1,1,1,2,1,0.0,1.0,0.0,0.0,0.0,0.0,
387,3,1,2,4,5,5,3,10,9,177.0,1.0,3.0,0.0,1.4999999999999998,1.875,
51,0,1,1,0,1,1,1,2,1,0.0,1.0,0.0,0.0,0.0,0.0,
402,1,0,0,2,1,2,1,3,2,14.0,0.5,1.0,0.0,0.0,1.0,
523,1,0,0,1,1,1,1,2,1,0.0,1.0,0.0,0.0,0.0,0.0,
669,1,0,0,1,1,1,1,2,1,0.0,1.0,0.0,0.0,0.0,0.0,
423,1,2,0,0,1,2,1,3,2,80.0,0.5,1.0,0.0,0.0,1.0,
432,3,3,0,5,3,8,3,11,10,150.0,0.375,1.75,0.9375,0.8333333333333333,3.625,
682,11,5,1,10,12,15,5,27,26,420.0,0.8,3.6666666666666665,1.8222222222222224,1.9119047619047618,4.4375,
380,1,1,0,0,1,1,1,2,1,0.0,1.0,0.0,0.0,0.0,0.0,
122,7,3,1,7,8,10,4,18,17,283.0,0.8,2.4,1.64,1.185714285714286,4.0,
64,4,2,0,2,4,4,4,8,7,335.0,1.0,2.75,1.1875,0.9166666666666666,1.5,
251,1,1,0,1,1,2,1,3,2,21.0,0.5,1.0,0.0,0.0,1.0,
260,0,0,1,1,1,1,1,2,1,0.0,1.0,0.0,0.0,0.0,0.0,
50,1,0,0,1,1,1,1,2,1,0.0,1.0,0.0,0.0,0.0,0.0,
149,2,1,0,0,2,1,2,3,2,15.0,2.0,2.0,0.0,1.0,0.5,
573,3,1,0,7,3,8,2,11,10,66.0,0.375,1.375,0.234375,0.6666666666666666,4.0,
446,1,0,0,1,1,1,1,2,1,0.0,1.0,0.0,0.0,0.0,0.0,
591,0,0,1,1,1,1,1,2,1,0.0,1.0,0.0,0.0,0.0,0.0,
435,2,1,0,0,2,1,2,3,2,2.0,2.0,2.0,0.0,1.0,0.5,
247,2,2,0,1,2,3,2,5,4,12.0,0.6666666666666666,2.0,0.0,1.0,1.5,
548,1,0,0,1,1,1,1,2,1,0.0,1.0,0.0,0.0,0.0,0.0,
211,4,2,1,5,5,7,4,12,11,211.0,0.7142857142857143,2.0,1.1428571428571428,0.9833333333333334,3.125,
582,1,1,0,0,1,1,1,2,1,0.0,1.0,0.0,0.0,0.0,0.0,
546,1,1,0,0,1,1,1,2,1,0.0,1.0,0.0,0.0,0.0,0.0,
385,1,1,0,1,1,2,1,3,2,9.0,0.5,1.0,0.0,0.0,1.0,
311,1,0,0,2,1,2,1,3,2,0.0,0.5,1.0,0.0,0.0,1.0,
180,2,0,0,1,2,1,2,3,2,45.0,2.0,2.0,0.0,1.0,0.5,
74,1,0,0,1,1,1,1,2,1,0.0,1.0,0.0,0.0,0.0,0.0,
374,12,8,1,11,13,19,5,32,31,300.0,0.6842105263157895,3.1052631578947367,1.5678670360110805,1.613095238095238,6.75,
342,3,2,0,5,3,7,2,10,9,139.0,0.42857142857142855,1.7142857142857142,0.20408163265306123,0.6666666666666666,3.5,
393,1,1,0,0,1,1,1,2,1,0.0,1.0,0.0,0.0,0.0,0.0,
472,1,0,0,1,1,1,1,2,1,0.0,1.0,0.0,0.0,0.0,0.0,
604,2,2,0,3,2,5,2,7,6,95.0,0.4,1.2,0.16,0.5,2.5,
93,1,1,0,0,1,1,1,2,1,0.0,1.0,0.0,0.0,0.0,0.0,
508,1,0,1,1,2,1,2,3,2,19.0,2.0,2.0,0.0,1.0,0.5,
197,1,2,0,1,1,3,1,4,3,97.0,0.3333333333333333,1.0,0.0,0.0,1.5,
439,1,1,0,2,1,3,1,4,3,20.0,0.3333333333333333,1.0,0.0,0.0,1.5,
407,2,3,1,2,3,5,3,8,7,220.0,0.6,2.2,0.15999999999999998,1.0,2.375,
224,0,0,1,1,1,1,1,2,1,0.0,1.0,0.0,0.0,0.0,0.0,
195,3,2,1,3,4,5,3,9,8,244.0,0.8,2.6,0.24,1.1666666666666665,2.125,
448,2,2,0,0,2,2,2,4,3,25.0,1.0,1.5,0.25,0.5,1.0,
207,10,2,2,8,12,10,8,22,21,430.0,1.2,5.9,3.4900000000000007,1.6619047619047618,1.3984375,
554,24,8,4,24,28,32,12,60,59,625.0,0.875,6.34375,9.6005859375,2.0435641972406673,5.24755859375,
578,7,3,1,9,8,12,6,20,19,219.0,0.6666666666666666,3.6666666666666665,2.055555555555556,1.4333333333333333,3.40625,
654,8,9,0,8,8,17,5,25,24,371.0,0.47058823529411764,2.8823529411764706,1.162629757785467,1.4333333333333331,6.53125,
21,0,0,1,1,1,1,1,2,1,0.0,1.0,0.0,0.0,0.0,0.0,
659,5,4,2,7,7,11,4,18,17,187.0,0.6363636363636364,2.727272727272727,0.38016528925619836,1.6666666666666665,4.5,
365,1,0,0,1,1,1,1,2,1,0.0,1.0,0.0,0.0,0.0,0.0,
613,1,1,0,1,1,2,1,3,2,11.0,0.5,1.0,0.0,0.0,1.0,
559,2,2,0,0,2,2,2,4,3,45.0,1.0,1.5,0.25,0.5,1.0,
568,5,3,2,6,7,9,5,16,15,501.0,0.7777777777777778,2.111111111111111,1.8765432098765433,1.1999999999999997,3.90625,
270,2,2,0,1,2,3,2,5,4,89.0,0.6666666666666666,1.3333333333333333,0.2222222222222222,0.5,1.5,
611,1,1,0,0,1,1,1,2,1,0.0,1.0,0.0,0.0,0.0,0.0,
579,3,0,0,2,3,2,3,5,4,88.0,1.5,2.5,0.25,1.0,0.875,
429,0,0,1,1,1,1,1,2,1,0.0,1.0,0.0,0.0,0.0,0.0,
516,2,0,0,1,2,1,2,3,2,12.0,2.0,2.0,0.0,1.0,0.5,
628,2,0,0,6,2,6,2,8,7,131.0,0.3333333333333333,1.3333333333333333,0.2222222222222222,0.5,3.0,
281,6,4,1,5,7,9,4,16,15,269.0,0.7777777777777778,2.2222222222222223,1.0617283950617287,1.1833333333333336,3.875,
228,1,0,0,1,1,1,1,2,1,0.0,1.0,0.0,0.0,0.0,0.0,
163,1,1,0,1,1,2,1,3,2,93.0,0.5,1.0,0.0,0.0,1.0,
433,10,4,2,9,12,13,5,25,24,446.0,0.9230769230769231,4.076923076923077,1.1479289940828403,2.1333333333333333,3.34375,
655,1,0,0,1,1,1,1,2,1,0.0,1.0,0.0,0.0,0.0,0.0,
11,3,2,0,2,3,4,2,7,6,42.0,0.75,1.5,0.25,0.6666666666666666,2.0,
409,1,2,0,1,1,3,1,4,3,48.0,0.3333333333333333,1.0,0.0,0.0,1.5,
196,0,0,1,1,1,1,1,2,1,0.0,1.0,0.0,0.0,0.0,0.0,
445,2,2,0,0,2,2,2,4,3,15.0,1.0,2.0,0.0,1.0,1.0,
536,3,0,0,7,3,7,3,10,9,163.0,0.42857142857142855,2.2857142857142856,0.7755102040816327,0.8333333333333333,3.0,
436,1,0,0,1,1,1,1,2,1,0.0,1.0,0.0,0.0,0.0,0.0,
504,6,2,0,8,6,10,5,16,15,366.0,0.6,3.2,1.1600000000000001,1.2333333333333332,3.5625,
124,1,3,0,0,1,3,1,4,3,6.0,0.3333333333333333,1.0,0.0,0.0,1.5,
330,1,1,0,1,1,2,1,3,2,15.0,0.5,1.0,0.0,0.0,1.0,
189,1,0,0,2,1,2,1,3,2,21.0,0.5,1.0,0.0,0.0,1.0,
243,0,0,1,2,1,2,1,3,2,37.0,0.5,1.0,0.0,0.0,1.0,
83,1,0,1,2,2,2,2,4,3,40.0,1.0,1.5,0.25,0.5,1.0,
621,2,1,0,1,2,2,2,4,3,57.0,1.0,2.0,0.0,1.0,1.0,
643,0,0,1,1,1,1,1,2,1,0.0,1.0,0.0,0.0,0.0,0.0,
469,1,1,0,1,1,2,1,3,2,0.0,0.5,1.0,0.0,0.0,1.0,
7,4,2,0,5,4,7,3,11,10,181.0,0.5714285714285714,1.7142857142857142,0.7755102040816327,1.1666666666666665,3.25,
54,1,1,0,0,1,1,1,2,1,0.0,1.0,0.0,0.0,0.0,0.0,
157,12,4,1,10,13,14,7,27,26,209.0,0.9285714285714286,4.285714285714286,4.204081632653061,1.6523809523809523,3.6640625,
232,1,1,0,0,1,1,1,2,1,0.0,1.0,0.0,0.0,0.0,0.0,
4,3,1,0,2,3,3,3,6,5,40.0,1.0,2.0,0.6666666666666666,0.8333333333333333,1.375,
245,1,0,0,1,1,1,1,2,1,0.0,1.0,0.0,0.0,0.0,0.0,
296,2,1,0,1,2,2,2,4,3,106.0,1.0,2.0,0.0,1.0,1.0,
307,3,2,0,3,3,5,2,8,7,230.0,0.6,1.4,0.24,0.6666666666666666,2.5,
18,2,0,1,3,3,3,3,6,5,125.0,1.0,2.3333333333333335,0.22222222222222224,1.0,1.375,
481,1,0,0,1,1,1,1,2,1,0.0,1.0,0.0,0.0,0.0,0.0,
378,1,1,0,0,1,1,1,2,1,0.0,1.0,0.0,0.0,0.0,0.0,
459,1,0,1,2,2,2,2,4,3,18.0,1.0,1.5,0.25,0.5,1.0,
641,1,0,0,1,1,1,1,2,1,0.0,1.0,0.0,0.0,0.0,0.0,
411,2,1,0,1,2,2,2,4,3,24.0,1.0,2.0,0.0,1.0,1.0,
283,9,1,0,12,9,13,9,22,21,568.0,0.6923076923076923,5.230769230769231,6.023668639053254,1.1801587301587302,2.619140625,
431,8,4,0,8,8,12,6,20,19,340.0,0.6666666666666666,4.75,2.0208333333333335,1.4333333333333333,2.28125,
205,1,1,0,0,1,1,1,2,1,0.0,1.0,0.0,0.0,0.0,0.0,
672,6,6,2,8,8,14,6,22,21,282.0,0.5714285714285714,2.2142857142857144,2.1683673469387754,1.2452380952380953,6.125,
679,1,0,0,1,1,1,1,2,1,0.0,1.0,0.0,0.0,0.0,0.0,
497,1,1,1,4,2,5,2,7,6,182.0,0.4,1.2,0.16000000000000006,0.5,2.5,
82,1,1,1,0,2,1,2,3,2,13.0,2.0,2.0,0.0,1.0,0.5,
136,2,0,0,4,2,4,2,6,5,149.0,0.5,1.5,0.25,0.5,2.0,
373,5,4,0,12,5,16,3,21,20,242.0,0.3125,1.6875,0.46484375,1.0833333333333333,7.75,
86,1,1,0,2,1,3,1,4,3,33.0,0.3333333333333333,1.0,0.0,0.0,1.5,
366,0,0,1,1,1,1,1,2,1,0.0,1.0,0.0,0.0,0.0,0.0,
471,1,0,0,1,1,1,1,2,1,0.0,1.0,0.0,0.0,0.0,0.0,
529,1,0,0,1,1,1,1,2,1,0.0,1.0,0.0,0.0,0.0,0.0,
125,1,1,0,0,1,1,1,2,1,0.0,1.0,0.0,0.0,0.0,0.0,
36,1,1,0,4,1,5,1,6,5,271.0,0.2,1.0,0.0,0.0,2.5,
41,8,2,1,6,9,8,6,17,16,349.0,1.125,5.0,1.0,1.8833333333333333,1.375,
470,2,2,0,0,2,2,2,4,3,70.0,1.0,1.5,0.25,0.5,1.0,
553,14,12,0,12,14,24,10,38,37,740.0,0.5833333333333334,6.375,6.151041666666667,1.726984126984127,3.1015625,
494,4,1,1,5,5,6,4,11,10,78.0,0.8333333333333334,2.5,0.9166666666666666,0.9833333333333332,2.5,
201,0,0,1,1,1,1,1,2,1,0.0,1.0,0.0,0.0,0.0,0.0,
527,1,1,0,0,1,1,1,2,1,0.0,1.0,0.0,0.0,0.0,0.0,
271,1,0,0,1,1,1,1,2,1,0.0,1.0,0.0,0.0,0.0,0.0,
250,1,1,0,0,1,1,1,2,1,0.0,1.0,0.0,0.0,0.0,0.0,
108,1,1,1,0,2,1,2,3,2,19.0,2.0,2.0,0.0,1.0,0.5,
279,1,0,0,1,1,1,1,2,1,0.0,1.0,0.0,0.0,0.0,0.0,
496,2,2,0,1,2,3,2,5,4,145.0,0.6666666666666666,2.0,0.0,1.0,1.5,
222,0,0,1,1,1,1,1,2,1,0.0,1.0,0.0,0.0,0.0,0.0,
503,3,1,0,3,3,4,2,7,6,92.0,0.75,1.75,0.1875,0.6666666666666666,2.0,
231,1,0,0,1,1,1,1,2,1,0.0,1.0,0.0,0.0,0.0,0.0,
221,1,1,0,0,1,1,1,2,1,0.0,1.0,0.0,0.0,0.0,0.0,
33,1,0,0,2,1,2,1,3,2,13.0,0.5,1.0,0.0,0.0,1.0,
636,6,5,1,5,7,10,5,17,16,487.0,0.7,3.3,1.41,1.2333333333333334,3.28125,
389,3,3,0,6,3,9,3,12,11,215.0,0.3333333333333333,2.111111111111111,0.54320987654321,0.8333333333333333,4.125,
303,5,5,0,8,5,13,3,18,17,262.0,0.38461538461538464,1.6153846153846154,0.3905325443786983,1.0833333333333333,6.375,
339,1,1,0,0,1,1,1,2,1,0.0,1.0,0.0,0.0,0.0,0.0,
138,6,5,0,8,6,13,5,19,18,181.0,0.46153846153846156,3.6923076923076925,0.5207100591715976,1.4166666666666665,3.78125,
290,3,0,0,2,3,2,2,5,4,39.0,1.5,2.0,0.0,0.6666666666666666,1.0,
37,1,0,0,1,1,1,1,2,1,0.0,1.0,0.0,0.0,0.0,0.0,
19,1,1,0,1,1,2,1,3,2,11.0,0.5,1.0,0.0,0.0,1.0,
23,0,0,1,1,1,1,1,2,1,0.0,1.0,0.0,0.0,0.0,0.0,
181,4,0,0,5,4,5,4,9,8,255.0,0.8,3.2,0.96,1.1666666666666665,1.75,
2,1,0,1,1,2,1,2,3,2,4.0,2.0,2.0,0.0,1.0,0.5,
340,1,0,0,1,1,1,1,2,1,0.0,1.0,0.0,0.0,0.0,0.0,
661,2,1,0,1,2,2,2,4,3,31.0,1.0,1.5,0.25,0.5,1.0,
116,1,1,0,0,1,1,1,2,1,0.0,1.0,0.0,0.0,0.0,0.0,
658,1,0,1,1,2,1,2,3,2,7.0,2.0,2.0,0.0,1.0,0.5,
310,1,0,1,2,2,2,2,4,3,56.0,1.0,1.5,0.25,0.5,1.0,
622,0,0,1,1,1,1,1,2,1,0.0,1.0,0.0,0.0,0.0,0.0,
159,1,2,0,0,1,2,1,3,2,59.0,0.5,1.0,0.0,0.0,1.0,
6,8,3,1,9,9,12,6,21,20,259.0,0.75,3.0,2.0,1.2273809523809525,4.375,
256,12,10,0,10,12,20,7,32,31,365.0,0.6,4.25,4.1875,1.3706349206349209,5.0625,
466,3,0,0,3,3,3,3,6,5,46.0,1.0,2.0,0.6666666666666666,0.8333333333333333,1.375,
675,1,1,0,1,1,2,1,3,2,63.0,0.5,1.0,0.0,0.0,1.0,
363,1,0,0,1,1,1,1,2,1,0.0,1.0,0.0,0.0,0.0,0.0,
632,3,1,1,1,4,2,4,6,5,85.0,2.0,3.0,1.0,1.1666666666666665,0.75,
173,4,2,1,16,5,18,3,23,22,278.0,0.2777777777777778,2.0,0.2222222222222222,1.0833333333333333,8.75,
275,3,2,0,3,3,5,3,8,7,190.0,0.6,2.2,0.5599999999999999,0.8333333333333333,2.25,
440,1,0,0,1,1,1,1,2,1,0.0,1.0,0.0,0.0,0.0,0.0,
249,2,0,0,1,2,1,2,3,2,11.0,2.0,2.0,0.0,1.0,0.5,
274,2,2,0,1,2,3,2,5,4,33.0,0.6666666666666666,1.3333333333333333,0.2222222222222222,0.5,1.5,
368,3,1,0,3,3,4,3,7,6,82.0,0.75,1.75,0.6875,0.8333333333333333,1.875,
117,0,0,1,1,1,1,1,2,1,0.0,1.0,0.0,0.0,0.0,0.0,
544,1,0,0,1,1,1,1,2,1,0.0,1.0,0.0,0.0,0.0,0.0,
599,1,0,0,3,1,3,1,4,3,92.0,0.3333333333333333,1.0,0.0,0.0,1.5,
215,1,0,0,1,1,1,1,2,1,0.0,1.0,0.0,0.0,0.0,0.0,
333,1,1,1,1,2,2,2,4,3,21.0,1.0,1.5,0.25,0.5,1.0,
537,1,0,0,1,1,1,1,2,1,0.0,1.0,0.0,0.0,0.0,0.0,
635,2,1,0,1,2,2,2,4,3,18.0,1.0,2.0,0.0,1.0,1.0,
160,2,1,0,1,2,2,2,4,3,36.0,1.0,1.5,0.25,0.5,1.0,
267,2,1,0,1,2,2,2,4,3,23.0,1.0,2.0,0.0,1.0,1.0,
248,1,0,0,1,1,1,1,2,1,0.0,1.0,0.0,0.0,0.0,0.0,
620,1,1,0,0,1,1,1,2,1,0.0,1.0,0.0,0.0,0.0,0.0,
266,1,1,0,3,1,4,1,5,4,39.0,0.25,1.0,0.0,0.0,2.0,
8,2,0,0,5,2,5,2,7,6,89.0,0.4,1.2,0.16,0.5,2.5,
361,2,0,1,8,3,8,2,11,10,311.0,0.375,1.25,0.1875,0.6666666666666666,4.0,
678,1,2,0,0,1,2,1,3,2,6.0,0.5,1.0,0.0,0.0,1.0,
242,1,0,1,1,2,1,2,3,2,84.0,2.0,2.0,0.0,1.0,0.5,
1,3,2,0,6,3,8,3,11,10,147.0,0.375,1.625,0.484375,0.8333333333333333,3.875,
454,1,2,0,2,1,4,1,5,4,106.0,0.25,1.0,0.0,0.0,2.0,
220,1,1,0,0,1,1,1,2,1,0.0,1.0,0.0,0.0,0.0,0.0,
552,1,0,0,1,1,1,1,2,1,0.0,1.0,0.0,0.0,0.0,0.0,
665,1,0,0,1,1,1,1,2,1,0.0,1.0,0.0,0.0,0.0,0.0,
321,1,1,0,0,1,1,1,2,1,0.0,1.0,0.0,0.0,0.0,0.0,
287,13,5,3,10,16,15,9,31,30,252.0,1.0666666666666667,4.933333333333334,3.7955555555555565,1.513117438117438,3.158203125,
154,9,1,0,13,9,14,7,23,22,560.0,0.6428571428571429,4.0,4.0,1.292857142857143,3.671875,
175,0,1,1,0,1,1,1,2,1,0.0,1.0,0.0,0.0,0.0,0.0,
485,3,2,0,2,3,4,3,7,6,51.0,0.75,2.0,0.5,0.8333333333333333,1.875,
596,2,0,0,2,2,2,2,4,3,150.0,1.0,2.0,0.0,1.0,1.0,
594,2,4,0,2,2,6,2,8,7,169.0,0.3333333333333333,1.6666666666666667,0.22222222222222224,0.5,3.0,
26,1,0,0,1,1,1,1,2,1,0.0,1.0,0.0,0.0,0.0,0.0,
13,1,0,0,1,1,1,1,2,1,0.0,1.0,0.0,0.0,0.0,0.0,
276,1,1,0,0,1,1,1,2,1,0.0,1.0,0.0,0.0,0.0,0.0,
357,1,2,0,3,1,5,1,6,5,52.0,0.2,1.0,0.0,0.0,2.5,
109,7,3,0,7,7,10,6,17,16,218.0,0.7,2.6,3.0400000000000005,1.2666666666666666,3.875,
278,1,0,0,1,1,1,1,2,1,0.0,1.0,0.0,0.0,0.0,0.0,
153,8,5,1,4,9,9,5,18,17,282.0,1.0,3.4444444444444446,1.1358024691358024,1.9333333333333331,2.9375,
94,1,0,2,3,3,3,2,6,5,53.0,1.0,1.6666666666666667,0.2222222222222222,0.6666666666666666,1.5,
218,0,0,1,1,1,1,1,2,1,0.0,1.0,0.0,0.0,0.0,0.0,
71,0,1,1,1,1,2,1,3,2,44.0,0.5,1.0,0.0,0.0,1.0,
416,1,1,0,2,1,3,1,4,3,52.0,0.3333333333333333,1.0,0.0,0.0,1.5,
144,7,5,2,8,9,13,6,22,21,295.0,0.6923076923076923,2.923076923076923,2.3786982248520707,1.4452380952380952,5.0625,
419,11,6,3,8,14,14,12,28,27,425.0,1.0,7.928571428571429,12.9234693877551,1.4139971139971141,1.7158203125,
130,2,0,0,1,2,1,2,3,2,59.0,2.0,2.0,0.0,1.0,0.5,
284,7,3,2,9,9,12,5,21,20,243.0,0.75,3.0,1.0,1.6333333333333333,4.40625,
77,4,4,0,9,4,13,3,17,16,249.0,0.3076923076923077,1.9230769230769231,0.37869822485207094,0.8333333333333333,6.25,
167,1,0,0,1,1,1,1,2,1,0.0,1.0,0.0,0.0,0.0,0.0,
187,5,5,0,5,5,10,5,15,14,250.0,0.5,2.6,0.8400000000000001,1.1666666666666665,4.28125,
639,1,0,1,1,2,1,2,3,2,43.0,2.0,2.0,0.0,1.0,0.5,
40,1,0,0,2,1,2,1,3,2,89.0,0.5,1.0,0.0,0.0,1.0,
500,1,0,0,1,1,1,1,2,1,0.0,1.0,0.0,0.0,0.0,0.0,
185,3,2,0,3,3,5,3,8,7,193.0,0.6,2.2,0.5599999999999999,0.8333333333333333,2.25,
219,1,0,0,1,1,1,1,2,1,0.0,1.0,0.0,0.0,0.0,0.0,
85,1,0,0,1,1,1,1,2,1,0.0,1.0,0.0,0.0,0.0,0.0,
477,1,0,0,1,1,1,1,2,1,0.0,1.0,0.0,0.0,0.0,0.0,
434,4,2,1,3,5,5,4,10,9,71.0,1.0,3.0,0.8,1.1666666666666665,1.875,
514,1,1,0,1,1,2,1,3,2,14.0,0.5,1.0,0.0,0.0,1.0,
382,1,1,0,0,1,1,1,2,1,0.0,1.0,0.0,0.0,0.0,0.0,
479,6,1,0,5,6,6,4,12,11,200.0,1.0,2.6666666666666665,0.888888888888889,1.4166666666666665,2.375,
476,1,2,0,1,1,3,1,4,3,58.0,0.3333333333333333,1.0,0.0,0.0,1.5,
135,7,4,0,11,7,15,5,22,21,265.0,0.4666666666666667,3.4,2.24,1.4833333333333334,4.46875,
329,0,0,2,2,2,2,2,4,3,28.0,1.0,1.5,0.25,0.5,1.0,
315,2,1,0,2,2,3,2,5,4,83.0,0.6666666666666666,1.6666666666666667,0.2222222222222222,0.5,1.5,
394,3,3,0,1,3,4,3,7,6,30.0,0.75,2.0,0.5,0.8333333333333333,1.875,
229,1,1,0,0,1,1,1,2,1,0.0,1.0,0.0,0.0,0.0,0.0,
644,8,5,3,4,11,9,6,20,19,335.0,1.2222222222222223,4.111111111111111,1.2098765432098761,2.0,2.3125,
210,1,0,0,1,1,1,1,2,1,0.0,1.0,0.0,0.0,0.0,0.0,
174,3,0,1,9,4,9,2,13,12,289.0,0.4444444444444444,1.5555555555555556,0.2469135802469136,1.0,4.5,
524,1,1,0,0,1,1,1,2,1,0.0,1.0,0.0,0.0,0.0,0.0,
158,15,4,0,11,15,15,7,30,29,309.0,1.0,4.8,3.0933333333333337,2.34047619047619,3.21875,
567,1,1,0,0,1,1,1,2,1,0.0,1.0,0.0,0.0,0.0,0.0,
657,1,0,0,1,1,1,1,2,1,0.0,1.0,0.0,0.0,0.0,0.0,
166,1,2,1,7,2,9,2,11,10,334.0,0.2222222222222222,2.0,0.0,1.0,4.5,
223,2,3,0,3,2,6,2,8,7,93.0,0.3333333333333333,1.5,0.25,0.5,3.0,
127,1,0,0,1,1,1,1,2,1,0.0,1.0,0.0,0.0,0.0,0.0,
156,1,1,0,2,1,3,1,4,3,79.0,0.3333333333333333,1.0,0.0,0.0,1.5,
9,1,0,0,1,1,1,1,2,1,0.0,1.0,0.0,0.0,0.0,0.0,
593,1,1,0,7,1,8,1,9,8,223.0,0.125,1.0,0.0,0.0,4.0,
188,1,0,0,1,1,1,1,2,1,0.0,1.0,0.0,0.0,0.0,0.0,
560,6,2,0,5,6,7,5,13,12,162.0,0.8571428571428571,3.142857142857143,2.122448979591837,1.2833333333333332,2.28125,
403,2,3,0,0,2,3,2,5,4,37.0,0.6666666666666666,1.3333333333333333,0.2222222222222222,0.5,1.5,
147,1,0,1,1,2,1,2,3,2,15.0,2.0,2.0,0.0,1.0,0.5,
511,2,0,0,1,2,1,2,3,2,32.0,2.0,2.0,0.0,1.0,0.5,
68,8,4,0,2,8,6,8,14,13,234.0,1.3333333333333333,3.5,4.583333333333333,1.269047619047619,2.15625,
115,1,1,0,0,1,1,1,2,1,0.0,1.0,0.0,0.0,0.0,0.0,
607,1,0,0,1,1,1,1,2,1,0.0,1.0,0.0,0.0,0.0,0.0,
22,0,0,1,1,1,1,1,2,1,0.0,1.0,0.0,0.0,0.0,0.0,
505,1,1,0,1,1,2,1,3,2,26.0,0.5,1.0,0.0,0.0,1.0,
65,1,0,0,2,1,2,1,3,2,31.0,0.5,1.0,0.0,0.0,1.0,
565,1,2,1,2,2,4,2,6,5,179.0,0.5,1.25,0.1875,0.5,2.0,
441,0,0,1,1,1,1,1,2,1,0.0,1.0,0.0,0.0,0.0,0.0,
379,2,3,0,5,2,8,2,10,9,74.0,0.25,1.625,0.234375,0.5,4.0,
285,1,1,0,1,1,2,1,3,2,39.0,0.5,1.0,0.0,0.0,1.0,
312,2,2,0,0,2,2,2,4,3,176.0,1.0,2.0,0.0,1.0,1.0,
225,1,0,0,1,1,1,1,2,1,0.0,1.0,0.0,0.0,0.0,0.0,
369,2,2,1,2,3,4,3,7,6,113.0,0.75,2.0,1.0,0.8333333333333333,1.75,
484,2,1,0,0,2,1,2,3,2,7.0,2.0,2.0,0.0,1.0,0.5,
293,0,0,1,1,1,1,1,2,1,0.0,1.0,0.0,0.0,0.0,0.0,
346,4,1,0,6,4,7,3,11,10,172.0,0.5714285714285714,1.5714285714285714,0.5306122448979591,0.8333333333333333,3.375,
410,1,0,0,1,1,1,1,2,1,0.0,1.0,0.0,0.0,0.0,0.0,
38,0,0,1,1,1,1,1,2,1,0.0,1.0,0.0,0.0,0.0,0.0,
417,1,0,0,1,1,1,1,2,1,0.0,1.0,0.0,0.0,0.0,0.0,
355,5,4,1,6,6,10,4,16,15,161.0,0.6,2.2,1.1600000000000001,1.1833333333333333,4.375,
193,0,0,1,1,1,1,1,2,1,0.0,1.0,0.0,0.0,0.0,0.0,
637,3,2,1,2,4,4,4,8,7,299.0,1.0,3.75,0.1875,1.3333333333333333,1.125,
241,1,1,0,0,1,1,1,2,1,0.0,1.0,0.0,0.0,0.0,0.0,
683,1,1,0,0,1,1,1,2,1,0.0,1.0,0.0,0.0,0.0,0.0,
381,1,0,0,1,1,1,1,2,1,0.0,1.0,0.0,0.0,0.0,0.0,
462,1,0,0,1,1,1,1,2,1,0.0,1.0,0.0,0.0,0.0,0.0,
338,5,3,0,2,5,5,2,10,9,108.0,1.0,2.0,0.0,1.3333333333333333,2.5,
192,2,1,0,2,2,3,2,5,4,52.0,0.6666666666666666,1.3333333333333333,0.2222222222222222,0.5,1.5,
254,1,0,0,1,1,1,1,2,1,0.0,1.0,0.0,0.0,0.0,0.0,
532,1,0,0,1,1,1,1,2,1,0.0,1.0,0.0,0.0,0.0,0.0,
301,3,0,0,4,3,4,3,7,6,76.0,0.75,2.75,0.1875,1.0,1.625,
558,1,1,0,2,1,3,1,4,3,59.0,0.3333333333333333,1.0,0.0,0.0,1.5,
539,1,0,0,1,1,1,1,2,1,0.0,1.0,0.0,0.0,0.0,0.0,
114,0,0,1,1,1,1,1,2,1,0.0,1.0,0.0,0.0,0.0,0.0,
113,0,0,1,1,1,1,1,2,1,0.0,1.0,0.0,0.0,0.0,0.0,
482,26,17,1,20,27,37,11,64,63,492.0,0.7297297297297297,6.081081081081081,6.020452885317752,2.447580197580198,5.55029296875,
412,4,3,0,0,4,3,4,7,6,122.0,1.3333333333333333,3.0,0.6666666666666666,1.1666666666666665,1.125,
119,2,1,0,5,2,6,2,8,7,104.0,0.3333333333333333,1.3333333333333333,0.22222222222222224,0.5,3.0,
498,3,3,0,5,3,8,3,11,10,233.0,0.375,2.0,0.25,0.8333333333333333,3.875,
336,5,1,0,4,5,5,4,10,9,123.0,1.0,2.0,1.2,0.9833333333333334,2.25,
555,0,0,1,1,1,1,1,2,1,0.0,1.0,0.0,0.0,0.0,0.0,
430,2,0,0,1,2,1,2,3,2,95.0,2.0,2.0,0.0,1.0,0.5,
151,2,2,0,1,2,3,2,5,4,59.0,0.6666666666666666,1.3333333333333333,0.2222222222222222,0.5,1.5,
609,1,0,0,2,1,2,1,3,2,3.0,0.5,1.0,0.0,0.0,1.0,
424,3,2,0,3,3,5,2,8,7,112.0,0.6,1.6,0.24,0.6666666666666666,2.5,
400,1,0,0,1,1,1,1,2,1,0.0,1.0,0.0,0.0,0.0,0.0,
