ObID,HRI,HRL,LRI,LRL,Internals,Leaves,Height,Vertices,Size,Duration,RatioIL,MeanBar,StdBar,Beta1,Beta2,
613,2,4,2,4,4,8,4,12,11,191.0,0.5,3.5,0.75,1.1666666666666665,2.5,
399,4,1,0,7,4,8,3,12,11,229.0,0.5,1.75,0.4375,0.8333333333333333,3.875,
288,1,0,0,1,1,1,1,2,1,0.0,1.0,0.0,0.0,0.0,0.0,
249,3,0,0,4,3,4,3,7,6,213.0,0.75,2.25,0.6875,0.8333333333333333,1.75,
943,2,0,0,2,2,2,2,4,3,87.0,1.0,1.5,0.25,0.5,1.0,
982,1,0,1,1,2,1,2,3,2,36.0,2.0,2.0,0.0,1.0,0.5,
193,0,1,1,1,1,2,1,3,2,45.0,0.5,1.0,0.0,0.0,1.0,
770,4,1,0,3,4,4,4,8,7,147.0,1.0,2.75,1.1875,0.9166666666666665,1.5,
1038,5,1,0,2,5,3,5,8,7,229.0,1.6666666666666667,2.6666666666666665,2.8888888888888893,1.0333333333333332,1.15625,
1091,4,2,1,3,5,5,4,10,9,200.0,1.0,3.6,0.24,1.4999999999999998,1.5,
768,2,3,1,1,3,4,2,7,6,84.0,0.75,1.75,0.1875,0.6666666666666666,2.0,
556,1,0,0,1,1,1,1,2,1,0.0,1.0,0.0,0.0,0.0,0.0,
244,3,0,1,4,4,4,4,8,7,58.0,1.0,2.75,0.6875,1.1666666666666665,1.625,
561,1,1,0,1,1,2,1,3,2,6.0,0.5,1.0,0.0,0.0,1.0,
1191,2,0,0,2,2,2,2,4,3,29.0,1.0,1.5,0.25,0.5,1.0,
85,2,0,1,3,3,3,3,6,5,86.0,1.0,3.0,0.0,1.5,1.125,
454,1,1,0,0,1,1,1,2,1,0.0,1.0,0.0,0.0,0.0,0.0,
1172,3,2,2,4,5,6,4,11,10,360.0,0.8333333333333334,3.6666666666666665,0.5555555555555555,1.4999999999999998,1.75,
60,0,2,1,0,1,2,1,3,2,9.0,0.5,1.0,0.0,0.0,1.0,
1249,1,0,0,1,1,1,1,2,1,0.0,1.0,0.0,0.0,0.0,0.0,
819,0,1,1,1,1,2,1,3,2,13.0,0.5,1.0,0.0,0.0,1.0,
207,6,2,3,15,9,17,4,26,25,107.0,0.5294117647058824,2.4705882352941178,1.3079584775086506,1.5833333333333335,7.0,
395,1,1,0,0,1,1,1,2,1,0.0,1.0,0.0,0.0,0.0,0.0,
638,0,0,1,1,1,1,1,2,1,0.0,1.0,0.0,0.0,0.0,0.0,
449,1,1,0,0,1,1,1,2,1,0.0,1.0,0.0,0.0,0.0,0.0,
992,1,0,0,1,1,1,1,2,1,0.0,1.0,0.0,0.0,0.0,0.0,
170,2,2,1,1,3,3,3,6,5,46.0,1.0,2.3333333333333335,0.22222222222222224,1.0,1.375,
195,3,2,1,5,4,7,3,11,10,232.0,0.5714285714285714,2.2857142857142856,0.20408163265306123,1.1666666666666665,3.25,
986,4,3,0,2,4,5,2,9,8,135.0,0.8,1.8,0.16000000000000006,1.0,2.5,
95,1,1,1,0,2,1,2,3,2,24.0,2.0,2.0,0.0,1.0,0.5,
894,3,0,1,1,4,1,4,5,4,110.0,4.0,4.0,0.0,1.8333333333333333,0.25,
983,1,0,0,1,1,1,1,2,1,0.0,1.0,0.0,0.0,0.0,0.0,
1162,2,0,0,3,2,3,2,5,4,74.0,0.6666666666666666,1.3333333333333333,0.2222222222222222,0.5,1.5,
822,4,3,0,6,4,9,3,13,12,287.0,0.4444444444444444,2.111111111111111,0.54320987654321,0.8333333333333333,4.125,
1171,1,1,0,0,1,1,1,2,1,0.0,1.0,0.0,0.0,0.0,0.0,
779,5,5,1,2,6,7,4,13,12,112.0,0.8571428571428571,2.7142857142857144,0.7755102040816327,0.9833333333333334,2.75,
444,0,0,1,2,1,2,1,3,2,18.0,0.5,1.0,0.0,0.0,1.0,
1185,2,0,0,5,2,5,2,7,6,116.0,0.4,1.2,0.16,0.5,2.5,
1177,1,0,0,1,1,1,1,2,1,0.0,1.0,0.0,0.0,0.0,0.0,
693,1,0,0,1,1,1,1,2,1,0.0,1.0,0.0,0.0,0.0,0.0,
566,5,1,1,3,6,4,5,10,9,223.0,1.5,2.75,3.1875,1.2833333333333332,1.40625,
208,0,1,1,0,1,1,1,2,1,0.0,1.0,0.0,0.0,0.0,0.0,
646,0,0,1,1,1,1,1,2,1,0.0,1.0,0.0,0.0,0.0,0.0,
518,1,0,0,2,1,2,1,3,2,25.0,0.5,1.0,0.0,0.0,1.0,
788,1,0,0,1,1,1,1,2,1,0.0,1.0,0.0,0.0,0.0,0.0,
463,1,1,0,0,1,1,1,2,1,0.0,1.0,0.0,0.0,0.0,0.0,
1187,9,8,0,7,9,15,6,24,23,429.0,0.6,3.2666666666666666,2.3288888888888883,1.4690476190476192,5.25,
978,2,2,0,2,2,4,2,6,5,136.0,0.5,2.0,0.0,1.0,2.0,
1105,4,0,0,4,4,4,4,8,7,82.0,1.0,2.75,0.6875,1.1666666666666665,1.625,
1270,1,0,0,1,1,1,1,2,1,0.0,1.0,0.0,0.0,0.0,0.0,
311,1,1,0,0,1,1,1,2,1,0.0,1.0,0.0,0.0,0.0,0.0,
370,1,0,0,1,1,1,1,2,1,0.0,1.0,0.0,0.0,0.0,0.0,
136,0,1,1,2,1,3,1,4,3,23.0,0.3333333333333333,1.0,0.0,0.0,1.5,
1079,1,1,0,0,1,1,1,2,1,0.0,1.0,0.0,0.0,0.0,0.0,
1220,1,1,0,0,1,1,1,2,1,0.0,1.0,0.0,0.0,0.0,0.0,
1182,11,4,1,9,12,13,5,25,24,399.0,0.9230769230769231,3.6153846153846154,1.0059171597633136,1.911904761904762,3.96875,
269,0,0,1,1,1,1,1,2,1,0.0,1.0,0.0,0.0,0.0,0.0,
1049,3,1,0,1,3,2,3,5,4,52.0,1.5,2.5,0.25,1.0,0.875,
554,0,0,1,1,1,1,1,2,1,0.0,1.0,0.0,0.0,0.0,0.0,
149,11,2,3,10,14,12,8,26,25,206.0,1.1666666666666667,5.333333333333333,3.5555555555555554,1.7952380952380953,2.1484375,
30,5,7,2,9,7,16,4,23,22,166.0,0.4375,2.625,0.984375,1.4833333333333332,6.5,
106,19,19,2,10,21,29,6,50,49,225.0,0.7241379310344828,3.1379310344827585,1.2913198573127231,2.7654761904761904,10.28125,
666,1,3,1,2,2,5,2,7,6,135.0,0.4,2.0,0.0,1.0,2.5,
552,3,2,0,2,3,4,2,7,6,82.0,0.75,2.0,0.0,0.6666666666666666,2.0,
1180,1,1,0,0,1,1,1,2,1,0.0,1.0,0.0,0.0,0.0,0.0,
858,15,3,1,8,16,11,8,27,26,323.0,1.4545454545454546,6.090909090909091,0.9917355371900826,1.753643578643579,1.1015625,
1122,0,1,1,0,1,1,1,2,1,0.0,1.0,0.0,0.0,0.0,0.0,
11,8,3,1,6,9,9,6,18,17,98.0,1.0,4.222222222222222,1.0617283950617287,1.411904761904762,2.1875,
881,1,1,0,0,1,1,1,2,1,0.0,1.0,0.0,0.0,0.0,0.0,
435,1,1,0,4,1,5,1,6,5,29.0,0.2,1.0,0.0,0.0,2.5,
216,1,1,0,0,1,1,1,2,1,0.0,1.0,0.0,0.0,0.0,0.0,
1186,2,0,0,3,2,3,2,5,4,62.0,0.6666666666666666,1.3333333333333333,0.2222222222222222,0.5,1.5,
139,2,1,1,0,3,1,3,4,3,22.0,3.0,3.0,0.0,1.5,0.375,
990,4,1,0,1,4,2,4,6,5,47.0,2.0,3.0,1.0,1.1666666666666665,0.75,
442,6,5,0,5,6,10,4,16,15,314.0,0.6,2.8,0.5599999999999999,1.4166666666666665,4.0,
392,1,1,0,0,1,1,1,2,1,0.0,1.0,0.0,0.0,0.0,0.0,
771,1,0,0,1,1,1,1,2,1,0.0,1.0,0.0,0.0,0.0,0.0,
1093,4,2,1,3,5,5,5,10,9,202.0,1.0,4.4,1.44,1.1666666666666665,1.125,
642,1,1,0,0,1,1,1,2,1,0.0,1.0,0.0,0.0,0.0,0.0,
1118,17,9,0,17,17,26,5,43,42,313.0,0.6538461538461539,3.3076923076923075,1.828402366863905,2.2380952380952377,8.71875,
393,5,1,2,6,7,7,3,14,13,157.0,1.0,2.4285714285714284,0.5306122448979592,1.3,3.0,
538,12,8,0,15,12,23,6,35,34,549.0,0.5217391304347826,2.739130434782609,2.01890359168242,1.7452380952380953,8.78125,
1117,1,1,0,2,1,3,1,4,3,39.0,0.3333333333333333,1.0,0.0,0.0,1.5,
680,1,1,0,1,1,2,1,3,2,15.0,0.5,1.0,0.0,0.0,1.0,
133,2,0,1,2,3,2,3,5,4,42.0,1.5,2.5,0.25,1.0,0.875,
190,2,1,1,0,3,1,3,4,3,33.0,3.0,3.0,0.0,1.5,0.375,
437,2,1,0,1,2,2,2,4,3,50.0,1.0,1.5,0.25,0.5,1.0,
352,12,5,1,12,13,17,5,30,29,264.0,0.7647058823529411,2.8823529411764706,1.5155709342560555,2.1452380952380947,6.3125,
650,1,0,0,3,1,3,1,4,3,12.0,0.3333333333333333,1.0,0.0,0.0,1.5,
21,9,1,1,8,10,9,6,19,18,317.0,1.1111111111111112,4.888888888888889,2.320987654320987,1.8000000000000003,1.59375,
759,2,2,0,2,2,4,2,6,5,78.0,0.5,1.25,0.1875,0.5,2.0,
799,1,0,0,1,1,1,1,2,1,0.0,1.0,0.0,0.0,0.0,0.0,
802,2,1,0,2,2,3,2,5,4,152.0,0.6666666666666666,1.6666666666666667,0.2222222222222222,0.5,1.5,
991,3,3,1,3,4,6,4,10,9,95.0,0.6666666666666666,3.5,0.25,1.3333333333333333,1.875,
360,1,1,0,0,1,1,1,2,1,0.0,1.0,0.0,0.0,0.0,0.0,
59,22,20,5,23,27,43,8,70,69,436.0,0.627906976744186,4.488372093023256,3.366143861546782,3.1377705627705628,9.796875,
119,22,16,2,29,24,45,5,69,68,212.0,0.5333333333333333,3.2444444444444445,1.0735802469135802,3.4440476190476184,15.5625,
425,2,3,0,3,2,6,2,8,7,67.0,0.3333333333333333,1.1666666666666667,0.13888888888888887,0.5,3.0,
608,1,1,0,0,1,1,1,2,1,0.0,1.0,0.0,0.0,0.0,0.0,
539,2,3,0,0,2,3,2,5,4,104.0,0.6666666666666666,1.3333333333333333,0.2222222222222222,0.5,1.5,
144,1,0,2,1,3,1,3,4,3,94.0,3.0,3.0,0.0,1.5,0.375,
647,1,0,0,1,1,1,1,2,1,0.0,1.0,0.0,0.0,0.0,0.0,
755,1,1,0,0,1,1,1,2,1,0.0,1.0,0.0,0.0,0.0,0.0,
1001,0,0,1,1,1,1,1,2,1,0.0,1.0,0.0,0.0,0.0,0.0,
846,2,0,0,3,2,3,2,5,4,96.0,0.6666666666666666,2.0,0.0,1.0,1.5,
558,0,0,1,1,1,1,1,2,1,0.0,1.0,0.0,0.0,0.0,0.0,
1043,2,1,0,1,2,2,2,4,3,23.0,1.0,2.0,0.0,1.0,1.0,
877,5,2,1,6,6,8,5,14,13,207.0,0.75,3.25,1.1875,1.2833333333333332,2.65625,
536,1,0,0,1,1,1,1,2,1,0.0,1.0,0.0,0.0,0.0,0.0,
640,1,0,0,1,1,1,1,2,1,0.0,1.0,0.0,0.0,0.0,0.0,
1142,1,0,0,1,1,1,1,2,1,0.0,1.0,0.0,0.0,0.0,0.0,
872,1,0,0,1,1,1,1,2,1,0.0,1.0,0.0,0.0,0.0,0.0,
255,1,1,1,4,2,5,2,7,6,115.0,0.4,1.4,0.24,0.5,2.5,
374,6,3,1,9,7,12,6,19,18,311.0,0.5833333333333334,3.25,1.0208333333333333,1.2333333333333334,4.21875,
191,0,0,1,1,1,1,1,2,1,0.0,1.0,0.0,0.0,0.0,0.0,
1265,2,2,0,1,2,3,2,5,4,64.0,0.6666666666666666,1.3333333333333333,0.2222222222222222,0.5,1.5,
592,1,0,0,1,1,1,1,2,1,0.0,1.0,0.0,0.0,0.0,0.0,
922,1,0,0,2,1,2,1,3,2,14.0,0.5,1.0,0.0,0.0,1.0,
342,2,1,0,2,2,3,2,5,4,123.0,0.6666666666666666,2.0,0.0,1.0,1.5,
1218,3,1,0,1,3,2,2,5,4,157.0,1.5,2.0,0.0,0.6666666666666666,1.0,
625,3,5,0,6,3,11,2,14,13,170.0,0.2727272727272727,1.4545454545454546,0.24793388429752064,0.6666666666666666,5.5,
224,5,5,2,10,7,15,6,22,21,230.0,0.4666666666666667,3.7333333333333334,1.128888888888889,1.2333333333333334,4.4375,
683,1,0,0,1,1,1,1,2,1,0.0,1.0,0.0,0.0,0.0,0.0,
39,12,6,2,12,14,18,7,32,31,203.0,0.7777777777777778,3.6666666666666665,2.5555555555555554,1.7773809523809523,5.7109375,
280,0,0,1,2,1,2,1,3,2,42.0,0.5,1.0,0.0,0.0,1.0,
661,1,0,1,1,2,1,2,3,2,87.0,2.0,2.0,0.0,1.0,0.5,
1106,2,4,0,0,2,4,2,6,5,13.0,0.5,1.25,0.1875,0.5,2.0,
1125,7,5,1,9,8,14,6,22,21,247.0,0.5714285714285714,3.7857142857142856,2.025510204081633,1.6333333333333333,4.15625,
617,7,4,1,7,8,11,7,19,18,271.0,0.7272727272727273,3.909090909090909,4.991735537190082,1.269047619047619,3.203125,
172,3,2,1,2,4,4,3,8,7,53.0,1.0,1.75,0.6875,0.8333333333333333,1.875,
386,1,1,0,0,1,1,1,2,1,0.0,1.0,0.0,0.0,0.0,0.0,
292,1,1,0,0,1,1,1,2,1,0.0,1.0,0.0,0.0,0.0,0.0,
110,8,6,1,3,9,9,4,18,17,74.0,1.0,2.3333333333333335,1.111111111111111,1.5833333333333333,3.875,
708,3,1,0,4,3,5,3,8,7,187.0,0.6,1.6,0.64,0.8333333333333333,2.375,
49,6,0,2,9,8,9,7,17,16,299.0,0.8888888888888888,4.222222222222222,2.3950617283950617,1.3261904761904761,2.1484375,
358,3,2,0,2,3,4,3,7,6,262.0,0.75,2.0,1.0,0.8333333333333333,1.75,
980,1,0,0,1,1,1,1,2,1,0.0,1.0,0.0,0.0,0.0,0.0,
959,1,0,0,2,1,2,1,3,2,56.0,0.5,1.0,0.0,0.0,1.0,
483,2,0,0,1,2,1,2,3,2,18.0,2.0,2.0,0.0,1.0,0.5,
1076,1,0,0,1,1,1,1,2,1,0.0,1.0,0.0,0.0,0.0,0.0,
1271,11,7,0,17,11,24,6,35,34,450.0,0.4583333333333333,3.6666666666666665,3.138888888888888,1.721428571428571,7.3125,
169,2,1,1,3,3,4,2,7,6,168.0,0.75,1.5,0.25,0.6666666666666666,2.0,
596,1,0,0,1,1,1,1,2,1,0.0,1.0,0.0,0.0,0.0,0.0,
214,4,2,1,11,5,13,5,18,17,272.0,0.38461538461538464,3.0,1.8461538461538463,1.0333333333333332,4.5625,
530,0,0,1,1,1,1,1,2,1,0.0,1.0,0.0,0.0,0.0,0.0,
411,2,3,0,1,2,4,2,6,5,41.0,0.5,1.5,0.25,0.5,2.0,
845,2,3,0,1,2,4,2,6,5,160.0,0.5,1.25,0.1875,0.5,2.0,
1254,1,0,0,1,1,1,1,2,1,0.0,1.0,0.0,0.0,0.0,0.0,
299,0,0,1,1,1,1,1,2,1,0.0,1.0,0.0,0.0,0.0,0.0,
774,4,1,0,6,4,7,3,11,10,80.0,0.5714285714285714,2.4285714285714284,0.5306122448979592,0.8333333333333333,3.0,
623,9,5,0,8,9,13,6,22,21,286.0,0.6923076923076923,3.3076923076923075,2.2130177514792893,1.4357142857142855,4.4375,
52,12,6,1,10,13,16,8,29,28,216.0,0.8125,4.9375,3.43359375,1.905952380952381,3.125,
1097,1,0,0,1,1,1,1,2,1,0.0,1.0,0.0,0.0,0.0,0.0,
1100,4,3,0,5,4,8,3,12,11,289.0,0.5,1.75,0.4375,0.8333333333333333,3.875,
155,0,1,2,0,2,1,2,3,2,6.0,2.0,2.0,0.0,1.0,0.5,
400,2,0,0,3,2,3,2,5,4,59.0,0.6666666666666666,1.3333333333333333,0.2222222222222222,0.5,1.5,
418,0,0,1,1,1,1,1,2,1,0.0,1.0,0.0,0.0,0.0,0.0,
1124,2,0,0,1,2,1,2,3,2,44.0,2.0,2.0,0.0,1.0,0.5,
574,1,0,0,1,1,1,1,2,1,0.0,1.0,0.0,0.0,0.0,0.0,
327,0,0,1,1,1,1,1,2,1,0.0,1.0,0.0,0.0,0.0,0.0,
505,1,1,1,1,2,2,2,4,3,43.0,1.0,1.5,0.25,0.5,1.0,
513,2,2,0,0,2,2,2,4,3,37.0,1.0,1.5,0.25,0.5,1.0,
529,1,1,0,1,1,2,1,3,2,9.0,0.5,1.0,0.0,0.0,1.0,
722,5,2,0,3,5,5,3,10,9,77.0,1.0,2.4,0.64,0.8999999999999999,2.125,
1004,1,1,0,1,1,2,1,3,2,9.0,0.5,1.0,0.0,0.0,1.0,
660,3,0,0,3,3,3,3,6,5,124.0,1.0,2.3333333333333335,0.22222222222222224,1.0,1.375,
1226,11,3,0,9,11,12,6,23,22,285.0,0.9166666666666666,3.9166666666666665,1.9097222222222217,1.3924603174603174,3.375,
615,1,0,0,1,1,1,1,2,1,0.0,1.0,0.0,0.0,0.0,0.0,
245,0,0,1,1,1,1,1,2,1,0.0,1.0,0.0,0.0,0.0,0.0,
562,1,2,0,0,1,2,1,3,2,5.0,0.5,1.0,0.0,0.0,1.0,
966,1,0,1,4,2,4,2,6,5,187.0,0.5,1.25,0.1875,0.5,2.0,
271,0,0,1,1,1,1,1,2,1,0.0,1.0,0.0,0.0,0.0,0.0,
84,0,1,1,1,1,2,1,3,2,0.0,0.5,1.0,0.0,0.0,1.0,
785,17,15,0,13,17,28,10,45,44,401.0,0.6071428571428571,5.285714285714286,5.13265306122449,1.6194305694305695,5.58203125,
1024,1,0,0,1,1,1,1,2,1,0.0,1.0,0.0,0.0,0.0,0.0,
507,1,1,0,0,1,1,1,2,1,0.0,1.0,0.0,0.0,0.0,0.0,
77,0,0,1,1,1,1,1,2,1,0.0,1.0,0.0,0.0,0.0,0.0,
1002,1,0,0,1,1,1,1,2,1,0.0,1.0,0.0,0.0,0.0,0.0,
500,1,0,0,1,1,1,1,2,1,0.0,1.0,0.0,0.0,0.0,0.0,
22,1,1,1,3,2,4,2,6,5,176.0,0.5,1.25,0.1875,0.5,2.0,
188,2,4,1,3,3,7,2,10,9,68.0,0.42857142857142855,1.4285714285714286,0.24489795918367346,0.6666666666666666,3.5,
1176,1,2,0,2,1,4,1,5,4,61.0,0.25,1.0,0.0,0.0,2.0,
901,1,0,0,1,1,1,1,2,1,0.0,1.0,0.0,0.0,0.0,0.0,
40,1,5,1,0,2,5,2,7,6,82.0,0.4,1.2,0.16000000000000006,0.5,2.5,
795,4,2,0,6,4,8,4,12,11,268.0,0.5,2.0,1.0,0.9166666666666665,3.625,
441,1,0,0,1,1,1,1,2,1,0.0,1.0,0.0,0.0,0.0,0.0,
1208,2,0,0,3,2,3,2,5,4,26.0,0.6666666666666666,1.6666666666666667,0.2222222222222222,0.5,1.5,
107,7,9,3,5,10,14,7,24,23,236.0,0.7142857142857143,4.071428571428571,2.352040816326531,1.4595238095238094,3.6484375,
102,9,6,2,16,11,22,5,33,32,608.0,0.5,3.1818181818181817,0.9669421487603302,1.5452380952380955,7.65625,
314,1,0,0,1,1,1,1,2,1,0.0,1.0,0.0,0.0,0.0,0.0,
1250,1,0,0,1,1,1,1,2,1,0.0,1.0,0.0,0.0,0.0,0.0,
419,1,1,0,0,1,1,1,2,1,0.0,1.0,0.0,0.0,0.0,0.0,
326,1,3,0,0,1,3,1,4,3,18.0,0.3333333333333333,1.0,0.0,0.0,1.5,
1082,1,1,0,0,1,1,1,2,1,0.0,1.0,0.0,0.0,0.0,0.0,
745,0,0,1,1,1,1,1,2,1,0.0,1.0,0.0,0.0,0.0,0.0,
792,4,3,1,4,5,7,4,12,11,312.0,0.7142857142857143,3.142857142857143,0.9795918367346939,0.9833333333333334,2.5,
217,0,1,1,0,1,1,1,2,1,0.0,1.0,0.0,0.0,0.0,0.0,
522,0,1,2,1,2,2,2,4,3,27.0,1.0,1.5,0.25,0.5,1.0,
1145,1,1,0,0,1,1,1,2,1,0.0,1.0,0.0,0.0,0.0,0.0,
1012,3,2,0,3,3,5,3,8,7,132.0,0.6,1.8,0.56,0.8333333333333333,2.375,
631,1,1,0,0,1,1,1,2,1,0.0,1.0,0.0,0.0,0.0,0.0,
621,0,0,1,1,1,1,1,2,1,0.0,1.0,0.0,0.0,0.0,0.0,
1253,1,0,1,1,2,1,2,3,2,19.0,2.0,2.0,0.0,1.0,0.5,
281,3,1,0,4,3,5,2,8,7,187.0,0.6,1.4,0.24,0.6666666666666666,2.5,
682,1,1,0,3,1,4,1,5,4,64.0,0.25,1.0,0.0,0.0,2.0,
1040,3,0,1,3,4,3,4,7,6,113.0,1.3333333333333333,3.3333333333333335,0.22222222222222224,1.3333333333333333,1.0,
1011,0,0,1,1,1,1,1,2,1,0.0,1.0,0.0,0.0,0.0,0.0,
494,6,1,1,5,7,6,3,13,12,174.0,1.1666666666666667,2.3333333333333335,0.888888888888889,1.3,2.5,
426,0,1,1,0,1,1,1,2,1,0.0,1.0,0.0,0.0,0.0,0.0,
1072,1,1,0,3,1,4,1,5,4,47.0,0.25,1.0,0.0,0.0,2.0,
405,0,0,1,1,1,1,1,2,1,0.0,1.0,0.0,0.0,0.0,0.0,
359,1,0,0,2,1,2,1,3,2,10.0,0.5,1.0,0.0,0.0,1.0,
229,0,1,1,0,1,1,1,2,1,0.0,1.0,0.0,0.0,0.0,0.0,
1085,4,1,0,1,4,2,4,6,5,79.0,2.0,3.0,1.0,1.1666666666666665,0.75,
551,3,0,0,1,3,1,3,4,3,69.0,3.0,3.0,0.0,1.5,0.375,
885,1,1,0,0,1,1,1,2,1,0.0,1.0,0.0,0.0,0.0,0.0,
758,1,1,0,0,1,1,1,2,1,0.0,1.0,0.0,0.0,0.0,0.0,
687,1,1,2,4,3,5,2,8,7,130.0,0.6,1.4,0.24,0.6666666666666666,2.5,
429,1,0,0,2,1,2,1,3,2,12.0,0.5,1.0,0.0,0.0,1.0,
251,1,1,1,0,2,1,2,3,2,22.0,2.0,2.0,0.0,1.0,0.5,
120,5,3,1,6,6,9,4,15,14,113.0,0.6666666666666666,2.4444444444444446,1.3580246913580245,1.1833333333333333,3.75,
899,1,1,0,3,1,4,1,5,4,98.0,0.25,1.0,0.0,0.0,2.0,
1248,1,1,0,2,1,3,1,4,3,36.0,0.3333333333333333,1.0,0.0,0.0,1.5,
1164,2,3,1,5,3,8,3,11,10,293.0,0.375,1.5,0.5,0.8333333333333333,3.875,
476,2,2,0,7,2,9,2,11,10,334.0,0.2222222222222222,1.4444444444444444,0.2469135802469136,0.5,4.5,
928,1,1,0,0,1,1,1,2,1,0.0,1.0,0.0,0.0,0.0,0.0,
278,1,0,1,1,2,1,2,3,2,29.0,2.0,2.0,0.0,1.0,0.5,
1169,1,1,0,0,1,1,1,2,1,0.0,1.0,0.0,0.0,0.0,0.0,
185,2,3,1,2,3,5,3,8,7,78.0,0.6,2.6,0.64,0.8333333333333333,2.0,
531,4,3,1,6,5,9,4,14,13,344.0,0.5555555555555556,2.111111111111111,0.9876543209876542,1.1666666666666665,4.0,
1193,2,3,0,2,2,5,2,7,6,124.0,0.4,1.2,0.16000000000000006,0.5,2.5,
19,0,1,1,1,1,2,1,3,2,214.0,0.5,1.0,0.0,0.0,1.0,
1000,1,1,0,0,1,1,1,2,1,0.0,1.0,0.0,0.0,0.0,0.0,
1054,1,1,0,0,1,1,1,2,1,0.0,1.0,0.0,0.0,0.0,0.0,
46,0,0,1,1,1,1,1,2,1,0.0,1.0,0.0,0.0,0.0,0.0,
619,1,2,0,0,1,2,1,3,2,74.0,0.5,1.0,0.0,0.0,1.0,
679,7,2,0,6,7,8,6,15,14,406.0,0.875,4.25,2.4375,1.2666666666666668,1.875,
235,0,0,1,1,1,1,1,2,1,0.0,1.0,0.0,0.0,0.0,0.0,
1016,1,0,0,1,1,1,1,2,1,0.0,1.0,0.0,0.0,0.0,0.0,
643,1,0,0,1,1,1,1,2,1,0.0,1.0,0.0,0.0,0.0,0.0,
656,1,0,0,1,1,1,1,2,1,0.0,1.0,0.0,0.0,0.0,0.0,
62,3,3,1,1,4,4,4,8,7,66.0,1.0,1.75,1.6875,0.9166666666666665,1.75,
985,0,0,1,1,1,1,1,2,1,0.0,1.0,0.0,0.0,0.0,0.0,
915,1,0,0,1,1,1,1,2,1,0.0,1.0,0.0,0.0,0.0,0.0,
817,2,1,0,3,2,4,2,6,5,46.0,0.5,2.0,0.0,1.0,2.0,
301,0,1,1,0,1,1,1,2,1,0.0,1.0,0.0,0.0,0.0,0.0,
516,2,0,0,2,2,2,2,4,3,42.0,1.0,1.5,0.25,0.5,1.0,
138,6,7,2,15,8,22,4,30,29,234.0,0.36363636363636365,2.590909090909091,0.7871900826446282,1.6833333333333333,9.25,
1021,1,0,0,1,1,1,1,2,1,0.0,1.0,0.0,0.0,0.0,0.0,
921,1,0,0,1,1,1,1,2,1,0.0,1.0,0.0,0.0,0.0,0.0,
900,1,1,0,0,1,1,1,2,1,0.0,1.0,0.0,0.0,0.0,0.0,
80,6,4,1,6,7,10,5,17,16,136.0,0.7,3.5,0.45,1.4333333333333333,3.15625,
735,1,0,0,1,1,1,1,2,1,0.0,1.0,0.0,0.0,0.0,0.0,
811,4,0,0,4,4,4,4,8,7,61.0,1.0,3.0,0.5,1.1666666666666665,1.5,
670,1,2,0,2,1,4,1,5,4,122.0,0.25,1.0,0.0,0.0,2.0,
892,2,2,0,2,2,4,2,6,5,70.0,0.5,1.25,0.1875,0.5,2.0,
1138,2,0,0,3,2,3,2,5,4,28.0,0.6666666666666666,1.3333333333333333,0.2222222222222222,0.5,1.5,
91,3,4,1,0,4,4,3,8,7,80.0,1.0,2.5,0.25,0.8333333333333333,1.75,
1112,1,3,0,2,1,5,1,6,5,70.0,0.2,1.0,0.0,0.0,2.5,
676,1,0,0,2,1,2,1,3,2,21.0,0.5,1.0,0.0,0.0,1.0,
135,0,0,1,1,1,1,1,2,1,0.0,1.0,0.0,0.0,0.0,0.0,
256,0,0,1,1,1,1,1,2,1,0.0,1.0,0.0,0.0,0.0,0.0,
343,1,0,0,1,1,1,1,2,1,0.0,1.0,0.0,0.0,0.0,0.0,
1027,5,6,0,5,5,11,3,16,15,376.0,0.45454545454545453,2.0,0.36363636363636365,1.0833333333333333,5.25,
131,8,5,1,4,9,9,5,18,17,105.0,1.0,4.111111111111111,1.4320987654320985,1.8833333333333333,2.28125,
115,7,2,2,4,9,6,6,15,14,138.0,1.5,4.333333333333333,2.222222222222222,1.269047619047619,1.46875,
678,1,1,0,1,1,2,1,3,2,7.0,0.5,1.0,0.0,0.0,1.0,
572,1,1,0,0,1,1,1,2,1,0.0,1.0,0.0,0.0,0.0,0.0,
573,1,1,0,0,1,1,1,2,1,0.0,1.0,0.0,0.0,0.0,0.0,
302,1,1,0,0,1,1,1,2,1,0.0,1.0,0.0,0.0,0.0,0.0,
937,3,1,0,1,3,2,2,5,4,31.0,1.5,2.0,0.0,0.6666666666666666,1.0,
1127,2,2,0,2,2,4,2,6,5,6.0,0.5,1.25,0.1875,0.5,2.0,
295,1,0,0,2,1,2,1,3,2,167.0,0.5,1.0,0.0,0.0,1.0,
1075,0,0,1,1,1,1,1,2,1,0.0,1.0,0.0,0.0,0.0,0.0,
410,1,0,0,3,1,3,1,4,3,128.0,0.3333333333333333,1.0,0.0,0.0,1.5,
1063,1,0,0,1,1,1,1,2,1,0.0,1.0,0.0,0.0,0.0,0.0,
29,0,0,2,1,2,1,2,3,2,271.0,2.0,2.0,0.0,1.0,0.5,
1143,1,0,0,1,1,1,1,2,1,0.0,1.0,0.0,0.0,0.0,0.0,
158,1,0,1,1,2,1,2,3,2,54.0,2.0,2.0,0.0,1.0,0.5,
210,3,3,2,4,5,7,4,12,11,289.0,0.7142857142857143,2.2857142857142856,0.7755102040816327,1.1666666666666665,3.125,
832,1,0,0,1,1,1,1,2,1,0.0,1.0,0.0,0.0,0.0,0.0,
232,0,2,1,0,1,2,1,3,2,5.0,0.5,1.0,0.0,0.0,1.0,
713,1,0,0,1,1,1,1,2,1,0.0,1.0,0.0,0.0,0.0,0.0,
519,8,3,1,10,9,13,5,22,21,251.0,0.6923076923076923,3.230769230769231,1.2544378698224854,1.5999999999999999,4.5625,
1031,4,4,1,4,5,8,4,13,12,197.0,0.625,2.625,1.234375,0.9833333333333334,3.125,
734,0,1,1,0,1,1,1,2,1,0.0,1.0,0.0,0.0,0.0,0.0,
840,1,1,0,0,1,1,1,2,1,0.0,1.0,0.0,0.0,0.0,0.0,
455,2,0,0,2,2,2,2,4,3,180.0,1.0,1.5,0.25,0.5,1.0,
468,1,1,0,0,1,1,1,2,1,0.0,1.0,0.0,0.0,0.0,0.0,
61,5,1,2,5,7,6,5,13,12,160.0,1.1666666666666667,4.166666666666667,1.4722222222222223,1.6666666666666665,1.5,
823,1,1,0,0,1,1,1,2,1,0.0,1.0,0.0,0.0,0.0,0.0,
870,1,0,0,1,1,1,1,2,1,0.0,1.0,0.0,0.0,0.0,0.0,
1140,0,0,1,1,1,1,1,2,1,0.0,1.0,0.0,0.0,0.0,0.0,
1055,3,1,0,0,3,1,3,4,3,49.0,3.0,3.0,0.0,1.5,0.375,
1228,1,0,1,2,2,2,2,4,3,71.0,1.0,1.5,0.25,0.5,1.0,
477,1,1,0,0,1,1,1,2,1,0.0,1.0,0.0,0.0,0.0,0.0,
1210,3,1,0,4,3,5,2,8,7,150.0,0.6,1.6,0.24,0.6666666666666666,2.5,
1096,1,1,0,0,1,1,1,2,1,0.0,1.0,0.0,0.0,0.0,0.0,
1132,2,0,0,1,2,1,2,3,2,46.0,2.0,2.0,0.0,1.0,0.5,
339,2,2,0,1,2,3,2,5,4,105.0,0.6666666666666666,2.0,0.0,1.0,1.5,
369,1,0,0,1,1,1,1,2,1,0.0,1.0,0.0,0.0,0.0,0.0,
715,1,1,0,1,1,2,1,3,2,43.0,0.5,1.0,0.0,0.0,1.0,
653,2,1,0,1,2,2,2,4,3,58.0,1.0,1.5,0.25,0.5,1.0,
177,1,1,1,0,2,1,2,3,2,2.0,2.0,2.0,0.0,1.0,0.5,
677,2,2,1,5,3,7,2,10,9,199.0,0.42857142857142855,1.4285714285714286,0.24489795918367346,0.6666666666666666,3.5,
953,1,0,0,3,1,3,1,4,3,42.0,0.3333333333333333,1.0,0.0,0.0,1.5,
394,1,1,0,0,1,1,1,2,1,0.0,1.0,0.0,0.0,0.0,0.0,
974,1,0,0,2,1,2,1,3,2,11.0,0.5,1.0,0.0,0.0,1.0,
968,11,9,0,9,11,18,10,29,28,429.0,0.6111111111111112,5.388888888888889,9.237654320987655,1.2064213564213564,3.923828125,
812,4,1,0,3,4,4,4,8,7,314.0,1.0,3.0,0.5,1.1666666666666665,1.5,
933,3,4,2,3,5,7,4,12,11,191.0,0.7142857142857143,1.7142857142857142,1.0612244897959182,0.9833333333333332,3.25,
1247,1,0,0,1,1,1,1,2,1,0.0,1.0,0.0,0.0,0.0,0.0,
1058,1,0,0,1,1,1,1,2,1,0.0,1.0,0.0,0.0,0.0,0.0,
93,0,1,1,1,1,2,1,3,2,11.0,0.5,1.0,0.0,0.0,1.0,
1203,3,0,0,1,3,1,3,4,3,9.0,3.0,3.0,0.0,1.5,0.375,
246,0,1,1,0,1,1,1,2,1,0.0,1.0,0.0,0.0,0.0,0.0,
277,1,1,0,1,1,2,1,3,2,34.0,0.5,1.0,0.0,0.0,1.0,
1022,2,1,1,3,3,4,3,7,6,282.0,0.75,2.5,0.75,0.8333333333333333,1.625,
838,4,2,1,3,5,5,5,10,9,165.0,1.0,3.2,2.16,1.0333333333333332,1.65625,
283,2,0,0,1,2,1,2,3,2,5.0,2.0,2.0,0.0,1.0,0.5,
396,1,1,0,0,1,1,1,2,1,0.0,1.0,0.0,0.0,0.0,0.0,
775,2,1,0,0,2,1,2,3,2,44.0,2.0,2.0,0.0,1.0,0.5,
855,1,0,0,1,1,1,1,2,1,0.0,1.0,0.0,0.0,0.0,0.0,
325,1,0,0,1,1,1,1,2,1,0.0,1.0,0.0,0.0,0.0,0.0,
865,1,1,0,0,1,1,1,2,1,0.0,1.0,0.0,0.0,0.0,0.0,
1077,4,3,1,4,5,7,3,12,11,167.0,0.7142857142857143,2.0,0.5714285714285714,1.0833333333333333,3.25,
323,1,0,0,1,1,1,1,2,1,0.0,1.0,0.0,0.0,0.0,0.0,
793,0,1,1,0,1,1,1,2,1,0.0,1.0,0.0,0.0,0.0,0.0,
1033,1,1,0,0,1,1,1,2,1,0.0,1.0,0.0,0.0,0.0,0.0,
1225,0,0,1,1,1,1,1,2,1,0.0,1.0,0.0,0.0,0.0,0.0,
1266,3,1,0,3,3,4,3,7,6,84.0,0.75,1.75,0.6875,0.8333333333333333,1.875,
941,1,0,0,1,1,1,1,2,1,0.0,1.0,0.0,0.0,0.0,0.0,
351,1,0,0,2,1,2,1,3,2,1.0,0.5,1.0,0.0,0.0,1.0,
797,27,13,1,26,28,39,15,67,66,1257.0,0.717948717948718,7.743589743589744,20.806048652202502,2.1707986457986457,6.431976318359375,
1189,1,1,0,2,1,3,1,4,3,107.0,0.3333333333333333,1.0,0.0,0.0,1.5,
1175,1,1,0,0,1,1,1,2,1,0.0,1.0,0.0,0.0,0.0,0.0,
769,2,1,0,0,2,1,2,3,2,4.0,2.0,2.0,0.0,1.0,0.5,
499,1,0,0,1,1,1,1,2,1,0.0,1.0,0.0,0.0,0.0,0.0,
762,1,0,0,1,1,1,1,2,1,0.0,1.0,0.0,0.0,0.0,0.0,
439,0,1,1,0,1,1,1,2,1,0.0,1.0,0.0,0.0,0.0,0.0,
1028,2,1,0,2,2,3,2,5,4,23.0,0.6666666666666666,1.3333333333333333,0.2222222222222222,0.5,1.5,
238,4,3,1,2,5,5,3,10,9,194.0,1.0,2.4,0.24,1.0833333333333333,2.25,
414,1,1,1,0,2,1,2,3,2,40.0,2.0,2.0,0.0,1.0,0.5,
841,1,2,0,1,1,3,1,4,3,11.0,0.3333333333333333,1.0,0.0,0.0,1.5,
1133,2,0,0,1,2,1,2,3,2,17.0,2.0,2.0,0.0,1.0,0.5,
918,2,1,0,2,2,3,2,5,4,57.0,0.6666666666666666,1.6666666666666667,0.2222222222222222,0.5,1.5,
192,0,0,1,1,1,1,1,2,1,0.0,1.0,0.0,0.0,0.0,0.0,
90,1,1,1,0,2,1,2,3,2,10.0,2.0,2.0,0.0,1.0,0.5,
162,0,1,1,0,1,1,1,2,1,0.0,1.0,0.0,0.0,0.0,0.0,
225,0,0,1,1,1,1,1,2,1,0.0,1.0,0.0,0.0,0.0,0.0,
649,1,2,1,2,2,4,2,6,5,81.0,0.5,1.25,0.1875,0.5,2.0,
626,1,1,0,0,1,1,1,2,1,0.0,1.0,0.0,0.0,0.0,0.0,
803,2,1,0,0,2,1,2,3,2,64.0,2.0,2.0,0.0,1.0,0.5,
263,1,0,0,1,1,1,1,2,1,0.0,1.0,0.0,0.0,0.0,0.0,
184,0,1,1,0,1,1,1,2,1,0.0,1.0,0.0,0.0,0.0,0.0,
948,2,1,0,1,2,2,2,4,3,45.0,1.0,2.0,0.0,1.0,1.0,
1237,0,1,1,0,1,1,1,2,1,0.0,1.0,0.0,0.0,0.0,0.0,
275,1,2,0,2,1,4,1,5,4,43.0,0.25,1.0,0.0,0.0,2.0,
965,1,0,0,1,1,1,1,2,1,0.0,1.0,0.0,0.0,0.0,0.0,
1190,1,2,0,2,1,4,1,5,4,43.0,0.25,1.0,0.0,0.0,2.0,
1030,9,5,2,12,11,17,5,28,27,366.0,0.6470588235294118,3.0588235294117645,0.9965397923875433,1.8023809523809522,6.15625,
100,4,5,1,5,5,10,4,15,14,108.0,0.5,2.7,0.6100000000000001,0.9833333333333334,4.125,
1163,1,1,1,0,2,1,2,3,2,66.0,2.0,2.0,0.0,1.0,0.5,
1123,1,1,0,0,1,1,1,2,1,0.0,1.0,0.0,0.0,0.0,0.0,
1094,2,0,1,1,3,1,3,4,3,23.0,3.0,3.0,0.0,1.5,0.375,
971,8,3,2,10,10,13,4,23,22,385.0,0.7692307692307693,2.3846153846153846,1.0059171597633136,1.7166666666666668,5.5,
471,1,0,0,1,1,1,1,2,1,0.0,1.0,0.0,0.0,0.0,0.0,
1240,1,1,0,0,1,1,1,2,1,0.0,1.0,0.0,0.0,0.0,0.0,
560,3,1,0,4,3,5,3,8,7,53.0,0.6,1.4,0.6400000000000002,0.8333333333333333,2.375,
309,1,0,0,3,1,3,1,4,3,50.0,0.3333333333333333,1.0,0.0,0.0,1.5,
763,1,1,0,0,1,1,1,2,1,0.0,1.0,0.0,0.0,0.0,0.0,
97,0,0,1,1,1,1,1,2,1,0.0,1.0,0.0,0.0,0.0,0.0,
663,1,1,0,1,1,2,1,3,2,9.0,0.5,1.0,0.0,0.0,1.0,
652,1,0,0,1,1,1,1,2,1,0.0,1.0,0.0,0.0,0.0,0.0,
813,7,3,1,13,8,16,5,24,23,391.0,0.5,2.4375,0.99609375,1.269047619047619,6.78125,
183,3,1,1,3,4,4,3,8,7,88.0,1.0,2.25,0.1875,0.8333333333333333,1.875,
479,1,0,0,1,1,1,1,2,1,0.0,1.0,0.0,0.0,0.0,0.0,
65,3,1,2,4,5,5,4,10,9,135.0,1.0,3.2,0.5599999999999999,1.5,1.75,
565,1,0,0,2,1,2,1,3,2,7.0,0.5,1.0,0.0,0.0,1.0,
168,2,3,1,2,3,5,3,8,7,128.0,0.6,2.6,0.24,1.0,2.125,
1244,0,1,1,0,1,1,1,2,1,0.0,1.0,0.0,0.0,0.0,0.0,
748,1,0,0,2,1,2,1,3,2,4.0,0.5,1.0,0.0,0.0,1.0,
1065,4,2,1,9,5,11,3,16,15,326.0,0.45454545454545453,2.3636363636363638,0.4132231404958678,1.0833333333333333,4.875,
956,0,1,1,0,1,1,1,2,1,0.0,1.0,0.0,0.0,0.0,0.0,
728,1,2,0,1,1,3,1,4,3,41.0,0.3333333333333333,1.0,0.0,0.0,1.5,
28,6,6,1,8,7,14,5,21,20,224.0,0.5,2.642857142857143,1.5153061224489794,1.4833333333333334,5.40625,
655,1,0,0,4,1,4,1,5,4,53.0,0.25,1.0,0.0,0.0,2.0,
723,2,3,0,2,2,5,2,7,6,149.0,0.4,1.2,0.16000000000000006,0.5,2.5,
134,1,2,1,2,2,4,2,6,5,24.0,0.5,1.5,0.25,0.5,2.0,
47,0,2,1,1,1,3,1,4,3,44.0,0.3333333333333333,1.0,0.0,0.0,1.5,
976,0,0,1,1,1,1,1,2,1,0.0,1.0,0.0,0.0,0.0,0.0,
7,25,16,6,29,31,45,7,76,75,396.0,0.6888888888888889,4.177777777777778,2.1906172839506173,3.442965367965368,11.4609375,
1160,1,0,0,1,1,1,1,2,1,0.0,1.0,0.0,0.0,0.0,0.0,
204,3,4,2,6,5,10,3,15,14,257.0,0.5,2.0,0.4,1.0833333333333333,4.75,
408,1,0,0,1,1,1,1,2,1,0.0,1.0,0.0,0.0,0.0,0.0,
15,8,6,2,10,10,16,6,26,25,550.0,0.625,4.25,1.3125,1.7999999999999998,3.84375,
1047,1,0,0,3,1,3,1,4,3,153.0,0.3333333333333333,1.0,0.0,0.0,1.5,
32,17,7,1,17,18,24,6,42,41,198.0,0.75,3.625,1.734375,2.3626984126984127,7.53125,
815,1,3,0,3,1,6,1,7,6,97.0,0.16666666666666666,1.0,0.0,0.0,3.0,
86,31,12,4,40,35,52,8,87,86,445.0,0.6730769230769231,3.9038461538461537,3.433062130177516,3.1767538017538026,14.8359375,
729,1,0,0,2,1,2,1,3,2,28.0,0.5,1.0,0.0,0.0,1.0,
1121,0,0,1,2,1,2,1,3,2,58.0,0.5,1.0,0.0,0.0,1.0,
716,1,1,0,0,1,1,1,2,1,0.0,1.0,0.0,0.0,0.0,0.0,
1214,4,1,1,5,5,6,5,11,10,383.0,0.8333333333333334,3.6666666666666665,1.5555555555555554,1.0333333333333332,1.65625,
79,1,3,1,1,2,4,2,6,5,181.0,0.5,1.75,0.1875,0.5,2.0,
1070,1,2,0,2,1,4,1,5,4,91.0,0.25,1.0,0.0,0.0,2.0,
916,1,0,0,2,1,2,1,3,2,15.0,0.5,1.0,0.0,0.0,1.0,
194,0,2,1,0,1,2,1,3,2,14.0,0.5,1.0,0.0,0.0,1.0,
1003,1,1,0,0,1,1,1,2,1,0.0,1.0,0.0,0.0,0.0,0.0,
636,0,1,1,0,1,1,1,2,1,0.0,1.0,0.0,0.0,0.0,0.0,
906,2,0,0,3,2,3,2,5,4,130.0,0.6666666666666666,1.6666666666666667,0.2222222222222222,0.5,1.5,
880,1,0,0,1,1,1,1,2,1,0.0,1.0,0.0,0.0,0.0,0.0,
975,1,0,0,1,1,1,1,2,1,0.0,1.0,0.0,0.0,0.0,0.0,
917,2,2,0,4,2,6,2,8,7,188.0,0.3333333333333333,1.6666666666666667,0.22222222222222224,0.5,3.0,
237,1,0,1,2,2,2,2,4,3,141.0,1.0,2.0,0.0,1.0,1.0,
780,1,1,1,1,2,2,2,4,3,64.0,1.0,1.5,0.25,0.5,1.0,
557,8,1,2,10,10,11,6,21,20,275.0,0.9090909090909091,3.5454545454545454,1.702479338842975,1.8333333333333333,3.375,
482,0,0,1,1,1,1,1,2,1,0.0,1.0,0.0,0.0,0.0,0.0,
485,4,1,1,5,5,6,4,11,10,362.0,0.8333333333333334,3.3333333333333335,1.2222222222222223,1.1666666666666665,1.875,
130,0,0,1,1,1,1,1,2,1,0.0,1.0,0.0,0.0,0.0,0.0,
786,1,1,0,0,1,1,1,2,1,0.0,1.0,0.0,0.0,0.0,0.0,
609,1,0,0,1,1,1,1,2,1,0.0,1.0,0.0,0.0,0.0,0.0,
165,0,2,1,1,1,3,1,4,3,88.0,0.3333333333333333,1.0,0.0,0.0,1.5,
304,0,1,1,0,1,1,1,2,1,0.0,1.0,0.0,0.0,0.0,0.0,
334,1,0,0,1,1,1,1,2,1,0.0,1.0,0.0,0.0,0.0,0.0,
64,1,2,1,1,2,3,2,5,4,139.0,0.6666666666666666,1.3333333333333333,0.2222222222222222,0.5,1.5,
71,3,1,2,1,5,2,5,7,6,76.0,2.5,4.0,1.0,1.4166666666666665,0.53125,
508,3,4,0,3,3,7,2,10,9,153.0,0.42857142857142855,1.7142857142857142,0.20408163265306123,0.6666666666666666,3.5,
297,2,2,0,1,2,3,2,5,4,77.0,0.6666666666666666,1.6666666666666667,0.2222222222222222,0.5,1.5,
276,0,0,1,1,1,1,1,2,1,0.0,1.0,0.0,0.0,0.0,0.0,
153,2,1,1,4,3,5,3,8,7,165.0,0.6,2.6,0.24,1.0,2.125,
874,2,1,0,1,2,2,2,4,3,12.0,1.0,2.0,0.0,1.0,1.0,
584,1,0,0,1,1,1,1,2,1,0.0,1.0,0.0,0.0,0.0,0.0,
1217,5,4,0,5,5,9,3,14,13,158.0,0.5555555555555556,2.0,0.6666666666666666,1.0833333333333333,4.125,
741,2,2,0,0,2,2,2,4,3,24.0,1.0,2.0,0.0,1.0,1.0,
308,6,1,0,7,6,8,4,14,13,233.0,0.75,2.625,1.234375,1.2333333333333334,3.25,
1069,1,0,0,1,1,1,1,2,1,0.0,1.0,0.0,0.0,0.0,0.0,
452,3,3,0,0,3,3,3,6,5,94.0,1.0,2.0,0.6666666666666666,0.8333333333333333,1.375,
853,1,0,0,2,1,2,1,3,2,6.0,0.5,1.0,0.0,0.0,1.0,
300,2,1,0,1,2,2,2,4,3,46.0,1.0,2.0,0.0,1.0,1.0,
504,6,1,3,6,9,7,5,16,15,202.0,1.2857142857142858,2.857142857142857,1.5510204081632655,1.3785714285714286,2.65625,
704,1,2,0,0,1,2,1,3,2,1.0,0.5,1.0,0.0,0.0,1.0,
324,1,0,0,1,1,1,1,2,1,0.0,1.0,0.0,0.0,0.0,0.0,
1090,0,0,1,1,1,1,1,2,1,0.0,1.0,0.0,0.0,0.0,0.0,
1139,1,0,0,1,1,1,1,2,1,0.0,1.0,0.0,0.0,0.0,0.0,
1165,1,1,0,0,1,1,1,2,1,0.0,1.0,0.0,0.0,0.0,0.0,
16,0,0,1,1,1,1,1,2,1,0.0,1.0,0.0,0.0,0.0,0.0,
416,1,0,0,1,1,1,1,2,1,0.0,1.0,0.0,0.0,0.0,0.0,
730,1,1,0,0,1,1,1,2,1,0.0,1.0,0.0,0.0,0.0,0.0,
310,2,0,1,4,3,4,3,7,6,130.0,0.75,1.75,0.6875,0.8333333333333333,1.875,
555,1,0,1,2,2,2,2,4,3,28.0,1.0,1.5,0.25,0.5,1.0,
1010,5,4,2,7,7,11,3,18,17,208.0,0.6363636363636364,1.7272727272727273,0.5619834710743802,1.4,5.25,
111,3,1,1,2,4,3,4,7,6,116.0,1.3333333333333333,2.6666666666666665,0.8888888888888888,1.1666666666666665,1.25,
114,1,0,1,1,2,1,2,3,2,37.0,2.0,2.0,0.0,1.0,0.5,
756,1,0,0,1,1,1,1,2,1,0.0,1.0,0.0,0.0,0.0,0.0,
496,2,0,0,1,2,1,2,3,2,50.0,2.0,2.0,0.0,1.0,0.5,
924,1,0,0,1,1,1,1,2,1,0.0,1.0,0.0,0.0,0.0,0.0,
1099,3,1,0,3,3,4,2,7,6,90.0,0.75,2.0,0.0,0.6666666666666666,2.0,
1183,2,1,1,4,3,5,3,8,7,71.0,0.6,1.6,0.64,0.8333333333333333,2.375,
691,1,2,0,0,1,2,1,3,2,8.0,0.5,1.0,0.0,0.0,1.0,
69,0,1,1,0,1,1,1,2,1,0.0,1.0,0.0,0.0,0.0,0.0,
842,1,0,0,1,1,1,1,2,1,0.0,1.0,0.0,0.0,0.0,0.0,
219,3,2,1,3,4,5,3,9,8,68.0,0.8,2.4,0.24,0.8333333333333333,2.25,
895,1,1,0,0,1,1,1,2,1,0.0,1.0,0.0,0.0,0.0,0.0,
1150,2,0,0,1,2,1,2,3,2,39.0,2.0,2.0,0.0,1.0,0.5,
298,3,2,0,8,3,10,3,13,12,235.0,0.3,2.6,0.24000000000000005,1.0,4.25,
764,1,1,0,2,1,3,1,4,3,63.0,0.3333333333333333,1.0,0.0,0.0,1.5,
692,1,1,0,0,1,1,1,2,1,0.0,1.0,0.0,0.0,0.0,0.0,
754,0,1,1,0,1,1,1,2,1,0.0,1.0,0.0,0.0,0.0,0.0,
125,17,15,3,19,20,34,7,54,53,305.0,0.5882352941176471,4.617647058823529,2.05968858131488,2.403174603174603,7.4609375,
145,10,5,1,11,11,16,5,27,26,149.0,0.6875,3.125,0.609375,2.0,5.78125,
616,8,3,1,7,9,10,6,19,18,324.0,0.9,3.1,3.4900000000000007,1.4119047619047618,3.59375,
465,2,1,0,3,2,4,2,6,5,94.0,0.5,1.5,0.25,0.5,2.0,
1222,1,1,0,0,1,1,1,2,1,0.0,1.0,0.0,0.0,0.0,0.0,
228,0,0,1,1,1,1,1,2,1,0.0,1.0,0.0,0.0,0.0,0.0,
907,3,0,0,2,3,2,3,5,4,127.0,1.5,2.0,1.0,0.8333333333333333,0.875,
710,1,0,0,2,1,2,1,3,2,2.0,0.5,1.0,0.0,0.0,1.0,
385,1,1,0,0,1,1,1,2,1,0.0,1.0,0.0,0.0,0.0,0.0,
340,1,1,0,0,1,1,1,2,1,0.0,1.0,0.0,0.0,0.0,0.0,
489,1,0,0,1,1,1,1,2,1,0.0,1.0,0.0,0.0,0.0,0.0,
1153,2,0,0,2,2,2,2,4,3,105.0,1.0,1.5,0.25,0.5,1.0,
752,1,0,0,1,1,1,1,2,1,0.0,1.0,0.0,0.0,0.0,0.0,
773,1,2,0,1,1,3,1,4,3,21.0,0.3333333333333333,1.0,0.0,0.0,1.5,
903,3,0,1,2,4,2,4,6,5,114.0,2.0,4.0,0.0,1.8333333333333333,0.5,
397,1,1,0,0,1,1,1,2,1,0.0,1.0,0.0,0.0,0.0,0.0,
222,7,4,0,4,7,8,5,15,14,97.0,0.875,2.375,1.734375,1.2,3.40625,
1168,2,0,1,2,3,2,3,5,4,103.0,1.5,2.0,1.0,0.8333333333333333,0.875,
1078,1,1,0,0,1,1,1,2,1,0.0,1.0,0.0,0.0,0.0,0.0,
1207,1,0,0,1,1,1,1,2,1,0.0,1.0,0.0,0.0,0.0,0.0,
1006,2,1,0,1,2,2,2,4,3,34.0,1.0,1.5,0.25,0.5,1.0,
852,1,1,0,0,1,1,1,2,1,0.0,1.0,0.0,0.0,0.0,0.0,
1108,1,1,0,0,1,1,1,2,1,0.0,1.0,0.0,0.0,0.0,0.0,
241,4,5,0,4,4,9,4,13,12,232.0,0.4444444444444444,2.111111111111111,1.2098765432098766,0.9166666666666666,3.875,
590,1,0,0,1,1,1,1,2,1,0.0,1.0,0.0,0.0,0.0,0.0,
1114,2,0,0,1,2,1,2,3,2,41.0,2.0,2.0,0.0,1.0,0.5,
927,1,1,0,1,1,2,1,3,2,40.0,0.5,1.0,0.0,0.0,1.0,
888,1,0,0,1,1,1,1,2,1,0.0,1.0,0.0,0.0,0.0,0.0,
10,0,0,1,1,1,1,1,2,1,0.0,1.0,0.0,0.0,0.0,0.0,
720,1,1,1,0,2,1,2,3,2,130.0,2.0,2.0,0.0,1.0,0.5,
104,0,2,1,1,1,3,1,4,3,69.0,0.3333333333333333,1.0,0.0,0.0,1.5,
1103,1,0,0,1,1,1,1,2,1,0.0,1.0,0.0,0.0,0.0,0.0,
404,1,0,0,1,1,1,1,2,1,0.0,1.0,0.0,0.0,0.0,0.0,
296,3,3,0,6,3,9,3,12,11,325.0,0.3333333333333333,2.3333333333333335,0.4444444444444444,0.8333333333333333,4.0,
1042,1,0,0,1,1,1,1,2,1,0.0,1.0,0.0,0.0,0.0,0.0,
851,1,0,0,1,1,1,1,2,1,0.0,1.0,0.0,0.0,0.0,0.0,
488,1,2,0,3,1,5,1,6,5,72.0,0.2,1.0,0.0,0.0,2.5,
524,10,6,0,11,10,17,6,27,26,275.0,0.5882352941176471,3.4705882352941178,0.8373702422145327,1.6119047619047617,5.46875,
887,4,0,1,8,5,8,4,13,12,157.0,0.625,2.625,0.484375,1.1666666666666665,3.375,
550,1,0,0,2,1,2,1,3,2,31.0,0.5,1.0,0.0,0.0,1.0,
148,2,3,1,3,3,6,3,9,8,79.0,0.5,2.3333333333333335,0.5555555555555556,0.8333333333333333,2.625,
187,0,1,1,3,1,4,1,5,4,87.0,0.25,1.0,0.0,0.0,2.0,
1200,1,2,0,3,1,5,1,6,5,165.0,0.2,1.0,0.0,0.0,2.5,
778,1,1,0,0,1,1,1,2,1,0.0,1.0,0.0,0.0,0.0,0.0,
1131,2,3,0,3,2,6,2,8,7,192.0,0.3333333333333333,1.1666666666666667,0.1388888888888889,0.5,3.0,
112,7,4,1,4,8,8,5,16,15,101.0,1.0,3.25,1.9375,1.2119047619047618,2.6875,
464,7,4,1,5,8,9,6,17,16,105.0,0.8888888888888888,3.3333333333333335,1.3333333333333335,1.269047619047619,3.09375,
20,21,15,1,26,22,41,6,63,62,472.0,0.5365853658536586,3.341463414634146,1.395597858417608,2.97579365079365,13.3125,
667,1,1,0,0,1,1,1,2,1,0.0,1.0,0.0,0.0,0.0,0.0,
606,1,1,1,1,2,2,2,4,3,24.0,1.0,2.0,0.0,1.0,1.0,
549,1,0,0,1,1,1,1,2,1,0.0,1.0,0.0,0.0,0.0,0.0,
622,1,1,0,2,1,3,1,4,3,24.0,0.3333333333333333,1.0,0.0,0.0,1.5,
368,1,1,0,2,1,3,1,4,3,81.0,0.3333333333333333,1.0,0.0,0.0,1.5,
1245,1,0,1,5,2,5,2,7,6,98.0,0.4,1.2,0.16,0.5,2.5,
182,4,5,1,6,5,11,3,16,15,140.0,0.45454545454545453,2.272727272727273,0.38016528925619836,1.0833333333333333,5.0,
857,0,0,2,1,2,1,2,3,2,57.0,2.0,2.0,0.0,1.0,0.5,
268,0,0,1,1,1,1,1,2,1,0.0,1.0,0.0,0.0,0.0,0.0,
603,2,1,0,0,2,1,2,3,2,12.0,2.0,2.0,0.0,1.0,0.5,
179,2,0,1,1,3,1,3,4,3,64.0,3.0,3.0,0.0,1.5,0.375,
17,0,0,1,1,1,1,1,2,1,0.0,1.0,0.0,0.0,0.0,0.0,
1014,4,2,1,5,5,7,4,12,11,207.0,0.7142857142857143,2.857142857142857,0.6938775510204082,0.9833333333333334,2.75,
338,1,0,0,1,1,1,1,2,1,0.0,1.0,0.0,0.0,0.0,0.0,
630,1,1,0,1,1,2,1,3,2,27.0,0.5,1.0,0.0,0.0,1.0,
987,2,3,1,7,3,10,2,13,12,177.0,0.3,1.6,0.24000000000000005,0.6666666666666666,5.0,
637,1,1,0,1,1,2,1,3,2,6.0,0.5,1.0,0.0,0.0,1.0,
935,0,1,1,0,1,1,1,2,1,0.0,1.0,0.0,0.0,0.0,0.0,
1198,7,2,1,8,8,10,6,18,17,315.0,0.8,3.8,2.7600000000000007,1.1023809523809522,2.71875,
829,1,1,0,0,1,1,1,2,1,0.0,1.0,0.0,0.0,0.0,0.0,
142,0,0,1,1,1,1,1,2,1,0.0,1.0,0.0,0.0,0.0,0.0,
436,2,1,1,3,3,4,2,7,6,306.0,0.75,1.5,0.25,0.6666666666666666,2.0,
544,7,5,2,10,9,15,6,24,23,256.0,0.6,3.8,2.6933333333333334,1.6333333333333333,4.25,
511,1,0,0,2,1,2,1,3,2,12.0,0.5,1.0,0.0,0.0,1.0,
776,1,0,0,1,1,1,1,2,1,0.0,1.0,0.0,0.0,0.0,0.0,
1161,3,1,0,2,3,3,3,6,5,203.0,1.0,2.3333333333333335,0.8888888888888888,0.8333333333333333,1.25,
486,1,1,0,1,1,2,1,3,2,24.0,0.5,1.0,0.0,0.0,1.0,
751,0,0,1,1,1,1,1,2,1,0.0,1.0,0.0,0.0,0.0,0.0,
1017,1,1,1,0,2,1,2,3,2,39.0,2.0,2.0,0.0,1.0,0.5,
37,0,1,1,2,1,3,1,4,3,61.0,0.3333333333333333,1.0,0.0,0.0,1.5,
929,1,1,0,0,1,1,1,2,1,0.0,1.0,0.0,0.0,0.0,0.0,
264,1,2,1,3,2,5,2,7,6,206.0,0.4,1.6,0.24,0.5,2.5,
1252,1,1,0,1,1,2,1,3,2,14.0,0.5,1.0,0.0,0.0,1.0,
826,1,1,0,1,1,2,1,3,2,1.0,0.5,1.0,0.0,0.0,1.0,
1064,1,1,0,0,1,1,1,2,1,0.0,1.0,0.0,0.0,0.0,0.0,
279,0,0,1,1,1,1,1,2,1,0.0,1.0,0.0,0.0,0.0,0.0,
525,0,0,1,1,1,1,1,2,1,0.0,1.0,0.0,0.0,0.0,0.0,
1216,2,0,0,1,2,1,2,3,2,34.0,2.0,2.0,0.0,1.0,0.5,
307,1,0,0,2,1,2,1,3,2,30.0,0.5,1.0,0.0,0.0,1.0,
98,7,0,2,16,9,16,5,25,24,273.0,0.5625,2.1875,1.52734375,1.2357142857142855,6.78125,
1154,2,1,0,1,2,2,2,4,3,105.0,1.0,2.0,0.0,1.0,1.0,
447,1,0,0,1,1,1,1,2,1,0.0,1.0,0.0,0.0,0.0,0.0,
261,0,0,1,1,1,1,1,2,1,0.0,1.0,0.0,0.0,0.0,0.0,
867,1,1,0,0,1,1,1,2,1,0.0,1.0,0.0,0.0,0.0,0.0,
203,0,0,1,1,1,1,1,2,1,0.0,1.0,0.0,0.0,0.0,0.0,
767,3,2,0,2,3,4,3,7,6,180.0,0.75,2.0,0.5,0.8333333333333333,1.875,
804,1,0,0,2,1,2,1,3,2,1.0,0.5,1.0,0.0,0.0,1.0,
383,1,1,0,1,1,2,1,3,2,1.0,0.5,1.0,0.0,0.0,1.0,
946,1,0,0,1,1,1,1,2,1,0.0,1.0,0.0,0.0,0.0,0.0,
597,4,0,0,5,4,5,4,9,8,160.0,0.8,2.0,1.2,0.9166666666666665,2.25,
378,1,0,0,2,1,2,1,3,2,24.0,0.5,1.0,0.0,0.0,1.0,
1041,3,2,1,2,4,4,2,8,7,111.0,1.0,2.0,0.0,1.0,2.0,
1199,2,1,0,1,2,2,2,4,3,24.0,1.0,1.5,0.25,0.5,1.0,
726,1,2,0,1,1,3,1,4,3,53.0,0.3333333333333333,1.0,0.0,0.0,1.5,
202,5,6,3,7,8,13,5,21,20,274.0,0.6153846153846154,2.076923076923077,0.9940828402366862,1.2357142857142858,6.03125,
70,2,1,1,4,3,5,3,8,7,23.0,0.6,2.0,0.8,0.8333333333333333,2.25,
520,1,1,0,2,1,3,1,4,3,33.0,0.3333333333333333,1.0,0.0,0.0,1.5,
322,1,0,0,1,1,1,1,2,1,0.0,1.0,0.0,0.0,0.0,0.0,
905,4,5,0,2,4,7,4,11,10,224.0,0.5714285714285714,3.0,1.4285714285714286,0.9166666666666665,2.5,
1048,2,1,0,1,2,2,2,4,3,2.0,1.0,2.0,0.0,1.0,1.0,
484,1,1,0,0,1,1,1,2,1,0.0,1.0,0.0,0.0,0.0,0.0,
1147,1,0,0,1,1,1,1,2,1,0.0,1.0,0.0,0.0,0.0,0.0,
260,0,1,1,0,1,1,1,2,1,0.0,1.0,0.0,0.0,0.0,0.0,
736,5,3,0,6,5,9,3,14,13,264.0,0.5555555555555556,2.111111111111111,0.54320987654321,0.9,4.125,
391,1,1,0,0,1,1,1,2,1,0.0,1.0,0.0,0.0,0.0,0.0,
233,6,4,0,9,6,13,3,19,18,84.0,0.46153846153846156,2.3846153846153846,0.3905325443786983,1.15,5.75,
1267,1,0,0,1,1,1,1,2,1,0.0,1.0,0.0,0.0,0.0,0.0,
382,0,0,2,1,2,1,2,3,2,40.0,2.0,2.0,0.0,1.0,0.5,
994,1,0,0,1,1,1,1,2,1,0.0,1.0,0.0,0.0,0.0,0.0,
226,0,0,1,1,1,1,1,2,1,0.0,1.0,0.0,0.0,0.0,0.0,
761,1,0,0,1,1,1,1,2,1,0.0,1.0,0.0,0.0,0.0,0.0,
1219,1,0,0,1,1,1,1,2,1,0.0,1.0,0.0,0.0,0.0,0.0,
469,2,0,0,2,2,2,2,4,3,46.0,1.0,1.5,0.25,0.5,1.0,
1201,4,3,0,1,4,4,4,8,7,97.0,1.0,2.75,0.6875,1.1666666666666665,1.625,
578,2,0,0,2,2,2,2,4,3,10.0,1.0,1.5,0.25,0.5,1.0,
535,1,1,0,0,1,1,1,2,1,0.0,1.0,0.0,0.0,0.0,0.0,
376,1,0,0,2,1,2,1,3,2,36.0,0.5,1.0,0.0,0.0,1.0,
1235,2,1,0,1,2,2,2,4,3,29.0,1.0,2.0,0.0,1.0,1.0,
707,1,0,0,2,1,2,1,3,2,10.0,0.5,1.0,0.0,0.0,1.0,
1178,2,3,0,2,2,5,2,7,6,111.0,0.4,1.6,0.24,0.5,2.5,
1166,2,1,0,2,2,3,2,5,4,50.0,0.6666666666666666,2.0,0.0,1.0,1.5,
377,1,1,0,0,1,1,1,2,1,0.0,1.0,0.0,0.0,0.0,0.0,
582,1,1,0,0,1,1,1,2,1,0.0,1.0,0.0,0.0,0.0,0.0,
417,1,1,0,0,1,1,1,2,1,0.0,1.0,0.0,0.0,0.0,0.0,
1074,2,1,0,4,2,5,2,7,6,186.0,0.4,1.6,0.24,0.5,2.5,
635,2,1,0,1,2,2,2,4,3,130.0,1.0,1.5,0.25,0.5,1.0,
220,1,3,2,1,3,4,3,7,6,58.0,0.75,2.5,0.25,1.0,1.75,
575,8,7,0,6,8,13,6,21,20,440.0,0.6153846153846154,3.076923076923077,2.8402366863905324,1.4333333333333333,4.59375,
1234,1,1,0,2,1,3,1,4,3,36.0,0.3333333333333333,1.0,0.0,0.0,1.5,
750,3,2,0,4,3,6,3,9,8,122.0,0.5,2.3333333333333335,0.8888888888888888,0.8333333333333333,2.5,
506,1,0,1,1,2,1,2,3,2,50.0,2.0,2.0,0.0,1.0,0.5,
303,1,0,0,1,1,1,1,2,1,0.0,1.0,0.0,0.0,0.0,0.0,
0,3,1,1,3,4,4,3,8,7,130.0,1.0,2.75,0.1875,1.1666666666666665,1.625,
576,0,0,1,1,1,1,1,2,1,0.0,1.0,0.0,0.0,0.0,0.0,
174,2,1,1,6,3,7,3,10,9,63.0,0.42857142857142855,2.0,0.2857142857142857,0.8333333333333333,3.375,
335,1,0,0,1,1,1,1,2,1,0.0,1.0,0.0,0.0,0.0,0.0,
116,5,3,1,6,6,9,4,15,14,191.0,0.6666666666666666,3.111111111111111,0.7654320987654322,1.1833333333333333,3.25,
1148,1,0,0,1,1,1,1,2,1,0.0,1.0,0.0,0.0,0.0,0.0,
175,1,2,1,0,2,2,2,4,3,6.0,1.0,1.5,0.25,0.5,1.0,
68,17,5,1,15,18,20,6,38,37,275.0,0.9,3.65,0.9274999999999997,2.303174603174603,5.875,
440,5,3,0,5,5,8,5,13,12,167.0,0.625,2.875,2.109375,1.0333333333333332,2.9375,
24,0,1,1,1,1,2,1,3,2,11.0,0.5,1.0,0.0,0.0,1.0,
159,0,0,1,1,1,1,1,2,1,0.0,1.0,0.0,0.0,0.0,0.0,
547,6,3,0,6,6,9,5,15,14,278.0,0.6666666666666666,3.111111111111111,1.4320987654320985,1.2333333333333332,3.1875,
1110,11,6,0,9,11,15,8,26,25,272.0,0.7333333333333333,4.8,4.6933333333333325,1.745238095238095,3.4609375,
1119,1,0,0,1,1,1,1,2,1,0.0,1.0,0.0,0.0,0.0,0.0,
938,1,1,1,1,2,2,2,4,3,29.0,1.0,1.5,0.25,0.5,1.0,
1056,1,1,0,0,1,1,1,2,1,0.0,1.0,0.0,0.0,0.0,0.0,
180,1,0,1,3,2,3,2,5,4,45.0,0.6666666666666666,2.0,0.0,1.0,1.5,
230,0,0,1,1,1,1,1,2,1,0.0,1.0,0.0,0.0,0.0,0.0,
337,4,3,0,2,4,5,3,9,8,148.0,0.8,1.8,0.56,0.8333333333333333,2.375,
564,1,0,0,1,1,1,1,2,1,0.0,1.0,0.0,0.0,0.0,0.0,
1025,2,0,0,3,2,3,2,5,4,45.0,0.6666666666666666,1.3333333333333333,0.2222222222222222,0.5,1.5,
189,0,0,1,1,1,1,1,2,1,0.0,1.0,0.0,0.0,0.0,0.0,
223,0,0,1,1,1,1,1,2,1,0.0,1.0,0.0,0.0,0.0,0.0,
1209,0,0,1,1,1,1,1,2,1,0.0,1.0,0.0,0.0,0.0,0.0,
595,1,0,0,1,1,1,1,2,1,0.0,1.0,0.0,0.0,0.0,0.0,
512,1,2,0,1,1,3,1,4,3,22.0,0.3333333333333333,1.0,0.0,0.0,1.5,
344,1,0,0,1,1,1,1,2,1,0.0,1.0,0.0,0.0,0.0,0.0,
806,0,1,1,1,1,2,1,3,2,0.0,0.5,1.0,0.0,0.0,1.0,
1102,1,0,0,1,1,1,1,2,1,0.0,1.0,0.0,0.0,0.0,0.0,
1081,1,1,0,0,1,1,1,2,1,0.0,1.0,0.0,0.0,0.0,0.0,
367,1,0,0,1,1,1,1,2,1,0.0,1.0,0.0,0.0,0.0,0.0,
605,4,2,0,2,4,4,3,8,7,125.0,1.0,2.5,0.25,1.1666666666666665,1.75,
150,0,0,1,1,1,1,1,2,1,0.0,1.0,0.0,0.0,0.0,0.0,
409,1,1,0,1,1,2,1,3,2,37.0,0.5,1.0,0.0,0.0,1.0,
474,9,3,1,9,10,12,5,22,21,430.0,0.8333333333333334,2.8333333333333335,2.138888888888889,1.3607142857142858,4.4375,
598,1,0,0,1,1,1,1,2,1,0.0,1.0,0.0,0.0,0.0,0.0,
227,0,0,1,1,1,1,1,2,1,0.0,1.0,0.0,0.0,0.0,0.0,
514,1,1,0,4,1,5,1,6,5,43.0,0.2,1.0,0.0,0.0,2.5,
421,7,4,0,3,7,7,7,14,13,284.0,1.0,4.0,3.7142857142857144,1.1261904761904762,1.9296875,
161,3,0,1,4,4,4,4,8,7,120.0,1.0,3.25,0.1875,1.3333333333333333,1.375,
896,0,0,1,1,1,1,1,2,1,0.0,1.0,0.0,0.0,0.0,0.0,
696,5,2,0,5,5,7,3,12,11,263.0,0.7142857142857143,1.8571428571428572,0.4081632653061224,1.0833333333333333,3.375,
253,2,0,0,4,2,4,2,6,5,120.0,0.5,1.75,0.1875,0.5,2.0,
480,1,0,0,2,1,2,1,3,2,5.0,0.5,1.0,0.0,0.0,1.0,
242,0,1,1,0,1,1,1,2,1,0.0,1.0,0.0,0.0,0.0,0.0,
688,0,0,1,1,1,1,1,2,1,0.0,1.0,0.0,0.0,0.0,0.0,
1088,1,1,0,0,1,1,1,2,1,0.0,1.0,0.0,0.0,0.0,0.0,
422,2,0,0,2,2,2,2,4,3,38.0,1.0,1.5,0.25,0.5,1.0,
290,1,0,0,3,1,3,1,4,3,37.0,0.3333333333333333,1.0,0.0,0.0,1.5,
1013,2,0,0,1,2,1,2,3,2,2.0,2.0,2.0,0.0,1.0,0.5,
124,1,1,2,1,3,2,3,5,4,12.0,1.5,2.0,1.0,0.8333333333333333,0.875,
274,2,2,0,4,2,6,2,8,7,97.0,0.3333333333333333,1.5,0.25,0.5,3.0,
312,1,1,0,0,1,1,1,2,1,0.0,1.0,0.0,0.0,0.0,0.0,
689,1,0,0,1,1,1,1,2,1,0.0,1.0,0.0,0.0,0.0,0.0,
387,15,5,0,13,15,18,7,33,32,406.0,0.8333333333333334,3.4444444444444446,4.358024691358024,1.4968975468975467,5.8671875,
26,6,3,2,8,8,11,6,19,18,312.0,0.7272727272727273,3.8181818181818183,1.96694214876033,1.4333333333333333,3.21875,
247,1,1,0,0,1,1,1,2,1,0.0,1.0,0.0,0.0,0.0,0.0,
673,1,1,0,1,1,2,1,3,2,49.0,0.5,1.0,0.0,0.0,1.0,
651,6,3,0,5,6,8,3,14,13,327.0,0.75,2.125,0.609375,1.1,3.625,
1173,1,1,0,2,1,3,1,4,3,20.0,0.3333333333333333,1.0,0.0,0.0,1.5,
818,2,1,0,7,2,8,2,10,9,337.0,0.25,1.5,0.25,0.5,4.0,
864,2,1,0,2,2,3,2,5,4,58.0,0.6666666666666666,1.3333333333333333,0.2222222222222222,0.5,1.5,
1109,1,0,0,1,1,1,1,2,1,0.0,1.0,0.0,0.0,0.0,0.0,
1113,4,3,1,4,5,7,3,12,11,93.0,0.7142857142857143,2.4285714285714284,0.5306122448979593,1.0833333333333333,3.0,
248,0,0,1,1,1,1,1,2,1,0.0,1.0,0.0,0.0,0.0,0.0,
434,1,0,0,1,1,1,1,2,1,0.0,1.0,0.0,0.0,0.0,0.0,
44,11,3,2,14,13,17,5,30,29,154.0,0.7647058823529411,3.8823529411764706,1.3979238754325256,2.783333333333333,4.5625,
740,1,0,0,1,1,1,1,2,1,0.0,1.0,0.0,0.0,0.0,0.0,
517,0,0,1,1,1,1,1,2,1,0.0,1.0,0.0,0.0,0.0,0.0,
478,1,1,1,0,2,1,2,3,2,19.0,2.0,2.0,0.0,1.0,0.5,
510,1,0,0,1,1,1,1,2,1,0.0,1.0,0.0,0.0,0.0,0.0,
89,0,1,1,0,1,1,1,2,1,0.0,1.0,0.0,0.0,0.0,0.0,
126,12,5,6,13,18,18,6,36,35,438.0,1.0,3.611111111111111,0.6820987654320988,2.0551587301587304,5.5,
821,4,1,0,6,4,7,4,11,10,132.0,0.5714285714285714,2.142857142857143,1.5510204081632655,0.9166666666666665,3.0,
1020,1,0,0,1,1,1,1,2,1,0.0,1.0,0.0,0.0,0.0,0.0,
8,11,8,1,10,12,18,6,30,29,161.0,0.6666666666666666,4.666666666666667,1.0000000000000002,2.1333333333333333,3.5625,
372,3,2,0,2,3,4,2,7,6,73.0,0.75,1.75,0.1875,0.6666666666666666,2.0,
57,21,14,2,22,23,36,5,59,58,184.0,0.6388888888888888,3.5555555555555554,1.4135802469135799,2.9305555555555554,11.34375,
712,7,6,0,9,7,15,4,22,21,547.0,0.4666666666666667,2.533333333333333,0.5155555555555557,1.4833333333333332,6.5,
166,2,1,1,1,3,2,3,5,4,81.0,1.5,2.5,0.25,1.0,0.875,
731,0,0,1,1,1,1,1,2,1,0.0,1.0,0.0,0.0,0.0,0.0,
121,0,1,1,0,1,1,1,2,1,0.0,1.0,0.0,0.0,0.0,0.0,
171,0,0,1,1,1,1,1,2,1,0.0,1.0,0.0,0.0,0.0,0.0,
981,2,2,0,0,2,2,2,4,3,24.0,1.0,1.5,0.25,0.5,1.0,
243,1,0,0,1,1,1,1,2,1,0.0,1.0,0.0,0.0,0.0,0.0,
1037,1,1,0,0,1,1,1,2,1,0.0,1.0,0.0,0.0,0.0,0.0,
898,1,1,0,0,1,1,1,2,1,0.0,1.0,0.0,0.0,0.0,0.0,
87,6,5,1,10,7,15,5,22,21,205.0,0.4666666666666667,3.7333333333333334,1.6622222222222218,1.2,4.28125,
4,1,1,1,1,2,2,2,4,3,24.0,1.0,2.0,0.0,1.0,1.0,
784,2,0,0,1,2,1,2,3,2,7.0,2.0,2.0,0.0,1.0,0.5,
1084,1,0,0,1,1,1,1,2,1,0.0,1.0,0.0,0.0,0.0,0.0,
67,1,2,1,1,2,3,2,5,4,62.0,0.6666666666666666,1.3333333333333333,0.2222222222222222,0.5,1.5,
128,0,2,1,0,1,2,1,3,2,20.0,0.5,1.0,0.0,0.0,1.0,
860,3,1,0,0,3,1,3,4,3,26.0,3.0,3.0,0.0,1.5,0.375,
1060,2,1,0,1,2,2,2,4,3,3.0,1.0,1.5,0.25,0.5,1.0,
919,14,2,1,14,15,16,7,31,30,461.0,0.9375,4.5,2.5,1.7702380952380954,3.734375,
81,2,1,1,2,3,3,3,6,5,24.0,1.0,2.0,0.6666666666666666,0.8333333333333333,1.375,
273,1,0,0,3,1,3,1,4,3,98.0,0.3333333333333333,1.0,0.0,0.0,1.5,
588,0,0,1,2,1,2,1,3,2,40.0,0.5,1.0,0.0,0.0,1.0,
88,0,0,1,1,1,1,1,2,1,0.0,1.0,0.0,0.0,0.0,0.0,
431,1,0,0,1,1,1,1,2,1,0.0,1.0,0.0,0.0,0.0,0.0,
1134,1,0,0,1,1,1,1,2,1,0.0,1.0,0.0,0.0,0.0,0.0,
1229,1,1,1,0,2,1,2,3,2,24.0,2.0,2.0,0.0,1.0,0.5,
952,1,1,1,3,2,4,2,6,5,133.0,0.5,1.25,0.1875,0.5,2.0,
433,4,4,1,4,5,8,4,13,12,319.0,0.625,3.0,0.5,1.4999999999999998,3.0,
401,5,1,1,2,6,3,4,9,8,78.0,2.0,2.6666666666666665,0.8888888888888888,1.1833333333333331,1.25,
306,1,0,0,2,1,2,1,3,2,112.0,0.5,1.0,0.0,0.0,1.0,
844,9,7,0,7,9,14,7,23,22,246.0,0.6428571428571429,3.5,4.25,1.292857142857143,4.671875,
594,2,1,0,1,2,2,2,4,3,16.0,1.0,1.5,0.25,0.5,1.0,
117,3,4,1,3,4,7,3,11,10,116.0,0.5714285714285714,1.7142857142857142,0.489795918367347,0.8333333333333333,3.375,
18,4,0,1,4,5,4,4,9,8,133.0,1.25,3.5,0.25,1.4999999999999998,1.25,
807,2,2,0,1,2,3,2,5,4,30.0,0.6666666666666666,1.3333333333333333,0.2222222222222222,0.5,1.5,
1202,2,0,0,1,2,1,2,3,2,17.0,2.0,2.0,0.0,1.0,0.5,
671,1,0,0,2,1,2,1,3,2,33.0,0.5,1.0,0.0,0.0,1.0,
834,1,2,0,2,1,4,1,5,4,105.0,0.25,1.0,0.0,0.0,2.0,
38,0,0,1,1,1,1,1,2,1,0.0,1.0,0.0,0.0,0.0,0.0,
902,1,3,0,2,1,5,1,6,5,339.0,0.2,1.0,0.0,0.0,2.5,
1152,5,2,1,2,6,4,5,10,9,242.0,1.5,4.75,0.1875,1.7499999999999998,0.71875,
1051,3,0,0,5,3,5,3,8,7,118.0,0.6,2.2,0.5599999999999999,0.8333333333333333,2.25,
866,1,0,1,2,2,2,2,4,3,5.0,1.0,2.0,0.0,1.0,1.0,
1263,1,0,2,2,3,2,3,5,4,120.0,1.5,2.5,0.25,1.0,0.875,
839,1,0,0,1,1,1,1,2,1,0.0,1.0,0.0,0.0,0.0,0.0,
83,2,1,1,0,3,1,3,4,3,32.0,3.0,3.0,0.0,1.5,0.375,
1212,7,7,0,7,7,14,4,21,20,252.0,0.5,2.5,0.6785714285714286,1.1833333333333333,5.875,
1197,1,1,0,1,1,2,1,3,2,0.0,0.5,1.0,0.0,0.0,1.0,
218,3,2,0,3,3,5,3,8,7,81.0,0.6,2.2,0.15999999999999998,1.0,2.375,
940,5,2,0,2,5,4,3,9,8,89.0,1.25,2.25,0.6875,1.0833333333333333,1.75,
685,2,1,0,4,2,5,2,7,6,78.0,0.4,1.6,0.24,0.5,2.5,
346,1,1,0,0,1,1,1,2,1,0.0,1.0,0.0,0.0,0.0,0.0,
868,2,0,0,1,2,1,2,3,2,49.0,2.0,2.0,0.0,1.0,0.5,
205,0,1,1,1,1,2,1,3,2,0.0,0.5,1.0,0.0,0.0,1.0,
724,2,0,0,1,2,1,2,3,2,15.0,2.0,2.0,0.0,1.0,0.5,
403,2,1,0,1,2,2,2,4,3,195.0,1.0,2.0,0.0,1.0,1.0,
893,3,3,0,3,3,6,3,9,8,118.0,0.5,2.3333333333333335,0.2222222222222222,1.0,2.75,
289,0,1,1,0,1,1,1,2,1,0.0,1.0,0.0,0.0,0.0,0.0,
58,3,0,1,5,4,5,3,9,8,136.0,0.8,2.4,0.24,0.8333333333333333,2.25,
970,0,0,1,1,1,1,1,2,1,0.0,1.0,0.0,0.0,0.0,0.0,
527,1,1,0,2,1,3,1,4,3,25.0,0.3333333333333333,1.0,0.0,0.0,1.5,
782,1,2,0,1,1,3,1,4,3,57.0,0.3333333333333333,1.0,0.0,0.0,1.5,
27,0,1,1,1,1,2,1,3,2,15.0,0.5,1.0,0.0,0.0,1.0,
607,0,0,1,1,1,1,1,2,1,0.0,1.0,0.0,0.0,0.0,0.0,
963,5,6,0,5,5,11,3,16,15,123.0,0.45454545454545453,2.272727272727273,0.38016528925619836,1.0833333333333333,5.0,
99,33,15,2,27,35,42,8,77,76,463.0,0.8333333333333334,4.595238095238095,3.574263038548754,3.1103257853257857,10.0390625,
545,1,0,0,1,1,1,1,2,1,0.0,1.0,0.0,0.0,0.0,0.0,
587,2,2,1,0,3,2,3,5,4,64.0,1.5,2.0,1.0,0.8333333333333333,0.875,
1005,1,0,0,1,1,1,1,2,1,0.0,1.0,0.0,0.0,0.0,0.0,
908,1,0,1,1,2,1,2,3,2,46.0,2.0,2.0,0.0,1.0,0.5,
428,2,1,0,2,2,3,2,5,4,91.0,0.6666666666666666,1.3333333333333333,0.2222222222222222,0.5,1.5,
501,3,0,0,2,3,2,2,5,4,36.0,1.5,2.0,0.0,0.6666666666666666,1.0,
375,0,0,1,1,1,1,1,2,1,0.0,1.0,0.0,0.0,0.0,0.0,
835,1,1,0,0,1,1,1,2,1,0.0,1.0,0.0,0.0,0.0,0.0,
127,2,2,1,2,3,4,3,7,6,83.0,0.75,2.25,0.1875,1.0,1.875,
714,6,3,0,6,6,9,5,15,14,252.0,0.6666666666666666,2.7777777777777777,1.7283950617283952,1.2333333333333332,3.5625,
36,0,0,1,2,1,2,1,3,2,0.0,0.5,1.0,0.0,0.0,1.0,
152,3,1,1,5,4,6,3,10,9,97.0,0.6666666666666666,1.6666666666666667,0.5555555555555556,0.8333333333333333,2.875,
1095,1,0,0,1,1,1,1,2,1,0.0,1.0,0.0,0.0,0.0,0.0,
74,4,7,1,9,5,16,3,21,20,124.0,0.3125,2.3125,0.46484375,1.0833333333333333,7.125,
1206,3,1,0,2,3,3,3,6,5,81.0,1.0,1.6666666666666667,0.888888888888889,0.8333333333333333,1.375,
1258,1,1,0,1,1,2,1,3,2,15.0,0.5,1.0,0.0,0.0,1.0,
657,1,1,0,0,1,1,1,2,1,0.0,1.0,0.0,0.0,0.0,0.0,
33,4,1,2,5,6,6,5,12,11,189.0,1.0,2.1666666666666665,2.138888888888889,1.0333333333333332,2.53125,
961,1,1,0,1,1,2,1,3,2,23.0,0.5,1.0,0.0,0.0,1.0,
413,2,0,0,1,2,1,2,3,2,12.0,2.0,2.0,0.0,1.0,0.5,
72,0,1,1,0,1,1,1,2,1,0.0,1.0,0.0,0.0,0.0,0.0,
1032,2,0,0,3,2,3,2,5,4,126.0,0.6666666666666666,1.6666666666666667,0.2222222222222222,0.5,1.5,
197,8,8,1,6,9,14,5,23,22,165.0,0.6428571428571429,4.142857142857143,0.8367346938775512,1.3785714285714283,3.4375,
939,2,1,0,0,2,1,2,3,2,3.0,2.0,2.0,0.0,1.0,0.5,
181,1,0,2,1,3,1,3,4,3,10.0,3.0,3.0,0.0,1.5,0.375,
380,5,7,1,6,6,13,4,19,18,399.0,0.46153846153846156,2.3846153846153846,1.0059171597633136,1.4166666666666665,5.5,
579,1,0,0,4,1,4,1,5,4,39.0,0.25,1.0,0.0,0.0,2.0,
493,12,5,2,19,14,24,5,38,37,491.0,0.5833333333333334,2.75,1.9375,1.9499999999999997,8.9375,
854,0,0,1,1,1,1,1,2,1,0.0,1.0,0.0,0.0,0.0,0.0,
1101,2,3,0,1,2,4,2,6,5,91.0,0.5,1.25,0.1875,0.5,2.0,
721,0,1,1,1,1,2,1,3,2,61.0,0.5,1.0,0.0,0.0,1.0,
521,1,1,0,0,1,1,1,2,1,0.0,1.0,0.0,0.0,0.0,0.0,
747,5,1,1,7,6,8,5,14,13,200.0,0.75,2.5,1.25,1.2333333333333334,3.40625,
345,1,0,0,2,1,2,1,3,2,39.0,0.5,1.0,0.0,0.0,1.0,
567,3,1,0,3,3,4,2,7,6,250.0,0.75,1.5,0.25,0.6666666666666666,2.0,
737,1,0,0,1,1,1,1,2,1,0.0,1.0,0.0,0.0,0.0,0.0,
35,3,1,2,2,5,3,4,8,7,31.0,1.6666666666666667,4.0,0.0,1.4999999999999998,0.75,
250,0,0,1,1,1,1,1,2,1,0.0,1.0,0.0,0.0,0.0,0.0,
1023,2,1,0,1,2,2,2,4,3,79.0,1.0,1.5,0.25,0.5,1.0,
570,1,1,0,2,1,3,1,4,3,83.0,0.3333333333333333,1.0,0.0,0.0,1.5,
221,0,1,1,0,1,1,1,2,1,0.0,1.0,0.0,0.0,0.0,0.0,
379,1,0,0,1,1,1,1,2,1,0.0,1.0,0.0,0.0,0.0,0.0,
457,2,1,0,3,2,4,2,6,5,37.0,0.5,1.75,0.1875,0.5,2.0,
1,3,2,1,4,4,6,4,10,9,123.0,0.6666666666666666,3.1666666666666665,1.4722222222222223,0.9166666666666665,2.0,
805,1,2,1,0,2,2,2,4,3,9.0,1.0,2.0,0.0,1.0,1.0,
285,0,0,1,1,1,1,1,2,1,0.0,1.0,0.0,0.0,0.0,0.0,
186,0,1,1,0,1,1,1,2,1,0.0,1.0,0.0,0.0,0.0,0.0,
979,2,1,0,2,2,3,2,5,4,140.0,0.6666666666666666,1.3333333333333333,0.2222222222222222,0.5,1.5,
1141,2,3,1,0,3,3,2,6,5,68.0,1.0,1.6666666666666667,0.2222222222222222,0.6666666666666666,1.5,
559,2,1,0,2,2,3,2,5,4,26.0,0.6666666666666666,1.6666666666666667,0.2222222222222222,0.5,1.5,
836,11,6,0,13,11,19,5,30,29,234.0,0.5789473684210527,3.0526315789473686,0.89196675900277,1.527380952380952,7.03125,
633,2,1,0,2,2,3,2,5,4,28.0,0.6666666666666666,2.0,0.0,1.0,1.5,
328,1,0,0,1,1,1,1,2,1,0.0,1.0,0.0,0.0,0.0,0.0,
475,1,1,0,0,1,1,1,2,1,0.0,1.0,0.0,0.0,0.0,0.0,
25,0,1,1,1,1,2,1,3,2,3.0,0.5,1.0,0.0,0.0,1.0,
1146,2,3,0,0,2,3,2,5,4,29.0,0.6666666666666666,1.3333333333333333,0.2222222222222222,0.5,1.5,
548,1,0,0,2,1,2,1,3,2,7.0,0.5,1.0,0.0,0.0,1.0,
51,10,6,1,10,11,16,5,27,26,141.0,0.6875,3.125,0.859375,1.7785714285714285,5.78125,
701,1,0,0,2,1,2,1,3,2,9.0,0.5,1.0,0.0,0.0,1.0,
589,5,8,0,1,5,9,3,14,13,164.0,0.5555555555555556,1.8888888888888888,0.3209876543209877,1.0833333333333333,4.375,
381,2,1,0,1,2,2,2,4,3,40.0,1.0,1.5,0.25,0.5,1.0,
293,1,0,0,2,1,2,1,3,2,30.0,0.5,1.0,0.0,0.0,1.0,
1120,1,0,0,1,1,1,1,2,1,0.0,1.0,0.0,0.0,0.0,0.0,
141,3,2,1,5,4,7,3,11,10,210.0,0.5714285714285714,3.0,0.0,1.1666666666666665,2.625,
1255,1,1,0,0,1,1,1,2,1,0.0,1.0,0.0,0.0,0.0,0.0,
234,0,0,1,1,1,1,1,2,1,0.0,1.0,0.0,0.0,0.0,0.0,
912,2,1,1,4,3,5,3,8,7,143.0,0.6,2.0,0.4,0.8333333333333333,2.375,
700,2,0,0,2,2,2,2,4,3,48.0,1.0,1.5,0.25,0.5,1.0,
914,1,0,0,1,1,1,1,2,1,0.0,1.0,0.0,0.0,0.0,0.0,
1149,3,1,0,3,3,4,3,7,6,182.0,0.75,1.75,0.6875,0.8333333333333333,1.875,
258,0,0,1,1,1,1,1,2,1,0.0,1.0,0.0,0.0,0.0,0.0,
1264,0,1,1,0,1,1,1,2,1,0.0,1.0,0.0,0.0,0.0,0.0,
848,4,2,0,6,4,8,3,12,11,249.0,0.5,1.75,0.6875,0.8333333333333333,3.75,
593,1,2,0,2,1,4,1,5,4,54.0,0.25,1.0,0.0,0.0,2.0,
371,16,6,2,9,18,15,10,33,32,368.0,1.2,3.7333333333333334,5.395555555555555,1.836976911976912,5.134765625,
1073,2,2,0,1,2,3,2,5,4,53.0,0.6666666666666666,1.6666666666666667,0.2222222222222222,0.5,1.5,
694,2,0,0,1,2,1,2,3,2,32.0,2.0,2.0,0.0,1.0,0.5,
789,1,0,0,1,1,1,1,2,1,0.0,1.0,0.0,0.0,0.0,0.0,
926,1,0,0,1,1,1,1,2,1,0.0,1.0,0.0,0.0,0.0,0.0,
787,2,0,0,1,2,1,2,3,2,13.0,2.0,2.0,0.0,1.0,0.5,
1259,5,1,2,3,7,4,6,11,10,274.0,1.75,4.75,2.6875,1.1023809523809525,0.84375,
12,4,2,1,5,5,7,4,12,11,198.0,0.7142857142857143,3.142857142857143,0.6938775510204082,1.1666666666666665,2.5,
798,1,0,0,1,1,1,1,2,1,0.0,1.0,0.0,0.0,0.0,0.0,
318,1,0,0,1,1,1,1,2,1,0.0,1.0,0.0,0.0,0.0,0.0,
873,6,3,0,6,6,9,4,15,14,226.0,0.6666666666666666,2.4444444444444446,0.9135802469135802,1.2333333333333334,3.875,
627,2,0,0,3,2,3,2,5,4,114.0,0.6666666666666666,1.6666666666666667,0.2222222222222222,0.5,1.5,
809,1,1,0,0,1,1,1,2,1,0.0,1.0,0.0,0.0,0.0,0.0,
1242,1,1,1,0,2,1,2,3,2,33.0,2.0,2.0,0.0,1.0,0.5,
1116,5,1,0,3,5,4,4,9,8,178.0,1.25,3.0,0.5,0.9833333333333334,1.5,
143,15,4,2,23,17,27,6,44,43,449.0,0.6296296296296297,3.925925925925926,2.809327846364883,2.0214285714285714,7.40625,
1086,1,1,0,0,1,1,1,2,1,0.0,1.0,0.0,0.0,0.0,0.0,
583,5,1,1,3,6,4,6,10,9,371.0,1.5,4.5,0.75,1.6166666666666667,0.84375,
390,0,0,1,1,1,1,1,2,1,0.0,1.0,0.0,0.0,0.0,0.0,
266,3,0,0,3,3,3,2,6,5,81.0,1.0,1.6666666666666667,0.2222222222222222,0.6666666666666666,1.5,
662,1,1,0,1,1,2,1,3,2,23.0,0.5,1.0,0.0,0.0,1.0,
329,1,0,0,1,1,1,1,2,1,0.0,1.0,0.0,0.0,0.0,0.0,
198,1,0,1,2,2,2,2,4,3,5.0,1.0,1.5,0.25,0.5,1.0,
876,6,2,1,6,7,8,7,15,14,243.0,0.875,5.125,1.609375,1.4,1.3671875,
1221,1,0,0,1,1,1,1,2,1,0.0,1.0,0.0,0.0,0.0,0.0,
123,0,1,1,0,1,1,1,2,1,0.0,1.0,0.0,0.0,0.0,0.0,
658,0,0,1,1,1,1,1,2,1,0.0,1.0,0.0,0.0,0.0,0.0,
1098,0,1,1,0,1,1,1,2,1,0.0,1.0,0.0,0.0,0.0,0.0,
859,1,0,0,2,1,2,1,3,2,22.0,0.5,1.0,0.0,0.0,1.0,
1009,2,1,0,0,2,1,2,3,2,14.0,2.0,2.0,0.0,1.0,0.5,
973,6,3,0,3,6,6,4,12,11,196.0,1.0,3.0,0.6666666666666666,1.2333333333333332,2.25,
1260,1,0,0,1,1,1,1,2,1,0.0,1.0,0.0,0.0,0.0,0.0,
950,1,1,0,0,1,1,1,2,1,0.0,1.0,0.0,0.0,0.0,0.0,
14,9,6,2,9,11,15,6,26,25,130.0,0.7333333333333333,4.466666666666667,1.048888888888889,1.5785714285714285,3.25,
1128,4,3,0,1,4,4,4,8,7,85.0,1.0,2.25,1.1875,0.9166666666666665,1.75,
945,0,0,1,1,1,1,1,2,1,0.0,1.0,0.0,0.0,0.0,0.0,
212,1,1,1,2,2,3,2,5,4,29.0,0.6666666666666666,1.3333333333333333,0.2222222222222222,0.5,1.5,
1052,1,1,0,0,1,1,1,2,1,0.0,1.0,0.0,0.0,0.0,0.0,
48,18,10,2,16,20,26,7,46,45,253.0,0.7692307692307693,3.269230769230769,1.350591715976331,2.371428571428572,8.8359375,
882,2,1,1,4,3,5,2,8,7,309.0,0.6,1.6,0.24,0.6666666666666666,2.5,
1107,1,1,0,0,1,1,1,2,1,0.0,1.0,0.0,0.0,0.0,0.0,
34,6,3,1,5,7,8,6,15,14,150.0,0.875,3.875,2.859375,1.2333333333333334,2.40625,
3,4,4,1,2,5,6,4,11,10,299.0,0.8333333333333334,2.8333333333333335,0.47222222222222215,1.1666666666666665,2.375,
580,1,0,0,1,1,1,1,2,1,0.0,1.0,0.0,0.0,0.0,0.0,
118,27,15,6,32,33,47,10,80,79,657.0,0.7021276595744681,5.829787234042553,6.949751018560434,2.602612665112665,8.451171875,
200,2,0,1,1,3,1,3,4,3,33.0,3.0,3.0,0.0,1.5,0.375,
814,3,5,0,4,3,9,2,12,11,252.0,0.3333333333333333,1.3333333333333333,0.22222222222222227,0.6666666666666666,4.5,
291,1,0,0,2,1,2,1,3,2,2.0,0.5,1.0,0.0,0.0,1.0,
1015,1,0,0,2,1,2,1,3,2,5.0,0.5,1.0,0.0,0.0,1.0,
503,2,4,0,1,2,5,2,7,6,74.0,0.4,1.6,0.24,0.5,2.5,
109,5,3,2,4,7,7,4,14,13,135.0,1.0,3.2857142857142856,0.2040816326530612,1.4833333333333334,2.375,
969,1,1,0,1,1,2,1,3,2,9.0,0.5,1.0,0.0,0.0,1.0,
491,2,1,0,3,2,4,2,6,5,36.0,0.5,1.25,0.1875,0.5,2.0,
509,2,1,0,0,2,1,2,3,2,24.0,2.0,2.0,0.0,1.0,0.5,
639,1,0,0,1,1,1,1,2,1,0.0,1.0,0.0,0.0,0.0,0.0,
1071,1,0,0,1,1,1,1,2,1,0.0,1.0,0.0,0.0,0.0,0.0,
1018,0,1,1,0,1,1,1,2,1,0.0,1.0,0.0,0.0,0.0,0.0,
151,5,8,2,9,7,17,4,24,23,192.0,0.4117647058823529,2.6470588235294117,0.46366782006920415,1.4333333333333333,7.0,
879,0,0,1,1,1,1,1,2,1,0.0,1.0,0.0,0.0,0.0,0.0,
1029,1,0,0,1,1,1,1,2,1,0.0,1.0,0.0,0.0,0.0,0.0,
772,0,1,1,0,1,1,1,2,1,0.0,1.0,0.0,0.0,0.0,0.0,
316,1,1,0,1,1,2,1,3,2,34.0,0.5,1.0,0.0,0.0,1.0,
423,1,0,0,2,1,2,1,3,2,36.0,0.5,1.0,0.0,0.0,1.0,
82,15,8,5,18,20,26,7,46,45,335.0,0.7692307692307693,4.923076923076923,1.3017751479289943,2.4420634920634923,4.71875,
470,0,0,1,1,1,1,1,2,1,0.0,1.0,0.0,0.0,0.0,0.0,
668,0,0,1,1,1,1,1,2,1,0.0,1.0,0.0,0.0,0.0,0.0,
332,2,1,2,2,4,3,3,7,6,93.0,1.3333333333333333,2.0,0.6666666666666666,0.8333333333333333,1.375,
502,1,0,0,1,1,1,1,2,1,0.0,1.0,0.0,0.0,0.0,0.0,
571,1,0,0,1,1,1,1,2,1,0.0,1.0,0.0,0.0,0.0,0.0,
543,2,2,0,2,2,4,2,6,5,127.0,0.5,2.0,0.0,1.0,2.0,
904,3,4,1,3,4,7,3,11,10,218.0,0.5714285714285714,1.8571428571428572,0.4081632653061225,0.8333333333333333,3.375,
9,19,10,2,17,21,27,7,48,47,218.0,0.7777777777777778,4.037037037037037,3.146776406035666,2.4992063492063497,7.2265625,
137,8,1,1,6,9,7,6,16,15,148.0,1.2857142857142858,3.2857142857142856,1.918367346938775,1.4119047619047618,2.46875,
1061,5,3,0,2,5,5,4,10,9,162.0,1.0,2.4,1.04,0.9833333333333334,2.125,
1230,1,1,0,0,1,1,1,2,1,0.0,1.0,0.0,0.0,0.0,0.0,
363,4,3,0,4,4,7,4,11,10,149.0,0.5714285714285714,2.7142857142857144,0.7755102040816327,1.1666666666666665,2.875,
1238,2,2,0,2,2,4,2,6,5,151.0,0.5,1.5,0.25,0.5,2.0,
690,1,0,0,1,1,1,1,2,1,0.0,1.0,0.0,0.0,0.0,0.0,
1151,2,0,1,1,3,1,3,4,3,45.0,3.0,3.0,0.0,1.5,0.375,
348,0,0,1,1,1,1,1,2,1,0.0,1.0,0.0,0.0,0.0,0.0,
140,4,3,1,4,5,7,3,12,11,129.0,0.7142857142857143,2.7142857142857144,0.20408163265306123,0.9,2.875,
406,2,1,0,0,2,1,2,3,2,14.0,2.0,2.0,0.0,1.0,0.5,
1046,1,0,0,2,1,2,1,3,2,54.0,0.5,1.0,0.0,0.0,1.0,
958,2,3,0,0,2,3,2,5,4,5.0,0.6666666666666666,2.0,0.0,1.0,1.5,
624,1,2,0,2,1,4,1,5,4,74.0,0.25,1.0,0.0,0.0,2.0,
487,4,2,1,7,5,9,4,14,13,257.0,0.5555555555555556,2.3333333333333335,0.8888888888888891,1.1666666666666665,3.875,
239,0,0,1,1,1,1,1,2,1,0.0,1.0,0.0,0.0,0.0,0.0,
1044,1,1,0,0,1,1,1,2,1,0.0,1.0,0.0,0.0,0.0,0.0,
1137,1,0,0,1,1,1,1,2,1,0.0,1.0,0.0,0.0,0.0,0.0,
541,1,0,1,1,2,1,2,3,2,115.0,2.0,2.0,0.0,1.0,0.5,
1223,1,1,0,1,1,2,1,3,2,56.0,0.5,1.0,0.0,0.0,1.0,
53,6,1,2,6,8,7,6,15,14,110.0,1.1428571428571428,3.0,4.285714285714286,1.269047619047619,2.40625,
711,0,0,1,2,1,2,1,3,2,0.0,0.5,1.0,0.0,0.0,1.0,
913,1,1,0,0,1,1,1,2,1,0.0,1.0,0.0,0.0,0.0,0.0,
984,2,1,0,3,2,4,2,6,5,73.0,0.5,1.25,0.1875,0.5,2.0,
122,0,1,1,1,1,2,1,3,2,0.0,0.5,1.0,0.0,0.0,1.0,
1239,1,1,0,0,1,1,1,2,1,0.0,1.0,0.0,0.0,0.0,0.0,
438,5,1,1,8,6,9,3,15,14,256.0,0.6666666666666666,1.6666666666666667,0.4444444444444444,1.3333333333333333,4.375,
94,0,0,2,1,2,1,2,3,2,54.0,2.0,2.0,0.0,1.0,0.5,
467,1,0,0,2,1,2,1,3,2,30.0,0.5,1.0,0.0,0.0,1.0,
611,0,0,1,1,1,1,1,2,1,0.0,1.0,0.0,0.0,0.0,0.0,
890,1,1,0,0,1,1,1,2,1,0.0,1.0,0.0,0.0,0.0,0.0,
742,1,1,0,0,1,1,1,2,1,0.0,1.0,0.0,0.0,0.0,0.0,
996,1,1,0,0,1,1,1,2,1,0.0,1.0,0.0,0.0,0.0,0.0,
1243,0,0,1,1,1,1,1,2,1,0.0,1.0,0.0,0.0,0.0,0.0,
432,1,0,0,1,1,1,1,2,1,0.0,1.0,0.0,0.0,0.0,0.0,
103,0,1,1,0,1,1,1,2,1,0.0,1.0,0.0,0.0,0.0,0.0,
78,6,6,2,7,8,13,4,21,20,489.0,0.6153846153846154,2.5384615384615383,0.5562130177514794,1.6833333333333331,5.5,
757,1,1,0,0,1,1,1,2,1,0.0,1.0,0.0,0.0,0.0,0.0,
889,1,1,0,4,1,5,1,6,5,52.0,0.2,1.0,0.0,0.0,2.5,
727,2,0,0,1,2,1,2,3,2,1.0,2.0,2.0,0.0,1.0,0.5,
1196,1,2,0,0,1,2,1,3,2,11.0,0.5,1.0,0.0,0.0,1.0,
357,1,0,0,2,1,2,1,3,2,1.0,0.5,1.0,0.0,0.0,1.0,
1067,8,1,1,6,9,7,9,16,15,334.0,1.2857142857142858,6.0,9.142857142857142,1.1801587301587302,1.22265625,
883,6,1,2,7,8,8,6,16,15,412.0,1.0,3.0,2.0,1.3023809523809522,2.96875,
353,1,0,0,1,1,1,1,2,1,0.0,1.0,0.0,0.0,0.0,0.0,
1174,5,2,1,2,6,4,5,10,9,154.0,1.5,3.0,1.5,1.0333333333333332,1.53125,
1184,1,0,0,1,1,1,1,2,1,0.0,1.0,0.0,0.0,0.0,0.0,
717,1,0,0,1,1,1,1,2,1,0.0,1.0,0.0,0.0,0.0,0.0,
1232,1,0,0,1,1,1,1,2,1,0.0,1.0,0.0,0.0,0.0,0.0,
355,1,0,0,1,1,1,1,2,1,0.0,1.0,0.0,0.0,0.0,0.0,
321,1,0,0,1,1,1,1,2,1,0.0,1.0,0.0,0.0,0.0,0.0,
833,12,7,1,9,13,16,5,29,28,365.0,0.8125,3.75,1.0625,2.054761904761905,4.625,
1087,1,1,0,1,1,2,1,3,2,5.0,0.5,1.0,0.0,0.0,1.0,
462,1,0,0,3,1,3,1,4,3,42.0,0.3333333333333333,1.0,0.0,0.0,1.5,
167,1,0,1,3,2,3,2,5,4,10.0,0.6666666666666666,2.0,0.0,1.0,1.5,
1089,1,0,0,1,1,1,1,2,1,0.0,1.0,0.0,0.0,0.0,0.0,
1192,5,2,0,8,5,10,5,15,14,185.0,0.5,2.6,2.2399999999999998,1.0333333333333332,3.78125,
373,1,1,0,3,1,4,1,5,4,39.0,0.25,1.0,0.0,0.0,2.0,
825,1,1,0,0,1,1,1,2,1,0.0,1.0,0.0,0.0,0.0,0.0,
955,1,0,1,2,2,2,2,4,3,34.0,1.0,1.5,0.25,0.5,1.0,
659,2,1,0,0,2,1,2,3,2,28.0,2.0,2.0,0.0,1.0,0.5,
76,1,1,1,1,2,2,2,4,3,33.0,1.0,2.0,0.0,1.0,1.0,
472,5,0,0,8,5,8,4,13,12,176.0,0.625,2.25,1.4375,1.1666666666666665,3.375,
1104,1,1,0,1,1,2,1,3,2,32.0,0.5,1.0,0.0,0.0,1.0,
816,1,0,0,1,1,1,1,2,1,0.0,1.0,0.0,0.0,0.0,0.0,
702,9,8,0,13,9,21,5,30,29,280.0,0.42857142857142855,2.0952380952380953,1.324263038548753,1.4023809523809525,9.15625,
800,1,4,0,1,1,5,1,6,5,143.0,0.2,1.0,0.0,0.0,2.5,
925,6,1,0,6,6,7,3,13,12,130.0,0.8571428571428571,2.5714285714285716,0.24489795918367344,1.15,3.0,
732,1,1,0,0,1,1,1,2,1,0.0,1.0,0.0,0.0,0.0,0.0,
1057,4,2,0,3,4,5,4,9,8,92.0,0.8,2.8,0.96,0.9166666666666665,1.875,
451,0,0,1,1,1,1,1,2,1,0.0,1.0,0.0,0.0,0.0,0.0,
791,1,0,0,1,1,1,1,2,1,0.0,1.0,0.0,0.0,0.0,0.0,
445,1,0,0,2,1,2,1,3,2,14.0,0.5,1.0,0.0,0.0,1.0,
931,2,1,0,3,2,4,2,6,5,36.0,0.5,1.25,0.1875,0.5,2.0,
490,1,2,0,2,1,4,1,5,4,39.0,0.25,1.0,0.0,0.0,2.0,
1251,1,1,0,0,1,1,1,2,1,0.0,1.0,0.0,0.0,0.0,0.0,
794,1,0,0,2,1,2,1,3,2,72.0,0.5,1.0,0.0,0.0,1.0,
73,7,4,1,11,8,15,7,23,22,186.0,0.5333333333333333,4.666666666666667,4.088888888888889,1.2928571428571427,3.21875,
665,7,3,0,8,7,11,4,18,17,413.0,0.6363636363636364,2.1818181818181817,1.421487603305785,1.15,4.625,
42,0,1,1,0,1,1,1,2,1,0.0,1.0,0.0,0.0,0.0,0.0,
654,12,6,2,11,14,17,7,31,30,471.0,0.8235294117647058,4.0588235294117645,3.2318339100346014,1.5175324675324675,4.8515625,
347,3,0,0,2,3,2,3,5,4,28.0,1.5,3.0,0.0,1.5,0.75,
753,0,0,1,1,1,1,1,2,1,0.0,1.0,0.0,0.0,0.0,0.0,
824,2,1,0,0,2,1,2,3,2,15.0,2.0,2.0,0.0,1.0,0.5,
645,1,0,1,1,2,1,2,3,2,8.0,2.0,2.0,0.0,1.0,0.5,
581,1,0,0,1,1,1,1,2,1,0.0,1.0,0.0,0.0,0.0,0.0,
675,1,2,0,1,1,3,1,4,3,39.0,0.3333333333333333,1.0,0.0,0.0,1.5,
1026,1,0,0,1,1,1,1,2,1,0.0,1.0,0.0,0.0,0.0,0.0,
783,0,0,1,1,1,1,1,2,1,0.0,1.0,0.0,0.0,0.0,0.0,
749,1,1,1,0,2,1,2,3,2,69.0,2.0,2.0,0.0,1.0,0.5,
1213,4,3,0,1,4,4,3,8,7,180.0,1.0,1.75,0.6875,0.8333333333333333,1.875,
863,8,4,1,7,9,11,6,20,19,419.0,0.8181818181818182,4.545454545454546,1.520661157024793,1.5999999999999999,2.40625,
56,6,5,1,6,7,11,4,18,17,102.0,0.6363636363636364,3.0,0.36363636363636365,1.4833333333333332,4.125,
884,2,1,0,2,2,3,2,5,4,71.0,0.6666666666666666,1.3333333333333333,0.2222222222222222,0.5,1.5,
681,1,0,0,1,1,1,1,2,1,0.0,1.0,0.0,0.0,0.0,0.0,
808,2,2,0,3,2,5,2,7,6,219.0,0.4,1.4,0.24,0.5,2.5,
267,2,0,0,2,2,2,2,4,3,60.0,1.0,2.0,0.0,1.0,1.0,
585,2,1,1,3,3,4,2,7,6,62.0,0.75,1.5,0.25,0.6666666666666666,2.0,
317,5,5,2,5,7,10,4,17,16,254.0,0.7,2.1,1.29,1.4333333333333333,4.375,
1035,3,3,1,4,4,7,3,11,10,214.0,0.5714285714285714,2.2857142857142856,0.489795918367347,1.1666666666666665,3.125,
1036,1,1,0,1,1,2,1,3,2,99.0,0.5,1.0,0.0,0.0,1.0,
252,2,2,1,1,3,3,2,6,5,241.0,1.0,1.6666666666666667,0.2222222222222222,0.6666666666666666,1.5,
362,2,2,0,1,2,3,2,5,4,39.0,0.6666666666666666,1.3333333333333333,0.2222222222222222,0.5,1.5,
129,4,3,1,2,5,5,3,10,9,153.0,1.0,2.8,0.15999999999999998,1.4999999999999998,2.0,
923,1,3,0,1,1,4,1,5,4,61.0,0.25,1.0,0.0,0.0,2.0,
160,14,10,2,18,16,28,7,44,43,331.0,0.5714285714285714,4.464285714285714,2.1058673469387754,2.1543650793650793,6.53125,
828,2,0,0,1,2,1,2,3,2,12.0,2.0,2.0,0.0,1.0,0.5,
389,2,1,0,0,2,1,2,3,2,29.0,2.0,2.0,0.0,1.0,0.5,
664,5,2,0,2,5,4,3,9,8,146.0,1.25,2.5,0.25,0.8999999999999999,1.75,
105,0,2,1,2,1,4,1,5,4,151.0,0.25,1.0,0.0,0.0,2.0,
891,2,0,0,4,2,4,2,6,5,37.0,0.5,1.25,0.1875,0.5,2.0,
861,1,1,0,2,1,3,1,4,3,105.0,0.3333333333333333,1.0,0.0,0.0,1.5,
972,2,3,0,0,2,3,2,5,4,27.0,0.6666666666666666,1.3333333333333333,0.2222222222222222,0.5,1.5,
843,1,0,0,1,1,1,1,2,1,0.0,1.0,0.0,0.0,0.0,0.0,
831,2,2,0,0,2,2,2,4,3,35.0,1.0,1.5,0.25,0.5,1.0,
1039,3,2,0,3,3,5,3,8,7,115.0,0.6,2.4,0.24,1.0,2.25,
384,1,1,0,2,1,3,1,4,3,33.0,0.3333333333333333,1.0,0.0,0.0,1.5,
1231,1,1,1,0,2,1,2,3,2,9.0,2.0,2.0,0.0,1.0,0.5,
1008,0,1,1,0,1,1,1,2,1,0.0,1.0,0.0,0.0,0.0,0.0,
178,4,5,2,5,6,10,4,16,15,314.0,0.6,2.9,0.6899999999999998,1.1833333333333333,3.875,
336,1,0,0,2,1,2,1,3,2,2.0,0.5,1.0,0.0,0.0,1.0,
315,3,2,1,4,4,6,4,10,9,199.0,0.6666666666666666,2.5,1.25,0.9166666666666665,2.375,
698,1,2,0,2,1,4,1,5,4,40.0,0.25,1.0,0.0,0.0,2.0,
254,1,0,1,2,2,2,2,4,3,25.0,1.0,1.5,0.25,0.5,1.0,
1092,3,3,0,0,3,3,3,6,5,76.0,1.0,2.6666666666666665,0.22222222222222224,1.0,1.25,
967,1,1,0,1,1,2,1,3,2,16.0,0.5,1.0,0.0,0.0,1.0,
5,18,8,1,15,19,23,8,42,41,202.0,0.8260869565217391,4.391304347826087,2.4120982986767485,1.8416527916527918,5.5234375,
648,2,3,2,9,4,12,3,16,15,211.0,0.3333333333333333,1.9166666666666667,0.5763888888888888,0.8333333333333333,5.625,
930,1,0,0,1,1,1,1,2,1,0.0,1.0,0.0,0.0,0.0,0.0,
415,4,2,0,0,4,2,4,6,5,251.0,2.0,2.5,2.25,0.9166666666666665,0.75,
92,5,8,1,3,6,11,4,17,16,178.0,0.5454545454545454,2.3636363636363638,0.7768595041322314,1.1833333333333333,4.875,
781,1,0,0,1,1,1,1,2,1,0.0,1.0,0.0,0.0,0.0,0.0,
412,1,0,0,2,1,2,1,3,2,34.0,0.5,1.0,0.0,0.0,1.0,
1156,4,2,0,1,4,3,3,7,6,57.0,1.3333333333333333,2.6666666666666665,0.22222222222222224,1.1666666666666665,1.25,
553,2,1,0,2,2,3,2,5,4,111.0,0.6666666666666666,2.0,0.0,1.0,1.5,
1262,3,1,0,2,3,3,2,6,5,86.0,1.0,2.0,0.0,0.6666666666666666,1.5,
43,6,5,1,2,7,7,4,14,13,99.0,1.0,2.4285714285714284,0.816326530612245,1.1833333333333333,3.0,
231,2,1,1,5,3,6,3,9,8,178.0,0.5,2.5,0.25,1.0,2.625,
766,1,0,0,3,1,3,1,4,3,51.0,0.3333333333333333,1.0,0.0,0.0,1.5,
739,5,1,0,3,5,4,3,9,8,87.0,1.25,2.5,0.75,0.8999999999999999,1.625,
869,5,4,0,1,5,5,5,10,9,230.0,1.0,4.4,0.24000000000000005,1.5833333333333333,1.0625,
156,0,1,1,0,1,1,1,2,1,0.0,1.0,0.0,0.0,0.0,0.0,
1188,2,1,0,1,2,2,2,4,3,71.0,1.0,1.5,0.25,0.5,1.0,
697,12,6,0,13,12,19,6,31,30,467.0,0.631578947368421,2.6842105263157894,2.1108033240997237,1.6380952380952378,7.6875,
856,21,8,2,20,23,28,6,51,50,457.0,0.8214285714285714,3.857142857142857,2.8367346938775513,2.6793650793650796,8.21875,
515,1,0,0,1,1,1,1,2,1,0.0,1.0,0.0,0.0,0.0,0.0,
272,2,1,1,0,3,1,3,4,3,328.0,3.0,3.0,0.0,1.5,0.375,
569,3,5,0,2,3,7,2,10,9,185.0,0.42857142857142855,1.4285714285714286,0.24489795918367346,0.6666666666666666,3.5,
909,3,1,0,2,3,3,2,6,5,51.0,1.0,1.6666666666666667,0.2222222222222222,0.6666666666666666,1.5,
1261,1,0,0,1,1,1,1,2,1,0.0,1.0,0.0,0.0,0.0,0.0,
1034,8,2,0,6,8,8,5,16,15,130.0,1.0,3.625,0.734375,1.2357142857142858,2.4375,
443,1,0,0,1,1,1,1,2,1,0.0,1.0,0.0,0.0,0.0,0.0,
473,5,1,2,2,7,3,7,10,9,382.0,2.3333333333333335,3.3333333333333335,6.888888888888889,1.1261904761904762,1.0546875,
610,7,5,1,5,8,10,6,18,17,317.0,0.8,3.5,1.45,1.4333333333333331,3.09375,
1246,1,0,0,1,1,1,1,2,1,0.0,1.0,0.0,0.0,0.0,0.0,
213,5,4,1,4,6,8,4,14,13,137.0,0.75,2.875,0.859375,1.4166666666666665,3.0,
526,0,1,1,0,1,1,1,2,1,0.0,1.0,0.0,0.0,0.0,0.0,
849,1,1,0,0,1,1,1,2,1,0.0,1.0,0.0,0.0,0.0,0.0,
424,1,0,0,3,1,3,1,4,3,18.0,0.3333333333333333,1.0,0.0,0.0,1.5,
1053,1,0,0,1,1,1,1,2,1,0.0,1.0,0.0,0.0,0.0,0.0,
705,0,0,1,1,1,1,1,2,1,0.0,1.0,0.0,0.0,0.0,0.0,
725,1,1,0,0,1,1,1,2,1,0.0,1.0,0.0,0.0,0.0,0.0,
320,0,0,2,1,2,1,2,3,2,101.0,2.0,2.0,0.0,1.0,0.5,
466,1,0,0,1,1,1,1,2,1,0.0,1.0,0.0,0.0,0.0,0.0,
341,4,1,1,4,5,5,4,10,9,118.0,1.0,2.4,1.8400000000000003,0.9833333333333334,2.0,
1215,1,0,0,3,1,3,1,4,3,19.0,0.3333333333333333,1.0,0.0,0.0,1.5,
1111,1,0,0,1,1,1,1,2,1,0.0,1.0,0.0,0.0,0.0,0.0,
988,1,1,0,1,1,2,1,3,2,18.0,0.5,1.0,0.0,0.0,1.0,
628,5,3,0,6,5,9,3,14,13,191.0,0.5555555555555556,1.7777777777777777,0.3950617283950618,1.0833333333333333,4.375,
932,3,0,0,1,3,1,3,4,3,36.0,3.0,3.0,0.0,1.5,0.375,
1157,1,0,0,2,1,2,1,3,2,22.0,0.5,1.0,0.0,0.0,1.0,
498,3,4,0,7,3,11,2,14,13,156.0,0.2727272727272727,1.6363636363636365,0.23140495867768598,0.6666666666666666,5.5,
533,3,0,0,3,3,3,3,6,5,149.0,1.0,1.6666666666666667,0.888888888888889,0.8333333333333333,1.375,
286,1,1,0,2,1,3,1,4,3,120.0,0.3333333333333333,1.0,0.0,0.0,1.5,
796,4,1,1,4,5,5,3,10,9,330.0,1.0,1.8,0.56,1.0833333333333333,2.375,
738,2,1,1,0,3,1,3,4,3,46.0,3.0,3.0,0.0,1.5,0.375,
954,1,0,0,1,1,1,1,2,1,0.0,1.0,0.0,0.0,0.0,0.0,
568,7,3,0,11,7,14,5,21,20,244.0,0.5,3.0714285714285716,1.6377551020408163,1.5333333333333332,4.78125,
1130,1,0,0,1,1,1,1,2,1,0.0,1.0,0.0,0.0,0.0,0.0,
1181,0,1,1,0,1,1,1,2,1,0.0,1.0,0.0,0.0,0.0,0.0,
1059,1,0,0,1,1,1,1,2,1,0.0,1.0,0.0,0.0,0.0,0.0,
718,13,11,1,11,14,22,7,36,35,377.0,0.6363636363636364,4.5,1.25,2.302380952380952,4.8046875,
703,1,0,0,1,1,1,1,2,1,0.0,1.0,0.0,0.0,0.0,0.0,
1129,4,3,1,3,5,6,4,11,10,158.0,0.8333333333333334,2.6666666666666665,0.5555555555555555,1.1666666666666665,2.5,
602,2,0,0,3,2,3,2,5,4,5.0,0.6666666666666666,1.3333333333333333,0.2222222222222222,0.5,1.5,
1268,1,1,0,0,1,1,1,2,1,0.0,1.0,0.0,0.0,0.0,0.0,
284,2,0,0,1,2,1,2,3,2,50.0,2.0,2.0,0.0,1.0,0.5,
2,26,21,3,25,29,46,9,75,74,226.0,0.6304347826086957,6.130434782608695,3.4177693761814743,2.697927072927073,5.671875,
634,1,0,0,1,1,1,1,2,1,0.0,1.0,0.0,0.0,0.0,0.0,
240,6,4,1,6,7,10,6,17,16,439.0,0.7,3.5,2.65,1.1023809523809525,3.1875,
453,13,15,0,9,13,24,11,37,36,658.0,0.5416666666666666,6.291666666666667,6.873263888888888,1.4694805194805194,3.31494140625,
998,6,8,0,2,6,10,5,16,15,235.0,0.6,4.0,1.2,1.4166666666666665,2.625,
331,0,0,1,1,1,1,1,2,1,0.0,1.0,0.0,0.0,0.0,0.0,
330,1,0,0,1,1,1,1,2,1,0.0,1.0,0.0,0.0,0.0,0.0,
206,1,2,1,0,2,2,2,4,3,54.0,1.0,1.5,0.25,0.5,1.0,
601,3,1,0,3,3,4,3,7,6,152.0,0.75,1.75,0.6875,0.8333333333333333,1.875,
1050,1,1,0,3,1,4,1,5,4,109.0,0.25,1.0,0.0,0.0,2.0,
75,5,2,1,4,6,6,3,12,11,90.0,1.0,2.1666666666666665,0.8055555555555555,1.3333333333333333,2.625,
388,2,1,0,3,2,4,2,6,5,59.0,0.5,1.25,0.1875,0.5,2.0,
1159,1,1,0,1,1,2,1,3,2,53.0,0.5,1.0,0.0,0.0,1.0,
850,1,1,0,0,1,1,1,2,1,0.0,1.0,0.0,0.0,0.0,0.0,
886,3,1,0,4,3,5,3,8,7,119.0,0.6,2.0,0.8,0.8333333333333333,2.25,
495,9,2,0,2,9,4,5,13,12,109.0,2.25,3.75,1.1875,1.194047619047619,1.15625,
1135,4,2,0,3,4,5,4,9,8,160.0,0.8,2.4,1.0400000000000003,0.9166666666666666,2.125,
446,2,5,0,2,2,7,2,9,8,154.0,0.2857142857142857,1.7142857142857142,0.20408163265306126,0.5,3.5,
164,0,0,1,1,1,1,1,2,1,0.0,1.0,0.0,0.0,0.0,0.0,
154,2,0,1,2,3,2,3,5,4,91.0,1.5,3.0,0.0,1.5,0.75,
537,0,0,1,1,1,1,1,2,1,0.0,1.0,0.0,0.0,0.0,0.0,
686,1,0,0,1,1,1,1,2,1,0.0,1.0,0.0,0.0,0.0,0.0,
101,2,1,1,1,3,2,3,5,4,20.0,1.5,2.5,0.25,1.0,0.875,
644,6,4,1,6,7,10,4,17,16,425.0,0.7,2.8,0.76,1.4333333333333333,4.0,
827,1,2,0,0,1,2,1,3,2,17.0,0.5,1.0,0.0,0.0,1.0,
1068,1,1,0,0,1,1,1,2,1,0.0,1.0,0.0,0.0,0.0,0.0,
911,1,0,0,1,1,1,1,2,1,0.0,1.0,0.0,0.0,0.0,0.0,
532,0,1,1,0,1,1,1,2,1,0.0,1.0,0.0,0.0,0.0,0.0,
719,2,1,1,3,3,4,3,7,6,168.0,0.75,2.25,0.1875,1.0,1.875,
1062,5,7,1,4,6,11,4,17,16,233.0,0.5454545454545454,2.5454545454545454,0.42975206611570244,1.4166666666666665,4.75,
1126,1,1,0,2,1,3,1,4,3,72.0,0.3333333333333333,1.0,0.0,0.0,1.5,
1195,1,0,0,1,1,1,1,2,1,0.0,1.0,0.0,0.0,0.0,0.0,
458,2,1,0,2,2,3,2,5,4,25.0,0.6666666666666666,1.6666666666666667,0.2222222222222222,0.5,1.5,
1167,1,0,0,4,1,4,1,5,4,110.0,0.25,1.0,0.0,0.0,2.0,
1170,12,9,1,10,13,19,7,32,31,382.0,0.6842105263157895,3.8421052631578947,4.764542936288089,1.8702380952380953,5.5390625,
13,0,1,1,1,1,2,1,3,2,2.0,0.5,1.0,0.0,0.0,1.0,
294,1,1,0,0,1,1,1,2,1,0.0,1.0,0.0,0.0,0.0,0.0,
699,1,1,0,0,1,1,1,2,1,0.0,1.0,0.0,0.0,0.0,0.0,
746,1,1,0,0,1,1,1,2,1,0.0,1.0,0.0,0.0,0.0,0.0,
313,1,1,0,1,1,2,1,3,2,2.0,0.5,1.0,0.0,0.0,1.0,
54,6,4,1,8,7,12,5,19,18,402.0,0.5833333333333334,3.1666666666666665,1.472222222222222,1.2333333333333334,4.03125,
1045,1,3,0,0,1,3,1,4,3,41.0,0.3333333333333333,1.0,0.0,0.0,1.5,
1204,1,0,0,2,1,2,1,3,2,48.0,0.5,1.0,0.0,0.0,1.0,
957,12,9,1,18,13,27,5,40,39,529.0,0.48148148148148145,2.6666666666666665,1.111111111111111,2.2333333333333334,10.9375,
305,1,1,0,1,1,2,1,3,2,50.0,0.5,1.0,0.0,0.0,1.0,
709,2,0,0,2,2,2,2,4,3,37.0,1.0,2.0,0.0,1.0,1.0,
420,1,1,0,0,1,1,1,2,1,0.0,1.0,0.0,0.0,0.0,0.0,
1256,1,1,0,1,1,2,1,3,2,36.0,0.5,1.0,0.0,0.0,1.0,
871,2,2,1,3,3,5,2,8,7,179.0,0.6,1.4,0.24,0.6666666666666666,2.5,
450,1,1,0,0,1,1,1,2,1,0.0,1.0,0.0,0.0,0.0,0.0,
113,7,5,1,6,8,11,4,19,18,152.0,0.7272727272727273,2.727272727272727,1.2892561983471074,1.6833333333333333,4.25,
577,1,1,0,0,1,1,1,2,1,0.0,1.0,0.0,0.0,0.0,0.0,
910,1,1,0,0,1,1,1,2,1,0.0,1.0,0.0,0.0,0.0,0.0,
147,1,0,1,3,2,3,2,5,4,16.0,0.6666666666666666,1.6666666666666667,0.2222222222222222,0.5,1.5,
282,1,0,0,1,1,1,1,2,1,0.0,1.0,0.0,0.0,0.0,0.0,
456,0,0,1,1,1,1,1,2,1,0.0,1.0,0.0,0.0,0.0,0.0,
398,1,1,0,0,1,1,1,2,1,0.0,1.0,0.0,0.0,0.0,0.0,
1211,1,1,0,0,1,1,1,2,1,0.0,1.0,0.0,0.0,0.0,0.0,
684,0,1,1,0,1,1,1,2,1,0.0,1.0,0.0,0.0,0.0,0.0,
604,2,0,0,1,2,1,2,3,2,20.0,2.0,2.0,0.0,1.0,0.5,
810,38,21,3,30,41,51,13,92,91,566.0,0.803921568627451,5.176470588235294,10.57670126874279,2.7618637898049667,12.1798095703125,
132,7,8,2,8,9,16,4,25,24,212.0,0.5625,2.4375,0.87109375,1.5166666666666668,6.625,
66,2,0,1,1,3,1,3,4,3,29.0,3.0,3.0,0.0,1.5,0.375,
620,0,0,1,1,1,1,1,2,1,0.0,1.0,0.0,0.0,0.0,0.0,
997,1,1,1,2,2,3,2,5,4,90.0,0.6666666666666666,1.3333333333333333,0.2222222222222222,0.5,1.5,
790,1,1,0,1,1,2,1,3,2,18.0,0.5,1.0,0.0,0.0,1.0,
801,1,0,0,1,1,1,1,2,1,0.0,1.0,0.0,0.0,0.0,0.0,
612,2,0,0,1,2,1,2,3,2,47.0,2.0,2.0,0.0,1.0,0.5,
215,1,0,1,1,2,1,2,3,2,26.0,2.0,2.0,0.0,1.0,0.5,
1019,1,1,0,1,1,2,1,3,2,2.0,0.5,1.0,0.0,0.0,1.0,
407,1,1,0,0,1,1,1,2,1,0.0,1.0,0.0,0.0,0.0,0.0,
366,1,0,0,1,1,1,1,2,1,0.0,1.0,0.0,0.0,0.0,0.0,
934,1,0,0,1,1,1,1,2,1,0.0,1.0,0.0,0.0,0.0,0.0,
176,3,3,1,2,4,5,4,9,8,56.0,0.8,3.8,0.15999999999999998,1.3333333333333333,1.375,
108,6,6,1,7,7,13,5,20,19,220.0,0.5384615384615384,3.3076923076923075,1.4437869822485208,1.5333333333333332,4.15625,
1179,1,0,0,1,1,1,1,2,1,0.0,1.0,0.0,0.0,0.0,0.0,
1241,1,1,0,2,1,3,1,4,3,20.0,0.3333333333333333,1.0,0.0,0.0,1.5,
936,1,2,0,1,1,3,1,4,3,81.0,0.3333333333333333,1.0,0.0,0.0,1.5,
356,0,0,1,1,1,1,1,2,1,0.0,1.0,0.0,0.0,0.0,0.0,
993,2,1,0,3,2,4,2,6,5,99.0,0.5,2.0,0.0,1.0,2.0,
1080,5,1,0,2,5,3,4,8,7,135.0,1.6666666666666667,2.6666666666666665,1.5555555555555556,1.1666666666666665,1.125,
146,11,5,1,4,12,9,8,21,20,178.0,1.3333333333333333,4.333333333333333,3.3333333333333335,1.2814213564213564,2.3125,
287,1,2,0,2,1,4,1,5,4,60.0,0.25,1.0,0.0,0.0,2.0,
481,2,0,0,2,2,2,2,4,3,33.0,1.0,1.5,0.25,0.5,1.0,
319,1,1,0,1,1,2,1,3,2,6.0,0.5,1.0,0.0,0.0,1.0,
460,4,2,0,3,4,5,4,9,8,71.0,0.8,1.6,1.44,0.9166666666666665,2.25,
777,4,1,0,2,4,3,3,7,6,98.0,1.3333333333333333,2.3333333333333335,0.22222222222222224,0.8333333333333333,1.375,
944,1,1,0,1,1,2,1,3,2,12.0,0.5,1.0,0.0,0.0,1.0,
365,1,0,0,2,1,2,1,3,2,21.0,0.5,1.0,0.0,0.0,1.0,
672,6,2,1,8,7,10,7,17,16,249.0,0.7,5.0,1.8,1.4,1.8359375,
1227,1,1,0,1,1,2,1,3,2,3.0,0.5,1.0,0.0,0.0,1.0,
96,0,0,1,1,1,1,1,2,1,0.0,1.0,0.0,0.0,0.0,0.0,
695,1,1,0,1,1,2,1,3,2,25.0,0.5,1.0,0.0,0.0,1.0,
949,1,1,0,0,1,1,1,2,1,0.0,1.0,0.0,0.0,0.0,0.0,
614,1,0,0,1,1,1,1,2,1,0.0,1.0,0.0,0.0,0.0,0.0,
157,11,9,1,16,12,25,7,37,36,406.0,0.48,3.68,1.4176000000000002,1.7452380952380953,7.5859375,
897,2,3,1,3,3,6,3,9,8,151.0,0.5,1.6666666666666667,0.5555555555555557,0.8333333333333333,2.875,
964,1,1,1,1,2,2,2,4,3,30.0,1.0,2.0,0.0,1.0,1.0,
586,3,1,0,0,3,1,3,4,3,70.0,3.0,3.0,0.0,1.5,0.375,
492,1,0,0,1,1,1,1,2,1,0.0,1.0,0.0,0.0,0.0,0.0,
837,3,1,0,0,3,1,3,4,3,54.0,3.0,3.0,0.0,1.5,0.375,
45,2,3,1,2,3,5,3,8,7,142.0,0.6,2.4,0.24,1.0,2.25,
427,1,1,0,0,1,1,1,2,1,0.0,1.0,0.0,0.0,0.0,0.0,
744,1,0,0,1,1,1,1,2,1,0.0,1.0,0.0,0.0,0.0,0.0,
349,0,0,1,2,1,2,1,3,2,152.0,0.5,1.0,0.0,0.0,1.0,
830,1,0,0,3,1,3,1,4,3,62.0,0.3333333333333333,1.0,0.0,0.0,1.5,
6,13,9,1,10,14,19,6,33,32,231.0,0.7368421052631579,3.4210526315789473,2.1385041551246537,1.9714285714285713,6.0,
875,1,0,0,2,1,2,1,3,2,65.0,0.5,1.0,0.0,0.0,1.0,
354,6,4,1,6,7,10,5,17,16,286.0,0.7,3.3,1.21,1.4833333333333332,3.28125,
333,1,0,0,1,1,1,1,2,1,0.0,1.0,0.0,0.0,0.0,0.0,
23,0,0,1,1,1,1,1,2,1,0.0,1.0,0.0,0.0,0.0,0.0,
641,2,1,0,8,2,9,2,11,10,177.0,0.2222222222222222,1.7777777777777777,0.17283950617283947,0.5,4.5,
1115,1,0,0,3,1,3,1,4,3,76.0,0.3333333333333333,1.0,0.0,0.0,1.5,
265,0,0,1,1,1,1,1,2,1,0.0,1.0,0.0,0.0,0.0,0.0,
1224,3,3,1,1,4,4,4,8,7,160.0,1.0,3.25,0.6875,1.1666666666666665,1.375,
591,2,0,0,3,2,3,2,5,4,30.0,0.6666666666666666,1.3333333333333333,0.2222222222222222,0.5,1.5,
1236,1,3,0,1,1,4,1,5,4,41.0,0.25,1.0,0.0,0.0,2.0,
257,1,1,1,0,2,1,2,3,2,2.0,2.0,2.0,0.0,1.0,0.5,
236,0,1,1,0,1,1,1,2,1,0.0,1.0,0.0,0.0,0.0,0.0,
669,1,1,0,0,1,1,1,2,1,0.0,1.0,0.0,0.0,0.0,0.0,
765,1,0,0,1,1,1,1,2,1,0.0,1.0,0.0,0.0,0.0,0.0,
1066,3,2,0,0,3,2,2,5,4,33.0,1.5,2.0,0.0,0.6666666666666666,1.0,
1144,1,0,0,1,1,1,1,2,1,0.0,1.0,0.0,0.0,0.0,0.0,
209,0,0,1,1,1,1,1,2,1,0.0,1.0,0.0,0.0,0.0,0.0,
402,1,0,0,3,1,3,1,4,3,63.0,0.3333333333333333,1.0,0.0,0.0,1.5,
546,1,0,0,1,1,1,1,2,1,0.0,1.0,0.0,0.0,0.0,0.0,
63,10,7,2,10,12,17,5,29,28,157.0,0.7058823529411765,3.0,1.411764705882353,1.6880952380952379,6.1875,
733,2,1,0,0,2,1,2,3,2,72.0,2.0,2.0,0.0,1.0,0.5,
629,1,1,0,0,1,1,1,2,1,0.0,1.0,0.0,0.0,0.0,0.0,
523,1,1,0,2,1,3,1,4,3,81.0,0.3333333333333333,1.0,0.0,0.0,1.5,
542,2,1,0,3,2,4,2,6,5,83.0,0.5,1.25,0.1875,0.5,2.0,
563,2,2,1,1,3,3,2,6,5,159.0,1.0,2.0,0.0,0.6666666666666666,1.5,
743,2,1,0,2,2,3,2,5,4,23.0,0.6666666666666666,1.6666666666666667,0.2222222222222222,0.5,1.5,
201,1,2,1,1,2,3,2,5,4,66.0,0.6666666666666666,2.0,0.0,1.0,1.5,
960,2,4,1,3,3,7,3,10,9,204.0,0.42857142857142855,2.142857142857143,0.9795918367346939,0.8333333333333333,3.0,
173,6,8,2,9,8,17,4,25,24,151.0,0.47058823529411764,2.1176470588235294,0.8096885813148788,1.3833333333333333,7.625,
920,1,1,0,0,1,1,1,2,1,0.0,1.0,0.0,0.0,0.0,0.0,
259,0,0,1,1,1,1,1,2,1,0.0,1.0,0.0,0.0,0.0,0.0,
760,8,4,0,8,8,12,5,20,19,259.0,0.6666666666666666,3.1666666666666665,1.972222222222222,1.3666666666666667,4.375,
41,32,21,5,45,37,66,13,103,102,615.0,0.5606060606060606,6.242424242424242,13.032139577594117,2.9112248862248875,12.311767578125,
847,1,1,0,1,1,2,1,3,2,54.0,0.5,1.0,0.0,0.0,1.0,
1194,0,0,1,1,1,1,1,2,1,0.0,1.0,0.0,0.0,0.0,0.0,
999,1,1,0,0,1,1,1,2,1,0.0,1.0,0.0,0.0,0.0,0.0,
361,0,1,1,0,1,1,1,2,1,0.0,1.0,0.0,0.0,0.0,0.0,
50,28,10,3,28,31,38,7,69,68,214.0,0.8157894736842105,4.078947368421052,1.4937673130193907,3.186291486291487,9.796875,
1158,1,2,1,2,2,4,2,6,5,96.0,0.5,1.25,0.1875,0.5,2.0,
430,5,1,2,7,7,8,5,15,14,213.0,0.875,2.75,2.1875,1.2,3.0625,
951,1,0,0,1,1,1,1,2,1,0.0,1.0,0.0,0.0,0.0,0.0,
862,1,0,0,1,1,1,1,2,1,0.0,1.0,0.0,0.0,0.0,0.0,
497,1,1,0,0,1,1,1,2,1,0.0,1.0,0.0,0.0,0.0,0.0,
199,0,0,1,1,1,1,1,2,1,0.0,1.0,0.0,0.0,0.0,0.0,
1083,4,0,1,1,5,1,5,6,5,291.0,5.0,5.0,0.0,2.083333333333333,0.15625,
211,1,0,1,1,2,1,2,3,2,57.0,2.0,2.0,0.0,1.0,0.5,
1233,2,0,0,1,2,1,2,3,2,75.0,2.0,2.0,0.0,1.0,0.5,
618,1,0,0,1,1,1,1,2,1,0.0,1.0,0.0,0.0,0.0,0.0,
878,2,1,0,2,2,3,2,5,4,145.0,0.6666666666666666,1.3333333333333333,0.2222222222222222,0.5,1.5,
600,1,0,0,1,1,1,1,2,1,0.0,1.0,0.0,0.0,0.0,0.0,
977,7,4,2,6,9,10,5,19,18,360.0,0.9,2.9,1.29,1.469047619047619,3.78125,
1155,3,1,0,1,3,2,2,5,4,78.0,1.5,2.0,0.0,0.6666666666666666,1.0,
1269,0,0,1,2,1,2,1,3,2,41.0,0.5,1.0,0.0,0.0,1.0,
1136,4,5,1,6,5,11,4,16,15,210.0,0.45454545454545453,1.8181818181818181,1.0578512396694213,0.9833333333333334,5.0,
632,1,0,0,2,1,2,1,3,2,27.0,0.5,1.0,0.0,0.0,1.0,
262,0,0,1,1,1,1,1,2,1,0.0,1.0,0.0,0.0,0.0,0.0,
599,1,1,0,1,1,2,1,3,2,86.0,0.5,1.0,0.0,0.0,1.0,
196,0,1,1,0,1,1,1,2,1,0.0,1.0,0.0,0.0,0.0,0.0,
989,1,1,0,0,1,1,1,2,1,0.0,1.0,0.0,0.0,0.0,0.0,
364,1,1,0,1,1,2,1,3,2,3.0,0.5,1.0,0.0,0.0,1.0,
31,3,1,1,4,4,5,3,9,8,143.0,0.8,2.6,0.64,1.1666666666666665,2.0,
540,1,0,0,1,1,1,1,2,1,0.0,1.0,0.0,0.0,0.0,0.0,
820,0,0,1,1,1,1,1,2,1,0.0,1.0,0.0,0.0,0.0,0.0,
270,1,0,0,1,1,1,1,2,1,0.0,1.0,0.0,0.0,0.0,0.0,
947,2,0,0,3,2,3,2,5,4,102.0,0.6666666666666666,1.3333333333333333,0.2222222222222222,0.5,1.5,
995,0,0,1,1,1,1,1,2,1,0.0,1.0,0.0,0.0,0.0,0.0,
706,1,1,1,1,2,2,2,4,3,38.0,1.0,1.5,0.25,0.5,1.0,
1257,1,2,0,1,1,3,1,4,3,134.0,0.3333333333333333,1.0,0.0,0.0,1.5,
163,7,4,1,6,8,10,5,18,17,85.0,0.8,2.6,1.6400000000000001,1.4333333333333331,3.90625,
55,5,3,2,3,7,6,4,13,12,82.0,1.1666666666666667,2.5,0.9166666666666666,1.4833333333333332,2.5,
1205,1,1,1,0,2,1,2,3,2,89.0,2.0,2.0,0.0,1.0,0.5,
528,6,5,0,2,6,7,4,13,12,133.0,0.8571428571428571,2.7142857142857144,0.489795918367347,1.2333333333333334,2.875,
674,1,1,0,1,1,2,1,3,2,30.0,0.5,1.0,0.0,0.0,1.0,
942,2,1,0,1,2,2,2,4,3,23.0,1.0,2.0,0.0,1.0,1.0,
962,1,2,0,0,1,2,1,3,2,85.0,0.5,1.0,0.0,0.0,1.0,
448,1,1,1,1,2,2,2,4,3,47.0,1.0,2.0,0.0,1.0,1.0,
534,2,1,1,3,3,4,3,7,6,73.0,0.75,2.0,0.5,0.8333333333333333,1.875,
350,1,0,0,2,1,2,1,3,2,61.0,0.5,1.0,0.0,0.0,1.0,
459,7,4,0,9,7,13,5,20,19,371.0,0.5384615384615384,2.923076923076923,0.8402366863905326,1.2333333333333334,4.90625,
461,1,2,0,1,1,3,1,4,3,34.0,0.3333333333333333,1.0,0.0,0.0,1.5,
1007,1,2,0,2,1,4,1,5,4,55.0,0.25,1.0,0.0,0.0,2.0,
