ObID,HRI,HRL,LRI,LRL,Internals,Leaves,Height,Vertices,Size,Duration,RatioIL,MeanBar,StdBar,Beta1,Beta2,
805,3,4,0,2,3,6,3,9,8,106.0,0.5,1.8333333333333333,0.8055555555555557,0.8333333333333333,2.75,
868,1,1,0,0,1,1,1,2,1,0.0,1.0,0.0,0.0,0.0,0.0,
893,1,2,0,0,1,2,1,3,2,52.0,0.5,1.0,0.0,0.0,1.0,
385,2,2,0,0,2,2,2,4,3,16.0,1.0,1.5,0.25,0.5,1.0,
835,1,0,0,1,1,1,1,2,1,0.0,1.0,0.0,0.0,0.0,0.0,
542,3,1,0,1,3,2,3,5,4,48.0,1.5,2.5,0.25,1.0,0.875,
170,3,2,0,0,3,2,3,5,4,79.0,1.5,2.5,0.25,1.0,0.875,
187,1,1,0,0,1,1,1,2,1,0.0,1.0,0.0,0.0,0.0,0.0,
4,2,1,0,0,2,1,2,3,2,28.0,2.0,2.0,0.0,1.0,0.5,
883,1,1,0,0,1,1,1,2,1,0.0,1.0,0.0,0.0,0.0,0.0,
110,1,2,1,0,2,2,2,4,3,45.0,1.0,2.0,0.0,1.0,1.0,
485,2,2,0,0,2,2,2,4,3,53.0,1.0,1.5,0.25,0.5,1.0,
296,2,0,0,1,2,1,2,3,2,58.0,2.0,2.0,0.0,1.0,0.5,
196,1,4,0,3,1,7,1,8,7,264.0,0.14285714285714285,1.0,0.0,0.0,3.5,
342,2,3,0,0,2,3,2,5,4,109.0,0.6666666666666666,1.3333333333333333,0.2222222222222222,0.5,1.5,
777,1,1,0,0,1,1,1,2,1,0.0,1.0,0.0,0.0,0.0,0.0,
364,1,0,0,1,1,1,1,2,1,0.0,1.0,0.0,0.0,0.0,0.0,
774,5,3,0,2,5,5,5,10,9,158.0,1.0,3.6,1.8400000000000003,1.0333333333333332,1.40625,
654,1,1,0,0,1,1,1,2,1,0.0,1.0,0.0,0.0,0.0,0.0,
273,3,1,0,3,3,4,3,7,6,87.0,0.75,1.5,0.75,0.8333333333333333,1.875,
290,3,4,0,0,3,4,3,7,6,151.0,0.75,1.5,0.75,0.8333333333333333,1.875,
341,1,1,0,0,1,1,1,2,1,0.0,1.0,0.0,0.0,0.0,0.0,
782,1,1,0,0,1,1,1,2,1,0.0,1.0,0.0,0.0,0.0,0.0,
193,5,2,0,1,5,3,5,8,7,237.0,1.6666666666666667,3.3333333333333335,2.8888888888888893,1.0333333333333332,0.90625,
511,1,2,1,0,2,2,2,4,3,95.0,1.0,1.5,0.25,0.5,1.0,
712,6,4,0,1,6,5,6,11,10,374.0,1.2,3.4,4.24,1.0666666666666667,1.5,
224,21,26,0,7,21,33,9,54,53,765.0,0.6363636363636364,5.606060606060606,4.178145087235997,1.921101121101121,5.17578125,
869,4,4,0,0,4,4,2,8,7,133.0,1.0,2.0,0.0,1.0,2.0,
527,3,1,0,1,3,2,3,5,4,83.0,1.5,2.5,0.25,1.0,0.875,
257,2,1,0,1,2,2,2,4,3,92.0,1.0,2.0,0.0,1.0,1.0,
583,4,4,0,0,4,4,3,8,7,161.0,1.0,2.5,0.25,1.1666666666666665,1.75,
741,1,4,0,0,1,4,1,5,4,129.0,0.25,1.0,0.0,0.0,2.0,
751,2,2,0,0,2,2,2,4,3,79.0,1.0,1.5,0.25,0.5,1.0,
261,3,3,0,0,3,3,3,6,5,99.0,1.0,1.6666666666666667,0.888888888888889,0.8333333333333333,1.375,
718,1,1,0,0,1,1,1,2,1,0.0,1.0,0.0,0.0,0.0,0.0,
767,8,9,0,4,8,13,4,21,20,257.0,0.6153846153846154,2.076923076923077,0.9940828402366864,1.3499999999999999,5.75,
50,1,1,0,0,1,1,1,2,1,0.0,1.0,0.0,0.0,0.0,0.0,
582,1,2,0,0,1,2,1,3,2,10.0,0.5,1.0,0.0,0.0,1.0,
502,1,0,0,1,1,1,1,2,1,0.0,1.0,0.0,0.0,0.0,0.0,
597,3,0,0,1,3,1,3,4,3,127.0,3.0,3.0,0.0,1.5,0.375,
352,1,0,0,1,1,1,1,2,1,0.0,1.0,0.0,0.0,0.0,0.0,
427,1,2,0,1,1,3,1,4,3,195.0,0.3333333333333333,1.0,0.0,0.0,1.5,
375,1,1,0,0,1,1,1,2,1,0.0,1.0,0.0,0.0,0.0,0.0,
581,1,1,0,1,1,2,1,3,2,83.0,0.5,1.0,0.0,0.0,1.0,
800,2,0,0,2,2,2,2,4,3,39.0,1.0,1.5,0.25,0.5,1.0,
328,1,1,0,0,1,1,1,2,1,0.0,1.0,0.0,0.0,0.0,0.0,
270,1,1,0,1,1,2,1,3,2,13.0,0.5,1.0,0.0,0.0,1.0,
154,0,0,1,1,1,1,1,2,1,0.0,1.0,0.0,0.0,0.0,0.0,
67,2,7,0,1,2,8,2,10,9,178.0,0.25,1.25,0.1875,0.5,4.0,
227,1,1,0,0,1,1,1,2,1,0.0,1.0,0.0,0.0,0.0,0.0,
817,1,1,0,0,1,1,1,2,1,0.0,1.0,0.0,0.0,0.0,0.0,
420,1,2,0,0,1,2,1,3,2,12.0,0.5,1.0,0.0,0.0,1.0,
6,2,1,0,2,2,3,2,5,4,82.0,0.6666666666666666,2.0,0.0,1.0,1.5,
729,1,1,0,0,1,1,1,2,1,0.0,1.0,0.0,0.0,0.0,0.0,
340,1,1,0,0,1,1,1,2,1,0.0,1.0,0.0,0.0,0.0,0.0,
687,1,1,1,1,2,2,2,4,3,23.0,1.0,2.0,0.0,1.0,1.0,
443,1,1,0,0,1,1,1,2,1,0.0,1.0,0.0,0.0,0.0,0.0,
875,8,10,0,6,8,16,6,24,23,751.0,0.5,2.75,3.5625,1.1023809523809525,6.03125,
823,3,1,0,1,3,2,3,5,4,187.0,1.5,2.0,1.0,0.8333333333333333,0.875,
682,8,10,2,1,10,11,7,21,20,240.0,0.9090909090909091,3.6363636363636362,3.6859504132231407,1.2912698412698411,3.3359375,
671,1,3,0,0,1,3,1,4,3,26.0,0.3333333333333333,1.0,0.0,0.0,1.5,
871,1,1,0,0,1,1,1,2,1,0.0,1.0,0.0,0.0,0.0,0.0,
258,4,3,0,2,4,5,3,9,8,322.0,0.8,2.4,0.24,0.8333333333333333,2.25,
724,1,1,0,0,1,1,1,2,1,0.0,1.0,0.0,0.0,0.0,0.0,
145,1,1,0,0,1,1,1,2,1,0.0,1.0,0.0,0.0,0.0,0.0,
163,2,1,0,1,2,2,2,4,3,46.0,1.0,1.5,0.25,0.5,1.0,
548,3,5,0,2,3,7,2,10,9,256.0,0.42857142857142855,1.4285714285714286,0.24489795918367346,0.6666666666666666,3.5,
9,1,1,0,0,1,1,1,2,1,0.0,1.0,0.0,0.0,0.0,0.0,
111,1,1,0,0,1,1,1,2,1,0.0,1.0,0.0,0.0,0.0,0.0,
72,4,1,0,2,4,3,4,7,6,315.0,1.3333333333333333,3.3333333333333335,0.22222222222222224,1.3333333333333333,1.0,
816,2,4,0,0,2,4,2,6,5,92.0,0.5,2.0,0.0,1.0,2.0,
175,2,0,0,1,2,1,2,3,2,49.0,2.0,2.0,0.0,1.0,0.5,
493,5,6,0,0,5,6,4,11,10,310.0,0.8333333333333334,2.3333333333333335,0.8888888888888888,1.1666666666666665,2.625,
451,7,3,0,0,7,3,7,10,9,164.0,2.3333333333333335,4.666666666666667,4.222222222222222,1.2333333333333334,0.7109375,
359,1,1,0,0,1,1,1,2,1,0.0,1.0,0.0,0.0,0.0,0.0,
709,1,1,0,0,1,1,1,2,1,0.0,1.0,0.0,0.0,0.0,0.0,
34,5,3,0,1,5,4,4,9,8,263.0,1.25,3.5,0.75,1.4999999999999998,1.25,
821,1,2,0,0,1,2,1,3,2,159.0,0.5,1.0,0.0,0.0,1.0,
28,1,1,0,0,1,1,1,2,1,0.0,1.0,0.0,0.0,0.0,0.0,
837,1,1,0,1,1,2,1,3,2,6.0,0.5,1.0,0.0,0.0,1.0,
151,1,1,0,0,1,1,1,2,1,0.0,1.0,0.0,0.0,0.0,0.0,
783,1,1,0,0,1,1,1,2,1,0.0,1.0,0.0,0.0,0.0,0.0,
905,2,2,0,0,2,2,2,4,3,71.0,1.0,2.0,0.0,1.0,1.0,
846,1,0,0,1,1,1,1,2,1,0.0,1.0,0.0,0.0,0.0,0.0,
26,8,7,0,2,8,9,6,17,16,482.0,0.8888888888888888,3.0,1.5555555555555556,1.2690476190476192,3.46875,
807,7,9,0,2,7,11,4,18,17,277.0,0.6363636363636364,2.5454545454545454,0.793388429752066,1.1833333333333331,4.5,
119,2,1,0,0,2,1,2,3,2,37.0,2.0,2.0,0.0,1.0,0.5,
371,1,1,0,0,1,1,1,2,1,0.0,1.0,0.0,0.0,0.0,0.0,
562,1,1,0,1,1,2,1,3,2,2.0,0.5,1.0,0.0,0.0,1.0,
92,3,1,0,0,3,1,3,4,3,19.0,3.0,3.0,0.0,1.5,0.375,
625,1,0,0,1,1,1,1,2,1,0.0,1.0,0.0,0.0,0.0,0.0,
68,5,7,0,2,5,9,4,14,13,380.0,0.5555555555555556,2.6666666666666665,0.4444444444444444,1.1666666666666665,3.75,
177,1,1,0,0,1,1,1,2,1,0.0,1.0,0.0,0.0,0.0,0.0,
318,1,1,0,0,1,1,1,2,1,0.0,1.0,0.0,0.0,0.0,0.0,
752,3,2,0,1,3,3,3,6,5,129.0,1.0,2.3333333333333335,0.22222222222222224,1.0,1.375,
395,0,1,1,1,1,2,1,3,2,2.0,0.5,1.0,0.0,0.0,1.0,
515,1,1,0,0,1,1,1,2,1,0.0,1.0,0.0,0.0,0.0,0.0,
553,2,1,0,1,2,2,2,4,3,71.0,1.0,2.0,0.0,1.0,1.0,
571,1,1,0,0,1,1,1,2,1,0.0,1.0,0.0,0.0,0.0,0.0,
42,1,0,0,1,1,1,1,2,1,0.0,1.0,0.0,0.0,0.0,0.0,
486,2,1,0,0,2,1,2,3,2,20.0,2.0,2.0,0.0,1.0,0.5,
329,2,1,0,0,2,1,2,3,2,10.0,2.0,2.0,0.0,1.0,0.5,
587,2,2,0,1,2,3,2,5,4,107.0,0.6666666666666666,2.0,0.0,1.0,1.5,
96,3,2,0,0,3,2,2,5,4,36.0,1.5,2.0,0.0,0.6666666666666666,1.0,
389,3,1,0,0,3,1,3,4,3,58.0,3.0,3.0,0.0,1.5,0.375,
498,1,1,0,1,1,2,1,3,2,74.0,0.5,1.0,0.0,0.0,1.0,
673,1,1,0,1,1,2,1,3,2,15.0,0.5,1.0,0.0,0.0,1.0,
387,1,1,0,0,1,1,1,2,1,0.0,1.0,0.0,0.0,0.0,0.0,
221,1,0,0,1,1,1,1,2,1,0.0,1.0,0.0,0.0,0.0,0.0,
217,1,0,0,1,1,1,1,2,1,0.0,1.0,0.0,0.0,0.0,0.0,
505,10,4,0,4,10,8,7,18,17,254.0,1.25,4.0,4.0,1.4119047619047618,2.2109375,
856,2,2,0,2,2,4,2,6,5,270.0,0.5,1.5,0.25,0.5,2.0,
208,2,0,0,1,2,1,2,3,2,33.0,2.0,2.0,0.0,1.0,0.5,
181,1,2,0,1,1,3,1,4,3,117.0,0.3333333333333333,1.0,0.0,0.0,1.5,
612,1,1,0,0,1,1,1,2,1,0.0,1.0,0.0,0.0,0.0,0.0,
73,4,0,0,2,4,2,4,6,5,151.0,2.0,3.5,0.25,1.3333333333333333,0.625,
701,3,1,0,0,3,1,3,4,3,69.0,3.0,3.0,0.0,1.5,0.375,
146,1,1,0,0,1,1,1,2,1,0.0,1.0,0.0,0.0,0.0,0.0,
209,1,1,0,0,1,1,1,2,1,0.0,1.0,0.0,0.0,0.0,0.0,
496,2,2,0,0,2,2,2,4,3,41.0,1.0,1.5,0.25,0.5,1.0,
69,1,0,0,1,1,1,1,2,1,0.0,1.0,0.0,0.0,0.0,0.0,
220,6,2,0,2,6,4,5,10,9,171.0,1.5,2.25,2.6875,1.0333333333333332,1.65625,
426,1,2,0,0,1,2,1,3,2,76.0,0.5,1.0,0.0,0.0,1.0,
859,1,0,0,1,1,1,1,2,1,0.0,1.0,0.0,0.0,0.0,0.0,
604,2,2,0,1,2,3,2,5,4,130.0,0.6666666666666666,2.0,0.0,1.0,1.5,
79,1,3,0,0,1,3,1,4,3,36.0,0.3333333333333333,1.0,0.0,0.0,1.5,
603,3,1,0,1,3,2,3,5,4,131.0,1.5,2.0,1.0,0.8333333333333333,0.875,
292,1,3,0,0,1,3,1,4,3,63.0,0.3333333333333333,1.0,0.0,0.0,1.5,
918,2,2,0,0,2,2,2,4,3,133.0,1.0,1.5,0.25,0.5,1.0,
414,2,1,0,1,2,2,2,4,3,49.0,1.0,1.5,0.25,0.5,1.0,
394,1,2,0,0,1,2,1,3,2,15.0,0.5,1.0,0.0,0.0,1.0,
507,1,2,0,1,1,3,1,4,3,56.0,0.3333333333333333,1.0,0.0,0.0,1.5,
183,3,5,0,0,3,5,3,8,7,93.0,0.6,1.8,0.56,0.8333333333333333,2.375,
642,1,1,1,0,2,1,2,3,2,8.0,2.0,2.0,0.0,1.0,0.5,
787,1,2,0,0,1,2,1,3,2,5.0,0.5,1.0,0.0,0.0,1.0,
519,1,0,0,1,1,1,1,2,1,0.0,1.0,0.0,0.0,0.0,0.0,
678,1,1,0,0,1,1,1,2,1,0.0,1.0,0.0,0.0,0.0,0.0,
576,1,2,0,0,1,2,1,3,2,38.0,0.5,1.0,0.0,0.0,1.0,
295,1,1,0,0,1,1,1,2,1,0.0,1.0,0.0,0.0,0.0,0.0,
858,1,1,0,0,1,1,1,2,1,0.0,1.0,0.0,0.0,0.0,0.0,
525,9,6,0,2,9,8,7,17,16,315.0,1.125,3.5,4.5,1.4928571428571427,2.5546875,
332,1,0,0,1,1,1,1,2,1,0.0,1.0,0.0,0.0,0.0,0.0,
895,1,0,0,1,1,1,1,2,1,0.0,1.0,0.0,0.0,0.0,0.0,
472,0,1,1,0,1,1,1,2,1,0.0,1.0,0.0,0.0,0.0,0.0,
686,1,1,0,0,1,1,1,2,1,0.0,1.0,0.0,0.0,0.0,0.0,
140,2,2,0,1,2,3,2,5,4,173.0,0.6666666666666666,1.6666666666666667,0.2222222222222222,0.5,1.5,
779,0,2,1,0,1,2,1,3,2,18.0,0.5,1.0,0.0,0.0,1.0,
277,1,2,0,0,1,2,1,3,2,11.0,0.5,1.0,0.0,0.0,1.0,
705,2,2,1,0,3,2,3,5,4,190.0,1.5,2.5,0.25,1.0,0.875,
892,1,1,0,0,1,1,1,2,1,0.0,1.0,0.0,0.0,0.0,0.0,
207,4,6,0,1,4,7,4,11,10,121.0,0.5714285714285714,1.7142857142857142,1.0612244897959182,0.9166666666666665,3.25,
768,1,1,0,0,1,1,1,2,1,0.0,1.0,0.0,0.0,0.0,0.0,
773,5,4,0,3,5,7,3,12,11,101.0,0.7142857142857143,1.5714285714285714,0.5306122448979591,1.0833333333333333,3.375,
250,10,5,0,2,10,7,8,17,16,507.0,1.4285714285714286,6.285714285714286,5.346938775510203,1.4119047619047618,0.8359375,
683,2,1,0,0,2,1,2,3,2,141.0,2.0,2.0,0.0,1.0,0.5,
363,1,1,0,0,1,1,1,2,1,0.0,1.0,0.0,0.0,0.0,0.0,
83,1,1,0,0,1,1,1,2,1,0.0,1.0,0.0,0.0,0.0,0.0,
900,1,2,0,0,1,2,1,3,2,35.0,0.5,1.0,0.0,0.0,1.0,
806,2,1,1,1,3,2,3,5,4,100.0,1.5,2.0,1.0,0.8333333333333333,0.875,
291,1,2,0,1,1,3,1,4,3,136.0,0.3333333333333333,1.0,0.0,0.0,1.5,
863,1,3,0,0,1,3,1,4,3,40.0,0.3333333333333333,1.0,0.0,0.0,1.5,
308,1,0,0,1,1,1,1,2,1,0.0,1.0,0.0,0.0,0.0,0.0,
241,1,1,0,1,1,2,1,3,2,9.0,0.5,1.0,0.0,0.0,1.0,
897,2,3,0,0,2,3,2,5,4,79.0,0.6666666666666666,1.6666666666666667,0.2222222222222222,0.5,1.5,
334,2,2,0,0,2,2,2,4,3,70.0,1.0,1.5,0.25,0.5,1.0,
793,1,1,0,1,1,2,1,3,2,65.0,0.5,1.0,0.0,0.0,1.0,
794,1,0,0,1,1,1,1,2,1,0.0,1.0,0.0,0.0,0.0,0.0,
745,1,1,0,0,1,1,1,2,1,0.0,1.0,0.0,0.0,0.0,0.0,
565,6,2,0,3,6,5,4,11,10,124.0,1.2,3.4,0.24,1.4166666666666665,1.625,
326,2,1,0,1,2,2,2,4,3,7.0,1.0,1.5,0.25,0.5,1.0,
786,2,1,0,1,2,2,2,4,3,19.0,1.0,1.5,0.25,0.5,1.0,
717,2,1,0,0,2,1,2,3,2,34.0,2.0,2.0,0.0,1.0,0.5,
56,8,3,0,3,8,6,6,14,13,493.0,1.3333333333333333,4.5,1.9166666666666667,1.3023809523809524,1.34375,
727,1,1,0,0,1,1,1,2,1,0.0,1.0,0.0,0.0,0.0,0.0,
90,1,1,0,0,1,1,1,2,1,0.0,1.0,0.0,0.0,0.0,0.0,
539,2,1,0,0,2,1,2,3,2,16.0,2.0,2.0,0.0,1.0,0.5,
531,1,1,0,0,1,1,1,2,1,0.0,1.0,0.0,0.0,0.0,0.0,
904,3,3,0,0,3,3,3,6,5,210.0,1.0,2.6666666666666665,0.22222222222222224,1.0,1.25,
38,1,1,0,0,1,1,1,2,1,0.0,1.0,0.0,0.0,0.0,0.0,
551,2,1,0,0,2,1,2,3,2,9.0,2.0,2.0,0.0,1.0,0.5,
815,2,4,1,1,3,5,2,8,7,123.0,0.6,1.4,0.24,0.6666666666666666,2.5,
619,1,1,0,0,1,1,1,2,1,0.0,1.0,0.0,0.0,0.0,0.0,
120,1,0,0,1,1,1,1,2,1,0.0,1.0,0.0,0.0,0.0,0.0,
762,1,1,0,0,1,1,1,2,1,0.0,1.0,0.0,0.0,0.0,0.0,
545,3,2,1,1,4,3,4,7,6,298.0,1.3333333333333333,2.6666666666666665,1.5555555555555554,0.9166666666666665,1.125,
764,3,5,0,0,3,5,3,8,7,177.0,0.6,2.8,0.15999999999999998,1.0,2.0,
51,1,2,0,0,1,2,1,3,2,1.0,0.5,1.0,0.0,0.0,1.0,
647,1,0,0,1,1,1,1,2,1,0.0,1.0,0.0,0.0,0.0,0.0,
27,2,1,0,1,2,2,2,4,3,22.0,1.0,1.5,0.25,0.5,1.0,
382,4,2,0,2,4,4,3,8,7,221.0,1.0,2.5,0.25,1.1666666666666665,1.75,
199,2,2,0,0,2,2,2,4,3,20.0,1.0,1.5,0.25,0.5,1.0,
750,4,2,0,0,4,2,4,6,5,144.0,2.0,3.5,0.25,1.3333333333333333,0.625,
596,1,1,0,0,1,1,1,2,1,0.0,1.0,0.0,0.0,0.0,0.0,
444,2,3,0,0,2,3,2,5,4,15.0,0.6666666666666666,1.6666666666666667,0.2222222222222222,0.5,1.5,
23,25,20,0,6,25,26,10,51,50,1024.0,0.9615384615384616,6.576923076923077,5.321005917159765,2.5771284271284274,3.173828125,
457,1,0,0,1,1,1,1,2,1,0.0,1.0,0.0,0.0,0.0,0.0,
350,2,3,0,0,2,3,2,5,4,53.0,0.6666666666666666,1.3333333333333333,0.2222222222222222,0.5,1.5,
339,2,1,0,1,2,2,2,4,3,16.0,1.0,1.5,0.25,0.5,1.0,
613,4,3,0,3,4,6,3,10,9,121.0,0.6666666666666666,1.5,0.5833333333333334,0.8333333333333333,2.875,
244,1,1,0,0,1,1,1,2,1,0.0,1.0,0.0,0.0,0.0,0.0,
403,1,3,0,0,1,3,1,4,3,28.0,0.3333333333333333,1.0,0.0,0.0,1.5,
499,1,0,0,1,1,1,1,2,1,0.0,1.0,0.0,0.0,0.0,0.0,
215,4,2,0,2,4,4,3,8,7,84.0,1.0,2.5,0.25,1.1666666666666665,1.75,
103,1,1,0,0,1,1,1,2,1,0.0,1.0,0.0,0.0,0.0,0.0,
21,3,3,0,0,3,3,2,6,5,112.0,1.0,1.6666666666666667,0.2222222222222222,0.6666666666666666,1.5,
476,1,1,0,0,1,1,1,2,1,0.0,1.0,0.0,0.0,0.0,0.0,
896,10,8,0,5,10,13,6,23,22,300.0,0.7692307692307693,2.4615384615384617,2.4023668639053257,1.2496031746031744,5.375,
369,1,1,0,0,1,1,1,2,1,0.0,1.0,0.0,0.0,0.0,0.0,
348,1,2,0,0,1,2,1,3,2,14.0,0.5,1.0,0.0,0.0,1.0,
842,6,4,0,1,6,5,5,11,10,117.0,1.2,3.0,2.0,1.2333333333333334,1.78125,
666,5,2,0,1,5,3,4,8,7,172.0,1.6666666666666667,2.6666666666666665,1.5555555555555556,1.1666666666666665,1.125,
235,1,0,0,1,1,1,1,2,1,0.0,1.0,0.0,0.0,0.0,0.0,
825,1,1,0,0,1,1,1,2,1,0.0,1.0,0.0,0.0,0.0,0.0,
759,1,0,0,1,1,1,1,2,1,0.0,1.0,0.0,0.0,0.0,0.0,
153,1,1,0,1,1,2,1,3,2,10.0,0.5,1.0,0.0,0.0,1.0,
538,2,1,0,0,2,1,2,3,2,90.0,2.0,2.0,0.0,1.0,0.5,
228,1,1,0,0,1,1,1,2,1,0.0,1.0,0.0,0.0,0.0,0.0,
708,1,2,0,0,1,2,1,3,2,54.0,0.5,1.0,0.0,0.0,1.0,
303,1,1,0,0,1,1,1,2,1,0.0,1.0,0.0,0.0,0.0,0.0,
19,0,1,1,0,1,1,1,2,1,0.0,1.0,0.0,0.0,0.0,0.0,
437,1,3,0,0,1,3,1,4,3,27.0,0.3333333333333333,1.0,0.0,0.0,1.5,
147,1,3,0,0,1,3,1,4,3,60.0,0.3333333333333333,1.0,0.0,0.0,1.5,
829,1,1,0,0,1,1,1,2,1,0.0,1.0,0.0,0.0,0.0,0.0,
108,1,1,0,1,1,2,1,3,2,13.0,0.5,1.0,0.0,0.0,1.0,
176,2,1,0,0,2,1,2,3,2,33.0,2.0,2.0,0.0,1.0,0.5,
268,6,6,0,0,6,6,5,12,11,284.0,1.0,3.8333333333333335,0.47222222222222215,1.4166666666666665,1.65625,
870,1,2,0,0,1,2,1,3,2,106.0,0.5,1.0,0.0,0.0,1.0,
446,6,6,0,1,6,7,5,13,12,313.0,0.8571428571428571,3.4285714285714284,0.816326530612245,1.4166666666666665,2.28125,
251,1,1,0,0,1,1,1,2,1,0.0,1.0,0.0,0.0,0.0,0.0,
78,1,1,0,0,1,1,1,2,1,0.0,1.0,0.0,0.0,0.0,0.0,
283,1,1,0,0,1,1,1,2,1,0.0,1.0,0.0,0.0,0.0,0.0,
598,1,1,0,1,1,2,1,3,2,55.0,0.5,1.0,0.0,0.0,1.0,
501,5,8,0,4,5,12,4,17,16,256.0,0.4166666666666667,2.5833333333333335,1.076388888888889,1.1666666666666665,4.875,
454,1,1,0,0,1,1,1,2,1,0.0,1.0,0.0,0.0,0.0,0.0,
611,1,1,0,0,1,1,1,2,1,0.0,1.0,0.0,0.0,0.0,0.0,
722,4,5,0,1,4,6,3,10,9,207.0,0.6666666666666666,2.1666666666666665,0.47222222222222215,1.1666666666666665,2.75,
62,2,1,0,0,2,1,2,3,2,6.0,2.0,2.0,0.0,1.0,0.5,
713,1,1,0,1,1,2,1,3,2,4.0,0.5,1.0,0.0,0.0,1.0,
214,1,1,0,0,1,1,1,2,1,0.0,1.0,0.0,0.0,0.0,0.0,
452,3,1,0,1,3,2,3,5,4,18.0,1.5,2.5,0.25,1.0,0.875,
747,1,1,0,0,1,1,1,2,1,0.0,1.0,0.0,0.0,0.0,0.0,
643,1,0,0,1,1,1,1,2,1,0.0,1.0,0.0,0.0,0.0,0.0,
413,1,1,0,1,1,2,1,3,2,30.0,0.5,1.0,0.0,0.0,1.0,
734,1,0,0,1,1,1,1,2,1,0.0,1.0,0.0,0.0,0.0,0.0,
226,1,1,0,0,1,1,1,2,1,0.0,1.0,0.0,0.0,0.0,0.0,
742,1,1,0,0,1,1,1,2,1,0.0,1.0,0.0,0.0,0.0,0.0,
243,1,0,0,1,1,1,1,2,1,0.0,1.0,0.0,0.0,0.0,0.0,
66,2,1,0,0,2,1,2,3,2,13.0,2.0,2.0,0.0,1.0,0.5,
305,8,4,0,2,8,6,5,14,13,240.0,1.3333333333333333,2.8333333333333335,1.4722222222222223,1.2357142857142855,2.28125,
3,1,3,0,0,1,3,1,4,3,34.0,0.3333333333333333,1.0,0.0,0.0,1.5,
12,1,2,0,0,1,2,1,3,2,50.0,0.5,1.0,0.0,0.0,1.0,
481,1,2,0,0,1,2,1,3,2,48.0,0.5,1.0,0.0,0.0,1.0,
645,3,1,0,2,3,3,2,6,5,84.0,1.0,1.6666666666666667,0.2222222222222222,0.6666666666666666,1.5,
855,2,3,0,0,2,3,2,5,4,37.0,0.6666666666666666,1.3333333333333333,0.2222222222222222,0.5,1.5,
94,3,4,0,1,3,5,3,8,7,238.0,0.6,2.0,0.4,0.8333333333333333,2.375,
884,4,6,2,1,6,7,4,13,12,162.0,0.8571428571428571,3.142857142857143,0.4081632653061224,1.2333333333333332,2.5,
201,1,0,0,1,1,1,1,2,1,0.0,1.0,0.0,0.0,0.0,0.0,
264,1,0,0,1,1,1,1,2,1,0.0,1.0,0.0,0.0,0.0,0.0,
57,2,0,0,1,2,1,2,3,2,5.0,2.0,2.0,0.0,1.0,0.5,
733,1,1,0,0,1,1,1,2,1,0.0,1.0,0.0,0.0,0.0,0.0,
122,4,5,0,0,4,5,4,9,8,174.0,0.8,3.2,0.96,1.1666666666666665,1.75,
836,0,0,1,1,1,1,1,2,1,0.0,1.0,0.0,0.0,0.0,0.0,
271,5,3,0,0,5,3,5,8,7,292.0,1.6666666666666667,2.6666666666666665,2.8888888888888893,1.0333333333333332,1.15625,
309,7,3,0,1,7,4,5,11,10,444.0,1.75,4.75,0.1875,1.2333333333333332,0.71875,
459,1,1,0,0,1,1,1,2,1,0.0,1.0,0.0,0.0,0.0,0.0,
690,3,4,0,1,3,5,3,8,7,247.0,0.6,2.0,0.8,0.8333333333333333,2.25,
322,2,2,0,0,2,2,2,4,3,34.0,1.0,2.0,0.0,1.0,1.0,
513,1,0,0,1,1,1,1,2,1,0.0,1.0,0.0,0.0,0.0,0.0,
657,6,1,0,1,6,2,4,8,7,167.0,3.0,4.0,0.0,1.2333333333333332,0.5,
641,1,3,0,0,1,3,1,4,3,64.0,0.3333333333333333,1.0,0.0,0.0,1.5,
286,1,1,0,0,1,1,1,2,1,0.0,1.0,0.0,0.0,0.0,0.0,
137,6,5,0,0,6,5,4,11,10,130.0,1.2,2.6,1.04,0.9833333333333333,2.0,
293,3,2,0,2,3,4,2,7,6,36.0,0.75,2.0,0.0,0.6666666666666666,2.0,
482,1,1,0,0,1,1,1,2,1,0.0,1.0,0.0,0.0,0.0,0.0,
510,1,1,0,0,1,1,1,2,1,0.0,1.0,0.0,0.0,0.0,0.0,
249,1,0,0,1,1,1,1,2,1,0.0,1.0,0.0,0.0,0.0,0.0,
716,3,2,0,1,3,3,3,6,5,80.0,1.0,1.6666666666666667,0.888888888888889,0.8333333333333333,1.375,
347,4,2,0,1,4,3,4,7,6,133.0,1.3333333333333333,2.0,2.0,0.9166666666666666,1.25,
763,5,5,0,0,5,5,4,10,9,144.0,1.0,2.2,0.96,0.9833333333333334,2.25,
310,1,0,0,1,1,1,1,2,1,0.0,1.0,0.0,0.0,0.0,0.0,
53,1,0,0,2,1,2,1,3,2,25.0,0.5,1.0,0.0,0.0,1.0,
844,3,6,0,1,3,7,2,10,9,225.0,0.42857142857142855,1.7142857142857142,0.20408163265306126,0.6666666666666666,3.5,
377,2,1,0,0,2,1,2,3,2,6.0,2.0,2.0,0.0,1.0,0.5,
157,1,1,0,0,1,1,1,2,1,0.0,1.0,0.0,0.0,0.0,0.0,
0,1,1,0,0,1,1,1,2,1,0.0,1.0,0.0,0.0,0.0,0.0,
591,2,1,0,1,2,2,2,4,3,45.0,1.0,2.0,0.0,1.0,1.0,
903,2,3,0,0,2,3,2,5,4,72.0,0.6666666666666666,1.6666666666666667,0.2222222222222222,0.5,1.5,
627,2,2,0,0,2,2,2,4,3,15.0,1.0,1.5,0.25,0.5,1.0,
789,1,1,0,0,1,1,1,2,1,0.0,1.0,0.0,0.0,0.0,0.0,
239,2,3,0,0,2,3,2,5,4,78.0,0.6666666666666666,1.3333333333333333,0.2222222222222222,0.5,1.5,
630,2,3,0,0,2,3,2,5,4,39.0,0.6666666666666666,1.6666666666666667,0.2222222222222222,0.5,1.5,
509,1,1,0,0,1,1,1,2,1,0.0,1.0,0.0,0.0,0.0,0.0,
330,2,1,0,0,2,1,2,3,2,35.0,2.0,2.0,0.0,1.0,0.5,
284,1,1,0,0,1,1,1,2,1,0.0,1.0,0.0,0.0,0.0,0.0,
107,1,2,0,1,1,3,1,4,3,62.0,0.3333333333333333,1.0,0.0,0.0,1.5,
48,1,1,0,0,1,1,1,2,1,0.0,1.0,0.0,0.0,0.0,0.0,
599,2,1,0,2,2,3,2,5,4,99.0,0.6666666666666666,1.6666666666666667,0.2222222222222222,0.5,1.5,
164,1,2,0,0,1,2,1,3,2,29.0,0.5,1.0,0.0,0.0,1.0,
30,2,1,0,1,2,2,2,4,3,107.0,1.0,1.5,0.25,0.5,1.0,
913,1,1,0,0,1,1,1,2,1,0.0,1.0,0.0,0.0,0.0,0.0,
814,1,1,0,0,1,1,1,2,1,0.0,1.0,0.0,0.0,0.0,0.0,
24,3,2,0,0,3,2,2,5,4,47.0,1.5,2.0,0.0,0.6666666666666666,1.0,
491,3,4,0,1,3,5,3,8,7,75.0,0.6,1.4,0.64,0.8333333333333333,2.375,
674,4,2,0,0,4,2,4,6,5,213.0,2.0,2.5,2.25,0.9166666666666665,0.75,
418,2,3,0,0,2,3,2,5,4,87.0,0.6666666666666666,1.3333333333333333,0.2222222222222222,0.5,1.5,
662,1,1,0,1,1,2,1,3,2,108.0,0.5,1.0,0.0,0.0,1.0,
804,2,4,0,1,2,5,2,7,6,100.0,0.4,1.6,0.24,0.5,2.5,
225,5,2,1,0,6,2,5,8,7,163.0,3.0,4.0,1.0,1.2333333333333334,0.53125,
345,6,1,0,3,6,4,4,10,9,220.0,1.5,3.25,0.6875,0.9833333333333332,1.375,
785,2,1,0,0,2,1,2,3,2,38.0,2.0,2.0,0.0,1.0,0.5,
681,1,1,0,0,1,1,1,2,1,0.0,1.0,0.0,0.0,0.0,0.0,
547,10,6,0,4,10,10,6,20,19,484.0,1.0,3.6,2.2400000000000007,1.394047619047619,3.21875,
434,1,0,0,1,1,1,1,2,1,0.0,1.0,0.0,0.0,0.0,0.0,
447,1,1,0,0,1,1,1,2,1,0.0,1.0,0.0,0.0,0.0,0.0,
728,1,1,0,0,1,1,1,2,1,0.0,1.0,0.0,0.0,0.0,0.0,
160,1,1,0,1,1,2,1,3,2,80.0,0.5,1.0,0.0,0.0,1.0,
114,1,1,0,0,1,1,1,2,1,0.0,1.0,0.0,0.0,0.0,0.0,
614,2,3,0,0,2,3,2,5,4,9.0,0.6666666666666666,1.6666666666666667,0.2222222222222222,0.5,1.5,
317,3,5,0,1,3,6,2,9,8,154.0,0.5,1.5,0.25,0.6666666666666666,3.0,
275,1,1,0,0,1,1,1,2,1,0.0,1.0,0.0,0.0,0.0,0.0,
166,2,1,0,0,2,1,2,3,2,37.0,2.0,2.0,0.0,1.0,0.5,
203,11,5,0,2,11,7,5,18,17,190.0,1.5714285714285714,3.857142857142857,0.9795918367346939,1.8357142857142859,1.9375,
780,1,1,0,0,1,1,1,2,1,0.0,1.0,0.0,0.0,0.0,0.0,
353,5,6,0,5,5,11,3,16,15,378.0,0.45454545454545453,2.090909090909091,0.26446280991735543,1.0833333333333333,5.25,
131,2,1,0,0,2,1,2,3,2,28.0,2.0,2.0,0.0,1.0,0.5,
467,1,2,1,0,2,2,2,4,3,58.0,1.0,2.0,0.0,1.0,1.0,
668,1,1,0,0,1,1,1,2,1,0.0,1.0,0.0,0.0,0.0,0.0,
621,2,0,0,1,2,1,2,3,2,17.0,2.0,2.0,0.0,1.0,0.5,
516,1,2,0,0,1,2,1,3,2,52.0,0.5,1.0,0.0,0.0,1.0,
367,3,1,0,0,3,1,3,4,3,110.0,3.0,3.0,0.0,1.5,0.375,
404,3,3,0,0,3,3,2,6,5,86.0,1.0,2.0,0.0,0.6666666666666666,1.5,
84,4,4,0,1,4,5,4,9,8,78.0,0.8,2.6,0.64,1.1666666666666665,2.125,
520,1,1,0,0,1,1,1,2,1,0.0,1.0,0.0,0.0,0.0,0.0,
37,1,2,0,0,1,2,1,3,2,7.0,0.5,1.0,0.0,0.0,1.0,
554,2,2,0,0,2,2,2,4,3,11.0,1.0,1.5,0.25,0.5,1.0,
150,1,1,0,0,1,1,1,2,1,0.0,1.0,0.0,0.0,0.0,0.0,
801,1,2,0,0,1,2,1,3,2,44.0,0.5,1.0,0.0,0.0,1.0,
307,1,2,0,0,1,2,1,3,2,8.0,0.5,1.0,0.0,0.0,1.0,
556,2,2,1,0,3,2,3,5,4,57.0,1.5,2.0,1.0,0.8333333333333333,0.875,
478,1,1,0,0,1,1,1,2,1,0.0,1.0,0.0,0.0,0.0,0.0,
637,2,1,0,0,2,1,2,3,2,12.0,2.0,2.0,0.0,1.0,0.5,
477,1,1,0,0,1,1,1,2,1,0.0,1.0,0.0,0.0,0.0,0.0,
600,2,1,0,0,2,1,2,3,2,25.0,2.0,2.0,0.0,1.0,0.5,
802,0,0,1,1,1,1,1,2,1,0.0,1.0,0.0,0.0,0.0,0.0,
698,1,3,0,1,1,4,1,5,4,147.0,0.25,1.0,0.0,0.0,2.0,
315,1,1,0,0,1,1,1,2,1,0.0,1.0,0.0,0.0,0.0,0.0,
109,1,2,0,0,1,2,1,3,2,35.0,0.5,1.0,0.0,0.0,1.0,
634,0,0,1,1,1,1,1,2,1,0.0,1.0,0.0,0.0,0.0,0.0,
792,1,0,0,1,1,1,1,2,1,0.0,1.0,0.0,0.0,0.0,0.0,
475,1,0,0,1,1,1,1,2,1,0.0,1.0,0.0,0.0,0.0,0.0,
354,3,2,0,0,3,2,3,5,4,31.0,1.5,2.0,1.0,0.8333333333333333,0.875,
269,1,1,0,1,1,2,1,3,2,26.0,0.5,1.0,0.0,0.0,1.0,
841,3,2,1,2,4,4,3,8,7,115.0,1.0,2.5,0.25,0.8333333333333333,1.75,
775,2,1,0,1,2,2,2,4,3,136.0,1.0,1.5,0.25,0.5,1.0,
495,1,0,0,1,1,1,1,2,1,0.0,1.0,0.0,0.0,0.0,0.0,
71,1,1,0,0,1,1,1,2,1,0.0,1.0,0.0,0.0,0.0,0.0,
15,1,2,0,0,1,2,1,3,2,55.0,0.5,1.0,0.0,0.0,1.0,
771,2,1,0,0,2,1,2,3,2,20.0,2.0,2.0,0.0,1.0,0.5,
256,2,1,0,1,2,2,2,4,3,33.0,1.0,2.0,0.0,1.0,1.0,
880,1,1,0,1,1,2,1,3,2,64.0,0.5,1.0,0.0,0.0,1.0,
236,2,3,0,0,2,3,2,5,4,133.0,0.6666666666666666,1.3333333333333333,0.2222222222222222,0.5,1.5,
672,1,1,0,0,1,1,1,2,1,0.0,1.0,0.0,0.0,0.0,0.0,
824,2,0,0,1,2,1,2,3,2,43.0,2.0,2.0,0.0,1.0,0.5,
888,1,1,0,1,1,2,1,3,2,143.0,0.5,1.0,0.0,0.0,1.0,
81,1,1,0,0,1,1,1,2,1,0.0,1.0,0.0,0.0,0.0,0.0,
254,1,1,0,0,1,1,1,2,1,0.0,1.0,0.0,0.0,0.0,0.0,
97,1,1,0,0,1,1,1,2,1,0.0,1.0,0.0,0.0,0.0,0.0,
864,5,5,0,1,5,6,4,11,10,225.0,0.8333333333333334,2.5,1.5833333333333333,1.1666666666666665,2.375,
205,3,1,0,1,3,2,3,5,4,31.0,1.5,2.0,1.0,0.8333333333333333,0.875,
755,1,2,0,0,1,2,1,3,2,112.0,0.5,1.0,0.0,0.0,1.0,
862,2,1,0,0,2,1,2,3,2,22.0,2.0,2.0,0.0,1.0,0.5,
430,3,5,0,1,3,6,3,9,8,231.0,0.5,2.0,0.3333333333333333,0.8333333333333333,2.875,
839,1,1,0,0,1,1,1,2,1,0.0,1.0,0.0,0.0,0.0,0.0,
386,1,0,0,1,1,1,1,2,1,0.0,1.0,0.0,0.0,0.0,0.0,
464,1,1,0,0,1,1,1,2,1,0.0,1.0,0.0,0.0,0.0,0.0,
811,2,2,0,0,2,2,2,4,3,19.0,1.0,2.0,0.0,1.0,1.0,
696,1,1,0,0,1,1,1,2,1,0.0,1.0,0.0,0.0,0.0,0.0,
607,1,1,0,0,1,1,1,2,1,0.0,1.0,0.0,0.0,0.0,0.0,
435,4,1,0,2,4,3,4,7,6,262.0,1.3333333333333333,3.6666666666666665,0.22222222222222224,1.3333333333333333,0.875,
592,1,1,0,0,1,1,1,2,1,0.0,1.0,0.0,0.0,0.0,0.0,
537,1,2,0,0,1,2,1,3,2,3.0,0.5,1.0,0.0,0.0,1.0,
555,2,3,0,0,2,3,2,5,4,87.0,0.6666666666666666,1.6666666666666667,0.2222222222222222,0.5,1.5,
130,2,1,0,1,2,2,2,4,3,32.0,1.0,1.5,0.25,0.5,1.0,
190,3,2,0,1,3,3,3,6,5,89.0,1.0,2.3333333333333335,0.22222222222222224,1.0,1.375,
191,1,1,0,0,1,1,1,2,1,0.0,1.0,0.0,0.0,0.0,0.0,
8,1,1,0,0,1,1,1,2,1,0.0,1.0,0.0,0.0,0.0,0.0,
327,2,1,0,0,2,1,2,3,2,75.0,2.0,2.0,0.0,1.0,0.5,
699,1,1,0,0,1,1,1,2,1,0.0,1.0,0.0,0.0,0.0,0.0,
64,1,1,0,1,1,2,1,3,2,68.0,0.5,1.0,0.0,0.0,1.0,
753,2,5,0,1,2,6,2,8,7,340.0,0.3333333333333333,1.6666666666666667,0.22222222222222224,0.5,3.0,
822,2,4,0,0,2,4,2,6,5,104.0,0.5,1.25,0.1875,0.5,2.0,
784,1,2,0,0,1,2,1,3,2,16.0,0.5,1.0,0.0,0.0,1.0,
265,2,0,0,2,2,2,2,4,3,99.0,1.0,1.5,0.25,0.5,1.0,
850,1,2,0,0,1,2,1,3,2,10.0,0.5,1.0,0.0,0.0,1.0,
344,3,3,0,0,3,3,3,6,5,122.0,1.0,1.6666666666666667,0.888888888888889,0.8333333333333333,1.375,
909,1,1,0,0,1,1,1,2,1,0.0,1.0,0.0,0.0,0.0,0.0,
609,0,0,1,1,1,1,1,2,1,0.0,1.0,0.0,0.0,0.0,0.0,
335,1,1,0,0,1,1,1,2,1,0.0,1.0,0.0,0.0,0.0,0.0,
700,1,0,0,1,1,1,1,2,1,0.0,1.0,0.0,0.0,0.0,0.0,
914,1,1,0,0,1,1,1,2,1,0.0,1.0,0.0,0.0,0.0,0.0,
115,1,3,0,1,1,4,1,5,4,171.0,0.25,1.0,0.0,0.0,2.0,
438,8,2,0,4,8,6,6,14,13,209.0,1.3333333333333333,2.6666666666666665,4.222222222222222,1.269047619047619,2.25,
45,1,1,0,0,1,1,1,2,1,0.0,1.0,0.0,0.0,0.0,0.0,
113,2,1,0,0,2,1,2,3,2,1.0,2.0,2.0,0.0,1.0,0.5,
615,1,2,0,0,1,2,1,3,2,43.0,0.5,1.0,0.0,0.0,1.0,
549,1,1,0,0,1,1,1,2,1,0.0,1.0,0.0,0.0,0.0,0.0,
148,2,1,0,0,2,1,2,3,2,78.0,2.0,2.0,0.0,1.0,0.5,
629,1,1,0,0,1,1,1,2,1,0.0,1.0,0.0,0.0,0.0,0.0,
711,8,7,0,2,8,9,4,17,16,253.0,0.8888888888888888,2.888888888888889,0.9876543209876544,1.3833333333333333,3.375,
248,1,1,0,1,1,2,1,3,2,12.0,0.5,1.0,0.0,0.0,1.0,
263,3,1,0,1,3,2,3,5,4,141.0,1.5,2.5,0.25,1.0,0.875,
652,1,3,0,1,1,4,1,5,4,190.0,0.25,1.0,0.0,0.0,2.0,
730,1,2,0,0,1,2,1,3,2,15.0,0.5,1.0,0.0,0.0,1.0,
731,1,1,0,1,1,2,1,3,2,2.0,0.5,1.0,0.0,0.0,1.0,
543,2,3,1,2,3,5,3,8,7,251.0,0.6,1.4,0.6400000000000002,0.8333333333333333,2.375,
206,2,0,0,1,2,1,2,3,2,25.0,2.0,2.0,0.0,1.0,0.5,
321,1,1,0,1,1,2,1,3,2,16.0,0.5,1.0,0.0,0.0,1.0,
878,1,2,0,0,1,2,1,3,2,22.0,0.5,1.0,0.0,0.0,1.0,
680,1,3,0,1,1,4,1,5,4,300.0,0.25,1.0,0.0,0.0,2.0,
49,1,1,0,0,1,1,1,2,1,0.0,1.0,0.0,0.0,0.0,0.0,
155,1,1,0,0,1,1,1,2,1,0.0,1.0,0.0,0.0,0.0,0.0,
754,2,1,0,0,2,1,2,3,2,23.0,2.0,2.0,0.0,1.0,0.5,
35,1,1,0,0,1,1,1,2,1,0.0,1.0,0.0,0.0,0.0,0.0,
535,1,1,0,0,1,1,1,2,1,0.0,1.0,0.0,0.0,0.0,0.0,
445,1,0,0,1,1,1,1,2,1,0.0,1.0,0.0,0.0,0.0,0.0,
65,1,1,0,0,1,1,1,2,1,0.0,1.0,0.0,0.0,0.0,0.0,
396,1,1,0,0,1,1,1,2,1,0.0,1.0,0.0,0.0,0.0,0.0,
384,1,1,1,0,2,1,2,3,2,145.0,2.0,2.0,0.0,1.0,0.5,
848,8,12,0,5,8,17,6,25,24,452.0,0.47058823529411764,3.5294117647058822,3.190311418685121,1.3023809523809524,5.28125,
849,1,1,0,0,1,1,1,2,1,0.0,1.0,0.0,0.0,0.0,0.0,
351,2,3,0,0,2,3,2,5,4,53.0,0.6666666666666666,2.0,0.0,1.0,1.5,
819,1,1,0,0,1,1,1,2,1,0.0,1.0,0.0,0.0,0.0,0.0,
508,1,1,0,0,1,1,1,2,1,0.0,1.0,0.0,0.0,0.0,0.0,
906,1,3,0,1,1,4,1,5,4,99.0,0.25,1.0,0.0,0.0,2.0,
689,3,2,0,0,3,2,2,5,4,67.0,1.5,2.0,0.0,0.6666666666666666,1.0,
660,1,1,0,0,1,1,1,2,1,0.0,1.0,0.0,0.0,0.0,0.0,
222,4,5,0,1,4,6,4,10,9,172.0,0.6666666666666666,3.0,0.6666666666666666,1.1666666666666665,2.25,
770,1,0,0,1,1,1,1,2,1,0.0,1.0,0.0,0.0,0.0,0.0,
450,1,1,0,1,1,2,1,3,2,7.0,0.5,1.0,0.0,0.0,1.0,
500,1,1,0,1,1,2,1,3,2,0.0,0.5,1.0,0.0,0.0,1.0,
134,1,1,0,0,1,1,1,2,1,0.0,1.0,0.0,0.0,0.0,0.0,
288,1,3,0,1,1,4,1,5,4,128.0,0.25,1.0,0.0,0.0,2.0,
406,4,0,0,1,4,1,4,5,4,114.0,4.0,4.0,0.0,1.8333333333333333,0.25,
601,5,6,0,0,5,6,3,11,10,259.0,0.8333333333333334,1.6666666666666667,0.5555555555555557,1.0833333333333333,2.875,
458,3,0,0,2,3,2,2,5,4,51.0,1.5,2.0,0.0,0.6666666666666666,1.0,
442,1,1,0,0,1,1,1,2,1,0.0,1.0,0.0,0.0,0.0,0.0,
104,1,1,0,0,1,1,1,2,1,0.0,1.0,0.0,0.0,0.0,0.0,
282,1,2,0,0,1,2,1,3,2,4.0,0.5,1.0,0.0,0.0,1.0,
25,2,0,0,1,2,1,2,3,2,41.0,2.0,2.0,0.0,1.0,0.5,
229,2,1,0,0,2,1,2,3,2,22.0,2.0,2.0,0.0,1.0,0.5,
410,1,1,1,0,2,1,2,3,2,15.0,2.0,2.0,0.0,1.0,0.5,
572,2,0,0,1,2,1,2,3,2,31.0,2.0,2.0,0.0,1.0,0.5,
490,1,1,0,0,1,1,1,2,1,0.0,1.0,0.0,0.0,0.0,0.0,
575,4,6,0,1,4,7,3,11,10,313.0,0.5714285714285714,2.2857142857142856,0.489795918367347,1.1666666666666665,3.125,
746,1,0,0,1,1,1,1,2,1,0.0,1.0,0.0,0.0,0.0,0.0,
171,1,1,0,0,1,1,1,2,1,0.0,1.0,0.0,0.0,0.0,0.0,
480,2,1,0,1,2,2,2,4,3,108.0,1.0,1.5,0.25,0.5,1.0,
304,3,0,0,2,3,2,3,5,4,274.0,1.5,3.0,0.0,1.5,0.75,
118,0,0,1,1,1,1,1,2,1,0.0,1.0,0.0,0.0,0.0,0.0,
650,1,1,0,0,1,1,1,2,1,0.0,1.0,0.0,0.0,0.0,0.0,
514,1,1,0,0,1,1,1,2,1,0.0,1.0,0.0,0.0,0.0,0.0,
808,1,1,0,0,1,1,1,2,1,0.0,1.0,0.0,0.0,0.0,0.0,
20,4,1,0,2,4,3,2,7,6,105.0,1.3333333333333333,2.0,0.0,1.0,1.5,
703,2,2,0,0,2,2,2,4,3,59.0,1.0,2.0,0.0,1.0,1.0,
397,11,12,2,1,13,13,10,26,25,376.0,1.0,5.538461538461538,9.940828402366863,1.2174103674103673,2.96875,
400,1,1,0,0,1,1,1,2,1,0.0,1.0,0.0,0.0,0.0,0.0,
186,3,1,0,0,3,1,3,4,3,25.0,3.0,3.0,0.0,1.5,0.375,
338,2,1,0,0,2,1,2,3,2,17.0,2.0,2.0,0.0,1.0,0.5,
216,1,3,0,0,1,3,1,4,3,39.0,0.3333333333333333,1.0,0.0,0.0,1.5,
573,2,1,0,2,2,3,2,5,4,37.0,0.6666666666666666,1.6666666666666667,0.2222222222222222,0.5,1.5,
898,2,1,0,0,2,1,2,3,2,11.0,2.0,2.0,0.0,1.0,0.5,
98,1,1,0,1,1,2,1,3,2,16.0,0.5,1.0,0.0,0.0,1.0,
174,3,6,0,0,3,6,2,9,8,234.0,0.5,1.8333333333333333,0.13888888888888887,0.6666666666666666,3.0,
653,1,0,0,1,1,1,1,2,1,0.0,1.0,0.0,0.0,0.0,0.0,
528,1,1,0,0,1,1,1,2,1,0.0,1.0,0.0,0.0,0.0,0.0,
466,1,1,0,0,1,1,1,2,1,0.0,1.0,0.0,0.0,0.0,0.0,
533,2,2,0,0,2,2,2,4,3,30.0,1.0,2.0,0.0,1.0,1.0,
373,1,0,0,1,1,1,1,2,1,0.0,1.0,0.0,0.0,0.0,0.0,
180,1,1,0,0,1,1,1,2,1,0.0,1.0,0.0,0.0,0.0,0.0,
255,1,1,0,0,1,1,1,2,1,0.0,1.0,0.0,0.0,0.0,0.0,
692,1,2,0,0,1,2,1,3,2,68.0,0.5,1.0,0.0,0.0,1.0,
632,9,7,0,4,9,11,4,20,19,278.0,0.8181818181818182,3.1818181818181817,0.6942148760330578,1.883333333333333,3.875,
439,1,1,0,0,1,1,1,2,1,0.0,1.0,0.0,0.0,0.0,0.0,
504,1,1,0,0,1,1,1,2,1,0.0,1.0,0.0,0.0,0.0,0.0,
461,4,4,0,2,4,6,4,10,9,139.0,0.6666666666666666,1.8333333333333333,1.4722222222222223,0.9166666666666665,2.625,
93,1,1,0,0,1,1,1,2,1,0.0,1.0,0.0,0.0,0.0,0.0,
267,1,2,0,0,1,2,1,3,2,1.0,0.5,1.0,0.0,0.0,1.0,
757,7,5,0,2,7,7,4,14,13,347.0,1.0,3.142857142857143,0.9795918367346939,1.019047619047619,2.375,
54,4,1,0,0,4,1,4,5,4,84.0,4.0,4.0,0.0,1.8333333333333333,0.25,
638,1,1,0,1,1,2,1,3,2,3.0,0.5,1.0,0.0,0.0,1.0,
343,1,0,0,1,1,1,1,2,1,0.0,1.0,0.0,0.0,0.0,0.0,
392,1,5,0,0,1,5,1,6,5,131.0,0.2,1.0,0.0,0.0,2.5,
52,1,1,0,0,1,1,1,2,1,0.0,1.0,0.0,0.0,0.0,0.0,
736,1,2,0,0,1,2,1,3,2,23.0,0.5,1.0,0.0,0.0,1.0,
860,1,1,0,1,1,2,1,3,2,22.0,0.5,1.0,0.0,0.0,1.0,
143,3,1,0,0,3,1,3,4,3,9.0,3.0,3.0,0.0,1.5,0.375,
358,2,3,0,2,2,5,2,7,6,321.0,0.4,1.8,0.16,0.5,2.5,
238,1,1,0,1,1,2,1,3,2,55.0,0.5,1.0,0.0,0.0,1.0,
245,1,1,0,1,1,2,1,3,2,58.0,0.5,1.0,0.0,0.0,1.0,
16,1,1,0,1,1,2,1,3,2,3.0,0.5,1.0,0.0,0.0,1.0,
715,1,1,0,0,1,1,1,2,1,0.0,1.0,0.0,0.0,0.0,0.0,
360,1,2,0,0,1,2,1,3,2,40.0,0.5,1.0,0.0,0.0,1.0,
590,1,1,0,0,1,1,1,2,1,0.0,1.0,0.0,0.0,0.0,0.0,
550,2,2,0,1,2,3,2,5,4,58.0,0.6666666666666666,1.3333333333333333,0.2222222222222222,0.5,1.5,
661,1,1,0,0,1,1,1,2,1,0.0,1.0,0.0,0.0,0.0,0.0,
455,5,5,0,2,5,7,3,12,11,368.0,0.7142857142857143,2.5714285714285716,0.5306122448979592,1.5,2.875,
685,1,1,0,0,1,1,1,2,1,0.0,1.0,0.0,0.0,0.0,0.0,
325,1,1,0,0,1,1,1,2,1,0.0,1.0,0.0,0.0,0.0,0.0,
399,4,1,0,2,4,3,3,7,6,48.0,1.3333333333333333,2.3333333333333335,0.22222222222222224,0.8333333333333333,1.375,
231,2,1,0,1,2,2,2,4,3,19.0,1.0,2.0,0.0,1.0,1.0,
720,1,1,0,0,1,1,1,2,1,0.0,1.0,0.0,0.0,0.0,0.0,
124,1,2,0,0,1,2,1,3,2,39.0,0.5,1.0,0.0,0.0,1.0,
192,1,1,0,0,1,1,1,2,1,0.0,1.0,0.0,0.0,0.0,0.0,
390,1,1,0,1,1,2,1,3,2,11.0,0.5,1.0,0.0,0.0,1.0,
185,2,2,0,0,2,2,2,4,3,111.0,1.0,1.5,0.25,0.5,1.0,
882,1,1,0,0,1,1,1,2,1,0.0,1.0,0.0,0.0,0.0,0.0,
795,2,2,0,0,2,2,2,4,3,68.0,1.0,1.5,0.25,0.5,1.0,
665,6,4,0,2,6,6,5,12,11,405.0,1.0,3.3333333333333335,1.888888888888889,1.0333333333333332,1.90625,
285,3,1,0,0,3,1,3,4,3,28.0,3.0,3.0,0.0,1.5,0.375,
280,1,1,0,0,1,1,1,2,1,0.0,1.0,0.0,0.0,0.0,0.0,
558,1,2,0,0,1,2,1,3,2,14.0,0.5,1.0,0.0,0.0,1.0,
760,2,5,0,2,2,7,2,9,8,192.0,0.2857142857142857,1.1428571428571428,0.12244897959183675,0.5,3.5,
872,1,1,0,0,1,1,1,2,1,0.0,1.0,0.0,0.0,0.0,0.0,
429,2,1,0,1,2,2,2,4,3,25.0,1.0,1.5,0.25,0.5,1.0,
302,1,2,0,0,1,2,1,3,2,18.0,0.5,1.0,0.0,0.0,1.0,
833,2,1,0,0,2,1,2,3,2,13.0,2.0,2.0,0.0,1.0,0.5,
566,4,4,0,2,4,6,3,10,9,160.0,0.6666666666666666,2.0,0.3333333333333333,0.8333333333333333,2.875,
832,1,0,0,1,1,1,1,2,1,0.0,1.0,0.0,0.0,0.0,0.0,
421,1,1,0,0,1,1,1,2,1,0.0,1.0,0.0,0.0,0.0,0.0,
316,1,1,0,0,1,1,1,2,1,0.0,1.0,0.0,0.0,0.0,0.0,
133,1,0,0,1,1,1,1,2,1,0.0,1.0,0.0,0.0,0.0,0.0,
88,1,0,0,1,1,1,1,2,1,0.0,1.0,0.0,0.0,0.0,0.0,
85,2,3,0,0,2,3,2,5,4,163.0,0.6666666666666666,2.0,0.0,1.0,1.5,
532,3,3,0,1,3,4,2,7,6,118.0,0.75,1.5,0.25,0.6666666666666666,2.0,
70,2,2,0,0,2,2,2,4,3,28.0,1.0,1.5,0.25,0.5,1.0,
365,1,0,0,1,1,1,1,2,1,0.0,1.0,0.0,0.0,0.0,0.0,
423,4,2,0,1,4,3,4,7,6,76.0,1.3333333333333333,2.3333333333333335,1.5555555555555554,0.9166666666666665,1.25,
40,3,2,0,1,3,3,3,6,5,73.0,1.0,2.0,0.6666666666666666,0.8333333333333333,1.375,
349,2,1,0,0,2,1,2,3,2,28.0,2.0,2.0,0.0,1.0,0.5,
132,3,1,0,1,3,2,3,5,4,31.0,1.5,3.0,0.0,1.5,0.75,
44,1,2,0,0,1,2,1,3,2,49.0,0.5,1.0,0.0,0.0,1.0,
232,2,1,0,0,2,1,2,3,2,7.0,2.0,2.0,0.0,1.0,0.5,
873,1,0,0,1,1,1,1,2,1,0.0,1.0,0.0,0.0,0.0,0.0,
772,5,4,0,1,5,5,4,10,9,143.0,1.0,1.8,1.36,0.9833333333333334,2.25,
405,5,2,0,2,5,4,5,9,8,191.0,1.25,3.5,2.75,1.0333333333333332,1.1875,
834,1,0,0,1,1,1,1,2,1,0.0,1.0,0.0,0.0,0.0,0.0,
169,1,1,0,0,1,1,1,2,1,0.0,1.0,0.0,0.0,0.0,0.0,
408,1,1,0,0,1,1,1,2,1,0.0,1.0,0.0,0.0,0.0,0.0,
894,1,0,0,1,1,1,1,2,1,0.0,1.0,0.0,0.0,0.0,0.0,
769,1,1,0,0,1,1,1,2,1,0.0,1.0,0.0,0.0,0.0,0.0,
41,1,1,0,0,1,1,1,2,1,0.0,1.0,0.0,0.0,0.0,0.0,
714,1,1,0,1,1,2,1,3,2,21.0,0.5,1.0,0.0,0.0,1.0,
287,5,5,0,1,5,6,3,11,10,216.0,0.8333333333333334,2.1666666666666665,0.47222222222222215,1.0833333333333333,2.75,
828,1,0,0,1,1,1,1,2,1,0.0,1.0,0.0,0.0,0.0,0.0,
100,1,0,0,1,1,1,1,2,1,0.0,1.0,0.0,0.0,0.0,0.0,
407,3,1,0,1,3,2,3,5,4,57.0,1.5,2.5,0.25,1.0,0.875,
536,2,1,0,1,2,2,2,4,3,31.0,1.0,1.5,0.25,0.5,1.0,
299,1,1,0,0,1,1,1,2,1,0.0,1.0,0.0,0.0,0.0,0.0,
589,1,0,0,1,1,1,1,2,1,0.0,1.0,0.0,0.0,0.0,0.0,
91,2,1,0,0,2,1,2,3,2,23.0,2.0,2.0,0.0,1.0,0.5,
246,1,0,0,1,1,1,1,2,1,0.0,1.0,0.0,0.0,0.0,0.0,
585,2,1,0,0,2,1,2,3,2,9.0,2.0,2.0,0.0,1.0,0.5,
301,2,2,0,1,2,3,2,5,4,110.0,0.6666666666666666,1.3333333333333333,0.2222222222222222,0.5,1.5,
915,1,1,0,0,1,1,1,2,1,0.0,1.0,0.0,0.0,0.0,0.0,
39,1,2,0,0,1,2,1,3,2,83.0,0.5,1.0,0.0,0.0,1.0,
790,1,1,0,1,1,2,1,3,2,85.0,0.5,1.0,0.0,0.0,1.0,
874,1,2,0,0,1,2,1,3,2,0.0,0.5,1.0,0.0,0.0,1.0,
234,3,2,0,0,3,2,3,5,4,204.0,1.5,2.5,0.25,1.0,0.875,
781,1,1,0,0,1,1,1,2,1,0.0,1.0,0.0,0.0,0.0,0.0,
18,1,0,0,1,1,1,1,2,1,0.0,1.0,0.0,0.0,0.0,0.0,
161,2,3,0,1,2,4,2,6,5,15.0,0.5,1.5,0.25,0.5,2.0,
546,3,3,0,0,3,3,3,6,5,165.0,1.0,2.6666666666666665,0.22222222222222224,1.0,1.25,
840,1,1,0,0,1,1,1,2,1,0.0,1.0,0.0,0.0,0.0,0.0,
749,3,0,0,3,3,3,3,6,5,92.0,1.0,2.6666666666666665,0.22222222222222224,1.0,1.25,
36,2,1,0,1,2,2,2,4,3,67.0,1.0,2.0,0.0,1.0,1.0,
219,1,1,0,0,1,1,1,2,1,0.0,1.0,0.0,0.0,0.0,0.0,
204,8,6,0,0,8,6,6,14,13,247.0,1.3333333333333333,2.3333333333333335,3.222222222222222,1.269047619047619,2.46875,
419,1,1,0,0,1,1,1,2,1,0.0,1.0,0.0,0.0,0.0,0.0,
843,9,8,0,3,9,11,3,20,19,294.0,0.8181818181818182,2.272727272727273,0.38016528925619836,1.85,5.0,
424,3,0,0,1,3,1,3,4,3,98.0,3.0,3.0,0.0,1.5,0.375,
748,1,1,0,0,1,1,1,2,1,0.0,1.0,0.0,0.0,0.0,0.0,
877,1,1,0,0,1,1,1,2,1,0.0,1.0,0.0,0.0,0.0,0.0,
635,1,1,0,0,1,1,1,2,1,0.0,1.0,0.0,0.0,0.0,0.0,
61,2,3,0,0,2,3,2,5,4,290.0,0.6666666666666666,1.6666666666666667,0.2222222222222222,0.5,1.5,
521,3,1,0,2,3,3,2,6,5,113.0,1.0,1.6666666666666667,0.2222222222222222,0.6666666666666666,1.5,
87,3,0,0,1,3,1,3,4,3,21.0,3.0,3.0,0.0,1.5,0.375,
182,1,1,0,0,1,1,1,2,1,0.0,1.0,0.0,0.0,0.0,0.0,
788,5,2,0,1,5,3,4,8,7,157.0,1.6666666666666667,3.0,2.0,1.1666666666666665,1.0,
726,1,1,0,0,1,1,1,2,1,0.0,1.0,0.0,0.0,0.0,0.0,
362,1,0,0,1,1,1,1,2,1,0.0,1.0,0.0,0.0,0.0,0.0,
479,2,1,0,0,2,1,2,3,2,34.0,2.0,2.0,0.0,1.0,0.5,
648,9,6,0,1,9,7,4,16,15,300.0,1.2857142857142858,3.2857142857142856,0.489795918367347,1.9333333333333331,2.375,
663,3,2,0,1,3,3,2,6,5,155.0,1.0,2.0,0.0,0.6666666666666666,1.5,
574,2,1,0,1,2,2,2,4,3,94.0,1.0,1.5,0.25,0.5,1.0,
541,2,1,0,0,2,1,2,3,2,7.0,2.0,2.0,0.0,1.0,0.5,
456,2,2,0,0,2,2,2,4,3,15.0,1.0,1.5,0.25,0.5,1.0,
809,1,1,0,0,1,1,1,2,1,0.0,1.0,0.0,0.0,0.0,0.0,
178,3,3,0,0,3,3,2,6,5,261.0,1.0,2.0,0.0,0.6666666666666666,1.5,
82,1,1,0,0,1,1,1,2,1,0.0,1.0,0.0,0.0,0.0,0.0,
112,1,1,0,0,1,1,1,2,1,0.0,1.0,0.0,0.0,0.0,0.0,
776,1,1,0,0,1,1,1,2,1,0.0,1.0,0.0,0.0,0.0,0.0,
46,2,2,0,1,2,3,2,5,4,23.0,0.6666666666666666,1.6666666666666667,0.2222222222222222,0.5,1.5,
912,3,1,0,0,3,1,3,4,3,14.0,3.0,3.0,0.0,1.5,0.375,
356,1,1,0,0,1,1,1,2,1,0.0,1.0,0.0,0.0,0.0,0.0,
417,1,1,0,1,1,2,1,3,2,20.0,0.5,1.0,0.0,0.0,1.0,
876,1,1,0,0,1,1,1,2,1,0.0,1.0,0.0,0.0,0.0,0.0,
59,1,1,0,0,1,1,1,2,1,0.0,1.0,0.0,0.0,0.0,0.0,
63,1,2,0,1,1,3,1,4,3,42.0,0.3333333333333333,1.0,0.0,0.0,1.5,
881,3,1,0,0,3,1,3,4,3,130.0,3.0,3.0,0.0,1.5,0.375,
17,1,1,0,0,1,1,1,2,1,0.0,1.0,0.0,0.0,0.0,0.0,
10,1,2,0,0,1,2,1,3,2,3.0,0.5,1.0,0.0,0.0,1.0,
212,2,0,0,1,2,1,2,3,2,10.0,2.0,2.0,0.0,1.0,0.5,
294,1,0,0,1,1,1,1,2,1,0.0,1.0,0.0,0.0,0.0,0.0,
540,1,1,0,0,1,1,1,2,1,0.0,1.0,0.0,0.0,0.0,0.0,
218,1,1,0,0,1,1,1,2,1,0.0,1.0,0.0,0.0,0.0,0.0,
719,1,1,0,0,1,1,1,2,1,0.0,1.0,0.0,0.0,0.0,0.0,
391,3,2,0,0,3,2,3,5,4,145.0,1.5,3.0,0.0,1.5,0.75,
278,1,3,0,0,1,3,1,4,3,59.0,0.3333333333333333,1.0,0.0,0.0,1.5,
518,2,2,0,0,2,2,2,4,3,5.0,1.0,1.5,0.25,0.5,1.0,
560,2,2,0,0,2,2,2,4,3,13.0,1.0,2.0,0.0,1.0,1.0,
852,2,3,0,0,2,3,2,5,4,45.0,0.6666666666666666,2.0,0.0,1.0,1.5,
470,3,1,0,1,3,2,3,5,4,82.0,1.5,2.0,1.0,0.8333333333333333,0.875,
902,1,1,0,0,1,1,1,2,1,0.0,1.0,0.0,0.0,0.0,0.0,
544,1,0,0,1,1,1,1,2,1,0.0,1.0,0.0,0.0,0.0,0.0,
129,2,2,0,1,2,3,2,5,4,47.0,0.6666666666666666,1.3333333333333333,0.2222222222222222,0.5,1.5,
702,2,4,0,0,2,4,2,6,5,91.0,0.5,1.25,0.1875,0.5,2.0,
402,1,1,0,0,1,1,1,2,1,0.0,1.0,0.0,0.0,0.0,0.0,
33,3,10,0,0,3,10,3,13,12,287.0,0.3,2.1,0.2900000000000001,0.8333333333333333,4.75,
593,1,1,0,1,1,2,1,3,2,104.0,0.5,1.0,0.0,0.0,1.0,
879,1,1,0,0,1,1,1,2,1,0.0,1.0,0.0,0.0,0.0,0.0,
361,4,2,0,0,4,2,4,6,5,163.0,2.0,3.0,1.0,1.1666666666666665,0.75,
167,3,2,1,0,4,2,4,6,5,80.0,2.0,3.0,1.0,1.1666666666666665,0.75,
172,2,2,0,0,2,2,2,4,3,11.0,1.0,1.5,0.25,0.5,1.0,
2,1,0,0,1,1,1,1,2,1,0.0,1.0,0.0,0.0,0.0,0.0,
469,2,5,0,0,2,5,2,7,6,159.0,0.4,1.4,0.24,0.5,2.5,
43,2,1,0,0,2,1,2,3,2,40.0,2.0,2.0,0.0,1.0,0.5,
179,1,1,0,0,1,1,1,2,1,0.0,1.0,0.0,0.0,0.0,0.0,
416,2,1,0,0,2,1,2,3,2,5.0,2.0,2.0,0.0,1.0,0.5,
853,2,0,0,1,2,1,2,3,2,8.0,2.0,2.0,0.0,1.0,0.5,
667,1,2,0,0,1,2,1,3,2,65.0,0.5,1.0,0.0,0.0,1.0,
233,7,6,1,0,8,6,6,14,13,312.0,1.3333333333333333,3.3333333333333335,1.888888888888889,1.4333333333333333,2.09375,
274,4,4,0,1,4,5,4,9,8,109.0,0.8,3.0,0.4,1.1666666666666665,1.875,
311,1,1,0,0,1,1,1,2,1,0.0,1.0,0.0,0.0,0.0,0.0,
812,1,1,0,1,1,2,1,3,2,9.0,0.5,1.0,0.0,0.0,1.0,
433,1,1,0,0,1,1,1,2,1,0.0,1.0,0.0,0.0,0.0,0.0,
383,1,1,0,0,1,1,1,2,1,0.0,1.0,0.0,0.0,0.0,0.0,
766,1,0,0,1,1,1,1,2,1,0.0,1.0,0.0,0.0,0.0,0.0,
197,1,1,0,1,1,2,1,3,2,1.0,0.5,1.0,0.0,0.0,1.0,
743,0,0,1,1,1,1,1,2,1,0.0,1.0,0.0,0.0,0.0,0.0,
357,14,8,0,4,14,12,8,26,25,453.0,1.1666666666666667,5.166666666666667,6.472222222222222,1.5884920634920634,2.53125,
886,1,1,0,0,1,1,1,2,1,0.0,1.0,0.0,0.0,0.0,0.0,
47,1,1,0,1,1,2,1,3,2,21.0,0.5,1.0,0.0,0.0,1.0,
465,3,4,1,1,4,5,4,9,8,241.0,0.8,3.2,0.15999999999999998,1.3333333333333333,1.75,
564,4,3,0,3,4,6,4,10,9,207.0,0.6666666666666666,1.8333333333333333,1.4722222222222223,0.9166666666666665,2.625,
165,2,2,0,0,2,2,2,4,3,415.0,1.0,1.5,0.25,0.5,1.0,
200,1,2,0,1,1,3,1,4,3,73.0,0.3333333333333333,1.0,0.0,0.0,1.5,
908,3,4,0,0,3,4,3,7,6,329.0,0.75,2.5,0.75,0.8333333333333333,1.625,
247,2,3,0,1,2,4,2,6,5,144.0,0.5,1.25,0.1875,0.5,2.0,
13,3,1,0,0,3,1,3,4,3,58.0,3.0,3.0,0.0,1.5,0.375,
159,2,0,0,1,2,1,2,3,2,5.0,2.0,2.0,0.0,1.0,0.5,
431,1,1,0,0,1,1,1,2,1,0.0,1.0,0.0,0.0,0.0,0.0,
756,18,11,0,3,18,14,8,32,31,302.0,1.2857142857142858,4.928571428571429,1.9234693877551015,1.6777639027639024,2.6484375,
827,11,11,0,4,11,15,6,26,25,541.0,0.7333333333333333,3.466666666666667,2.382222222222222,1.4952380952380953,4.9375,
831,1,1,0,0,1,1,1,2,1,0.0,1.0,0.0,0.0,0.0,0.0,
688,1,4,1,0,2,4,2,6,5,87.0,0.5,1.75,0.1875,0.5,2.0,
710,4,5,0,0,4,5,3,9,8,58.0,0.8,1.6,0.64,0.8333333333333333,2.375,
735,3,2,0,0,3,2,3,5,4,62.0,1.5,3.0,0.0,1.5,0.75,
826,1,1,0,0,1,1,1,2,1,0.0,1.0,0.0,0.0,0.0,0.0,
76,3,2,0,0,3,2,3,5,4,55.0,1.5,2.0,1.0,0.8333333333333333,0.875,
861,1,1,0,0,1,1,1,2,1,0.0,1.0,0.0,0.0,0.0,0.0,
202,1,1,0,1,1,2,1,3,2,4.0,0.5,1.0,0.0,0.0,1.0,
370,6,3,0,5,6,8,3,14,13,141.0,0.75,2.0,0.5,1.15,3.75,
368,1,2,0,0,1,2,1,3,2,28.0,0.5,1.0,0.0,0.0,1.0,
58,1,0,0,1,1,1,1,2,1,0.0,1.0,0.0,0.0,0.0,0.0,
401,2,0,0,1,2,1,2,3,2,46.0,2.0,2.0,0.0,1.0,0.5,
489,1,0,0,1,1,1,1,2,1,0.0,1.0,0.0,0.0,0.0,0.0,
1,7,6,0,3,7,9,5,16,15,293.0,0.7777777777777778,2.6666666666666665,1.555555555555556,1.069047619047619,3.53125,
306,1,1,0,0,1,1,1,2,1,0.0,1.0,0.0,0.0,0.0,0.0,
126,1,0,0,1,1,1,1,2,1,0.0,1.0,0.0,0.0,0.0,0.0,
569,2,0,0,2,2,2,2,4,3,53.0,1.0,1.5,0.25,0.5,1.0,
765,1,3,0,0,1,3,1,4,3,19.0,0.3333333333333333,1.0,0.0,0.0,1.5,
677,3,1,0,2,3,3,3,6,5,79.0,1.0,2.3333333333333335,0.22222222222222224,1.0,1.375,
381,1,0,0,1,1,1,1,2,1,0.0,1.0,0.0,0.0,0.0,0.0,
492,4,1,0,0,4,1,4,5,4,35.0,4.0,4.0,0.0,1.8333333333333333,0.25,
738,4,3,0,1,4,4,3,8,7,90.0,1.0,2.0,0.5,0.8333333333333333,1.875,
676,1,1,0,0,1,1,1,2,1,0.0,1.0,0.0,0.0,0.0,0.0,
606,1,0,0,1,1,1,1,2,1,0.0,1.0,0.0,0.0,0.0,0.0,
579,1,1,0,1,1,2,1,3,2,183.0,0.5,1.0,0.0,0.0,1.0,
453,2,2,0,0,2,2,2,4,3,23.0,1.0,1.5,0.25,0.5,1.0,
333,1,2,0,0,1,2,1,3,2,29.0,0.5,1.0,0.0,0.0,1.0,
374,1,2,0,1,1,3,1,4,3,127.0,0.3333333333333333,1.0,0.0,0.0,1.5,
697,1,1,0,0,1,1,1,2,1,0.0,1.0,0.0,0.0,0.0,0.0,
623,4,2,0,0,4,2,4,6,5,194.0,2.0,3.0,1.0,1.1666666666666665,0.75,
737,1,1,0,0,1,1,1,2,1,0.0,1.0,0.0,0.0,0.0,0.0,
644,1,0,0,1,1,1,1,2,1,0.0,1.0,0.0,0.0,0.0,0.0,
441,1,2,0,0,1,2,1,3,2,18.0,0.5,1.0,0.0,0.0,1.0,
106,1,3,0,1,1,4,1,5,4,255.0,0.25,1.0,0.0,0.0,2.0,
198,4,5,0,0,4,5,3,9,8,73.0,0.8,2.4,0.64,0.8333333333333333,2.125,
483,1,0,0,1,1,1,1,2,1,0.0,1.0,0.0,0.0,0.0,0.0,
213,1,2,0,0,1,2,1,3,2,7.0,0.5,1.0,0.0,0.0,1.0,
460,1,0,0,1,1,1,1,2,1,0.0,1.0,0.0,0.0,0.0,0.0,
605,3,1,0,1,3,2,3,5,4,99.0,1.5,2.0,1.0,0.8333333333333333,0.875,
149,1,1,0,1,1,2,1,3,2,200.0,0.5,1.0,0.0,0.0,1.0,
580,1,0,0,1,1,1,1,2,1,0.0,1.0,0.0,0.0,0.0,0.0,
739,2,3,0,1,2,4,2,6,5,107.0,0.5,1.5,0.25,0.5,2.0,
312,4,2,0,1,4,3,3,7,6,133.0,1.3333333333333333,2.6666666666666665,0.22222222222222224,0.8333333333333333,1.25,
139,1,1,0,0,1,1,1,2,1,0.0,1.0,0.0,0.0,0.0,0.0,
670,1,0,0,1,1,1,1,2,1,0.0,1.0,0.0,0.0,0.0,0.0,
847,2,0,0,1,2,1,2,3,2,12.0,2.0,2.0,0.0,1.0,0.5,
279,2,3,0,0,2,3,2,5,4,205.0,0.6666666666666666,2.0,0.0,1.0,1.5,
346,2,2,1,0,3,2,2,5,4,81.0,1.5,2.0,0.0,0.6666666666666666,1.0,
366,1,1,0,0,1,1,1,2,1,0.0,1.0,0.0,0.0,0.0,0.0,
631,6,5,0,1,6,6,6,12,11,226.0,1.0,3.3333333333333335,1.888888888888889,1.2333333333333334,2.09375,
497,3,3,1,0,4,3,4,7,6,30.0,1.3333333333333333,3.6666666666666665,0.22222222222222224,1.3333333333333333,0.875,
412,1,2,0,1,1,3,1,4,3,42.0,0.3333333333333333,1.0,0.0,0.0,1.5,
121,3,7,0,1,3,8,2,11,10,337.0,0.375,1.625,0.234375,0.6666666666666666,4.0,
7,1,2,0,0,1,2,1,3,2,22.0,0.5,1.0,0.0,0.0,1.0,
266,1,0,0,1,1,1,1,2,1,0.0,1.0,0.0,0.0,0.0,0.0,
184,9,3,0,1,9,4,7,13,12,435.0,2.25,4.0,4.5,1.2511904761904762,1.2109375,
791,1,1,0,0,1,1,1,2,1,0.0,1.0,0.0,0.0,0.0,0.0,
372,1,1,0,0,1,1,1,2,1,0.0,1.0,0.0,0.0,0.0,0.0,
376,3,1,0,1,3,2,3,5,4,89.0,1.5,2.0,1.0,0.8333333333333333,0.875,
158,1,0,0,1,1,1,1,2,1,0.0,1.0,0.0,0.0,0.0,0.0,
210,1,2,0,1,1,3,1,4,3,69.0,0.3333333333333333,1.0,0.0,0.0,1.5,
552,1,4,0,1,1,5,1,6,5,168.0,0.2,1.0,0.0,0.0,2.5,
523,2,1,0,0,2,1,2,3,2,26.0,2.0,2.0,0.0,1.0,0.5,
144,1,1,0,0,1,1,1,2,1,0.0,1.0,0.0,0.0,0.0,0.0,
74,1,1,0,0,1,1,1,2,1,0.0,1.0,0.0,0.0,0.0,0.0,
628,1,2,0,0,1,2,1,3,2,54.0,0.5,1.0,0.0,0.0,1.0,
331,1,2,0,1,1,3,1,4,3,85.0,0.3333333333333333,1.0,0.0,0.0,1.5,
135,3,2,0,5,3,7,2,10,9,180.0,0.42857142857142855,1.2857142857142858,0.20408163265306126,0.6666666666666666,3.5,
14,1,2,0,0,1,2,1,3,2,59.0,0.5,1.0,0.0,0.0,1.0,
506,0,2,1,0,1,2,1,3,2,0.0,0.5,1.0,0.0,0.0,1.0,
799,9,5,1,6,10,11,9,21,20,537.0,0.9090909090909091,5.636363636363637,3.8677685950413223,1.394047619047619,1.736328125,
86,1,1,0,0,1,1,1,2,1,0.0,1.0,0.0,0.0,0.0,0.0,
694,7,5,0,2,7,7,5,14,13,262.0,1.0,2.0,2.0,1.2333333333333332,3.03125,
463,1,2,0,0,1,2,1,3,2,64.0,0.5,1.0,0.0,0.0,1.0,
651,1,0,0,1,1,1,1,2,1,0.0,1.0,0.0,0.0,0.0,0.0,
99,1,0,0,1,1,1,1,2,1,0.0,1.0,0.0,0.0,0.0,0.0,
152,3,1,0,1,3,2,2,5,4,51.0,1.5,2.0,0.0,0.6666666666666666,1.0,
610,1,1,0,0,1,1,1,2,1,0.0,1.0,0.0,0.0,0.0,0.0,
102,2,2,0,0,2,2,2,4,3,16.0,1.0,1.5,0.25,0.5,1.0,
761,1,1,0,0,1,1,1,2,1,0.0,1.0,0.0,0.0,0.0,0.0,
298,1,1,0,0,1,1,1,2,1,0.0,1.0,0.0,0.0,0.0,0.0,
622,6,5,0,4,6,9,4,15,14,256.0,0.6666666666666666,2.6666666666666665,1.1111111111111112,1.4166666666666665,3.5,
830,1,1,0,1,1,2,1,3,2,29.0,0.5,1.0,0.0,0.0,1.0,
101,3,1,0,0,3,1,3,4,3,150.0,3.0,3.0,0.0,1.5,0.375,
503,1,1,0,0,1,1,1,2,1,0.0,1.0,0.0,0.0,0.0,0.0,
810,1,2,0,0,1,2,1,3,2,22.0,0.5,1.0,0.0,0.0,1.0,
223,2,0,0,1,2,1,2,3,2,32.0,2.0,2.0,0.0,1.0,0.5,
297,1,1,0,0,1,1,1,2,1,0.0,1.0,0.0,0.0,0.0,0.0,
595,1,1,0,0,1,1,1,2,1,0.0,1.0,0.0,0.0,0.0,0.0,
156,2,2,0,0,2,2,2,4,3,8.0,1.0,1.5,0.25,0.5,1.0,
813,3,5,1,0,4,5,4,9,8,192.0,0.8,2.0,1.2,0.9166666666666665,2.25,
5,1,0,0,2,1,2,1,3,2,19.0,0.5,1.0,0.0,0.0,1.0,
758,1,0,0,1,1,1,1,2,1,0.0,1.0,0.0,0.0,0.0,0.0,
448,1,1,0,0,1,1,1,2,1,0.0,1.0,0.0,0.0,0.0,0.0,
89,1,1,0,0,1,1,1,2,1,0.0,1.0,0.0,0.0,0.0,0.0,
252,2,1,0,0,2,1,2,3,2,3.0,2.0,2.0,0.0,1.0,0.5,
797,2,3,0,1,2,4,2,6,5,344.0,0.5,1.25,0.1875,0.5,2.0,
488,2,1,0,0,2,1,2,3,2,7.0,2.0,2.0,0.0,1.0,0.5,
820,1,0,0,1,1,1,1,2,1,0.0,1.0,0.0,0.0,0.0,0.0,
568,1,0,0,1,1,1,1,2,1,0.0,1.0,0.0,0.0,0.0,0.0,
95,2,2,0,0,2,2,2,4,3,56.0,1.0,2.0,0.0,1.0,1.0,
425,1,1,0,0,1,1,1,2,1,0.0,1.0,0.0,0.0,0.0,0.0,
189,1,1,0,1,1,2,1,3,2,97.0,0.5,1.0,0.0,0.0,1.0,
916,2,1,0,1,2,2,2,4,3,128.0,1.0,2.0,0.0,1.0,1.0,
559,1,1,0,0,1,1,1,2,1,0.0,1.0,0.0,0.0,0.0,0.0,
378,2,1,0,0,2,1,2,3,2,15.0,2.0,2.0,0.0,1.0,0.5,
617,1,1,0,0,1,1,1,2,1,0.0,1.0,0.0,0.0,0.0,0.0,
636,1,1,0,0,1,1,1,2,1,0.0,1.0,0.0,0.0,0.0,0.0,
230,3,2,0,0,3,2,3,5,4,269.0,1.5,2.0,1.0,0.8333333333333333,0.875,
162,1,0,0,1,1,1,1,2,1,0.0,1.0,0.0,0.0,0.0,0.0,
526,1,0,0,2,1,2,1,3,2,57.0,0.5,1.0,0.0,0.0,1.0,
744,1,1,0,1,1,2,1,3,2,13.0,0.5,1.0,0.0,0.0,1.0,
281,1,1,0,2,1,3,1,4,3,47.0,0.3333333333333333,1.0,0.0,0.0,1.5,
889,4,5,1,1,5,6,4,11,10,296.0,0.8333333333333334,3.0,0.3333333333333333,1.1666666666666665,2.25,
857,2,0,0,1,2,1,2,3,2,111.0,2.0,2.0,0.0,1.0,0.5,
659,1,1,0,0,1,1,1,2,1,0.0,1.0,0.0,0.0,0.0,0.0,
55,4,2,0,1,4,3,3,7,6,76.0,1.3333333333333333,2.6666666666666665,0.22222222222222224,1.1666666666666665,1.25,
867,1,1,0,0,1,1,1,2,1,0.0,1.0,0.0,0.0,0.0,0.0,
487,1,2,0,0,1,2,1,3,2,86.0,0.5,1.0,0.0,0.0,1.0,
436,1,1,0,0,1,1,1,2,1,0.0,1.0,0.0,0.0,0.0,0.0,
588,1,2,0,0,1,2,1,3,2,4.0,0.5,1.0,0.0,0.0,1.0,
29,2,2,0,0,2,2,2,4,3,84.0,1.0,2.0,0.0,1.0,1.0,
173,1,1,0,0,1,1,1,2,1,0.0,1.0,0.0,0.0,0.0,0.0,
138,7,4,0,2,7,6,5,13,12,206.0,1.1666666666666667,2.6666666666666665,2.2222222222222223,1.2333333333333334,2.28125,
594,2,1,0,1,2,2,2,4,3,114.0,1.0,1.5,0.25,0.5,1.0,
194,2,2,0,0,2,2,2,4,3,40.0,1.0,1.5,0.25,0.5,1.0,
707,1,1,1,0,2,1,2,3,2,20.0,2.0,2.0,0.0,1.0,0.5,
11,0,1,1,0,1,1,1,2,1,0.0,1.0,0.0,0.0,0.0,0.0,
136,1,1,0,0,1,1,1,2,1,0.0,1.0,0.0,0.0,0.0,0.0,
240,1,1,0,0,1,1,1,2,1,0.0,1.0,0.0,0.0,0.0,0.0,
253,1,1,0,1,1,2,1,3,2,124.0,0.5,1.0,0.0,0.0,1.0,
116,1,1,0,0,1,1,1,2,1,0.0,1.0,0.0,0.0,0.0,0.0,
398,1,1,0,0,1,1,1,2,1,0.0,1.0,0.0,0.0,0.0,0.0,
524,3,3,0,1,3,4,3,7,6,124.0,0.75,2.25,0.1875,1.0,1.875,
141,1,2,0,0,1,2,1,3,2,11.0,0.5,1.0,0.0,0.0,1.0,
796,1,2,0,0,1,2,1,3,2,12.0,0.5,1.0,0.0,0.0,1.0,
626,8,4,0,5,8,9,5,17,16,349.0,0.8888888888888888,3.888888888888889,0.7654320987654322,1.069047619047619,2.46875,
602,1,1,0,0,1,1,1,2,1,0.0,1.0,0.0,0.0,0.0,0.0,
887,1,1,0,0,1,1,1,2,1,0.0,1.0,0.0,0.0,0.0,0.0,
890,3,13,0,0,3,13,2,16,15,371.0,0.23076923076923078,1.2307692307692308,0.1775147928994083,0.6666666666666666,6.5,
577,1,2,0,0,1,2,1,3,2,6.0,0.5,1.0,0.0,0.0,1.0,
211,2,1,0,0,2,1,2,3,2,79.0,2.0,2.0,0.0,1.0,0.5,
675,1,1,0,0,1,1,1,2,1,0.0,1.0,0.0,0.0,0.0,0.0,
640,1,1,0,0,1,1,1,2,1,0.0,1.0,0.0,0.0,0.0,0.0,
866,13,3,0,4,13,7,11,20,19,372.0,1.8571428571428572,7.285714285714286,7.061224489795919,1.676984126984127,0.71240234375,
669,1,2,0,0,1,2,1,3,2,16.0,0.5,1.0,0.0,0.0,1.0,
803,1,0,0,1,1,1,1,2,1,0.0,1.0,0.0,0.0,0.0,0.0,
195,2,1,0,0,2,1,2,3,2,65.0,2.0,2.0,0.0,1.0,0.5,
77,0,0,1,1,1,1,1,2,1,0.0,1.0,0.0,0.0,0.0,0.0,
415,1,1,0,0,1,1,1,2,1,0.0,1.0,0.0,0.0,0.0,0.0,
494,1,1,0,0,1,1,1,2,1,0.0,1.0,0.0,0.0,0.0,0.0,
586,1,0,0,1,1,1,1,2,1,0.0,1.0,0.0,0.0,0.0,0.0,
633,0,0,1,1,1,1,1,2,1,0.0,1.0,0.0,0.0,0.0,0.0,
80,1,1,0,0,1,1,1,2,1,0.0,1.0,0.0,0.0,0.0,0.0,
60,1,0,0,1,1,1,1,2,1,0.0,1.0,0.0,0.0,0.0,0.0,
732,1,4,0,0,1,4,1,5,4,53.0,0.25,1.0,0.0,0.0,2.0,
530,1,1,0,0,1,1,1,2,1,0.0,1.0,0.0,0.0,0.0,0.0,
237,1,1,0,0,1,1,1,2,1,0.0,1.0,0.0,0.0,0.0,0.0,
620,2,1,0,0,2,1,2,3,2,16.0,2.0,2.0,0.0,1.0,0.5,
899,11,11,0,4,11,15,6,26,25,356.0,0.7333333333333333,3.1333333333333333,1.3155555555555554,1.7214285714285713,5.34375,
393,1,0,0,1,1,1,1,2,1,0.0,1.0,0.0,0.0,0.0,0.0,
616,5,2,0,2,5,4,4,9,8,361.0,1.25,3.0,1.0,1.4999999999999998,1.5,
845,1,1,0,0,1,1,1,2,1,0.0,1.0,0.0,0.0,0.0,0.0,
624,1,1,0,0,1,1,1,2,1,0.0,1.0,0.0,0.0,0.0,0.0,
656,1,1,0,0,1,1,1,2,1,0.0,1.0,0.0,0.0,0.0,0.0,
471,2,3,1,0,3,3,3,6,5,282.0,1.0,1.6666666666666667,0.888888888888889,0.8333333333333333,1.375,
123,4,4,0,2,4,6,4,10,9,336.0,0.6666666666666666,2.6666666666666665,1.222222222222222,0.9166666666666665,2.375,
608,17,12,0,6,17,18,12,35,34,610.0,0.9444444444444444,6.055555555555555,12.274691358024695,1.488838938838939,3.25634765625,
778,1,1,0,1,1,2,1,3,2,4.0,0.5,1.0,0.0,0.0,1.0,
32,1,1,0,0,1,1,1,2,1,0.0,1.0,0.0,0.0,0.0,0.0,
563,1,1,0,0,1,1,1,2,1,0.0,1.0,0.0,0.0,0.0,0.0,
75,1,1,0,0,1,1,1,2,1,0.0,1.0,0.0,0.0,0.0,0.0,
473,1,2,0,1,1,3,1,4,3,66.0,0.3333333333333333,1.0,0.0,0.0,1.5,
259,8,6,0,1,8,7,6,15,14,207.0,1.1428571428571428,3.0,2.5714285714285716,1.2452380952380953,2.75,
105,2,0,0,1,2,1,2,3,2,12.0,2.0,2.0,0.0,1.0,0.5,
664,1,2,0,0,1,2,1,3,2,135.0,0.5,1.0,0.0,0.0,1.0,
885,1,0,0,1,1,1,1,2,1,0.0,1.0,0.0,0.0,0.0,0.0,
320,1,2,0,0,1,2,1,3,2,13.0,0.5,1.0,0.0,0.0,1.0,
337,7,3,0,1,7,4,6,11,10,87.0,1.75,5.25,0.1875,1.6166666666666665,0.5625,
262,7,2,0,3,7,5,5,12,11,175.0,1.4,2.6,1.8399999999999999,1.2333333333333332,2.03125,
691,1,1,0,0,1,1,1,2,1,0.0,1.0,0.0,0.0,0.0,0.0,
658,1,0,0,1,1,1,1,2,1,0.0,1.0,0.0,0.0,0.0,0.0,
891,1,1,0,2,1,3,1,4,3,31.0,0.3333333333333333,1.0,0.0,0.0,1.5,
522,1,0,0,1,1,1,1,2,1,0.0,1.0,0.0,0.0,0.0,0.0,
534,2,2,0,0,2,2,2,4,3,65.0,1.0,1.5,0.25,0.5,1.0,
242,1,1,0,0,1,1,1,2,1,0.0,1.0,0.0,0.0,0.0,0.0,
512,2,3,0,0,2,3,2,5,4,276.0,0.6666666666666666,1.3333333333333333,0.2222222222222222,0.5,1.5,
468,1,1,0,0,1,1,1,2,1,0.0,1.0,0.0,0.0,0.0,0.0,
907,1,2,0,0,1,2,1,3,2,21.0,0.5,1.0,0.0,0.0,1.0,
428,3,4,0,3,3,7,3,10,9,232.0,0.42857142857142855,2.142857142857143,0.6938775510204082,0.8333333333333333,3.125,
578,1,1,0,0,1,1,1,2,1,0.0,1.0,0.0,0.0,0.0,0.0,
649,1,2,0,0,1,2,1,3,2,7.0,0.5,1.0,0.0,0.0,1.0,
561,4,3,0,0,4,3,4,7,6,162.0,1.3333333333333333,2.3333333333333335,1.5555555555555554,0.9166666666666665,1.25,
127,2,3,1,2,3,5,3,8,7,339.0,0.6,2.2,0.96,0.8333333333333333,2.125,
272,5,2,0,0,5,2,4,7,6,155.0,2.5,3.0,1.0,0.9833333333333334,0.75,
462,1,1,0,0,1,1,1,2,1,0.0,1.0,0.0,0.0,0.0,0.0,
721,1,1,0,0,1,1,1,2,1,0.0,1.0,0.0,0.0,0.0,0.0,
911,1,1,0,0,1,1,1,2,1,0.0,1.0,0.0,0.0,0.0,0.0,
117,1,2,0,0,1,2,1,3,2,10.0,0.5,1.0,0.0,0.0,1.0,
314,1,2,0,0,1,2,1,3,2,7.0,0.5,1.0,0.0,0.0,1.0,
432,1,1,0,2,1,3,1,4,3,74.0,0.3333333333333333,1.0,0.0,0.0,1.5,
851,1,1,0,1,1,2,1,3,2,7.0,0.5,1.0,0.0,0.0,1.0,
838,1,1,0,0,1,1,1,2,1,0.0,1.0,0.0,0.0,0.0,0.0,
142,1,1,0,1,1,2,1,3,2,41.0,0.5,1.0,0.0,0.0,1.0,
411,2,1,0,0,2,1,2,3,2,53.0,2.0,2.0,0.0,1.0,0.5,
409,7,4,0,4,7,8,6,15,14,193.0,0.875,3.625,2.734375,1.1023809523809522,2.59375,
618,2,1,0,1,2,2,2,4,3,87.0,1.0,2.0,0.0,1.0,1.0,
910,1,1,0,0,1,1,1,2,1,0.0,1.0,0.0,0.0,0.0,0.0,
474,1,0,0,1,1,1,1,2,1,0.0,1.0,0.0,0.0,0.0,0.0,
695,0,1,1,0,1,1,1,2,1,0.0,1.0,0.0,0.0,0.0,0.0,
818,1,1,0,0,1,1,1,2,1,0.0,1.0,0.0,0.0,0.0,0.0,
679,3,3,0,1,3,4,3,7,6,126.0,0.75,2.75,0.1875,1.0,1.625,
646,1,1,0,0,1,1,1,2,1,0.0,1.0,0.0,0.0,0.0,0.0,
865,1,0,0,1,1,1,1,2,1,0.0,1.0,0.0,0.0,0.0,0.0,
557,1,1,0,0,1,1,1,2,1,0.0,1.0,0.0,0.0,0.0,0.0,
570,1,1,0,0,1,1,1,2,1,0.0,1.0,0.0,0.0,0.0,0.0,
639,1,1,0,0,1,1,1,2,1,0.0,1.0,0.0,0.0,0.0,0.0,
168,3,2,0,0,3,2,3,5,4,107.0,1.5,2.0,1.0,0.8333333333333333,0.875,
901,3,3,0,0,3,3,3,6,5,156.0,1.0,2.3333333333333335,0.8888888888888888,0.8333333333333333,1.25,
723,1,0,0,1,1,1,1,2,1,0.0,1.0,0.0,0.0,0.0,0.0,
854,7,3,0,1,7,4,6,11,10,207.0,1.75,3.0,3.0,1.1023809523809525,1.59375,
336,1,1,0,0,1,1,1,2,1,0.0,1.0,0.0,0.0,0.0,0.0,
323,1,0,0,1,1,1,1,2,1,0.0,1.0,0.0,0.0,0.0,0.0,
313,1,0,0,1,1,1,1,2,1,0.0,1.0,0.0,0.0,0.0,0.0,
684,1,1,0,0,1,1,1,2,1,0.0,1.0,0.0,0.0,0.0,0.0,
655,1,0,0,1,1,1,1,2,1,0.0,1.0,0.0,0.0,0.0,0.0,
422,2,2,0,0,2,2,2,4,3,159.0,1.0,1.5,0.25,0.5,1.0,
917,1,0,0,1,1,1,1,2,1,0.0,1.0,0.0,0.0,0.0,0.0,
276,7,7,0,6,7,13,5,20,19,288.0,0.5384615384615384,2.8461538461538463,1.207100591715976,1.4833333333333332,5.03125,
584,10,6,0,2,10,8,8,18,17,340.0,1.25,4.25,4.4375,1.4119047619047618,2.0859375,
260,2,1,0,1,2,2,2,4,3,134.0,1.0,1.5,0.25,0.5,1.0,
567,2,0,0,1,2,1,2,3,2,139.0,2.0,2.0,0.0,1.0,0.5,
704,4,2,0,2,4,4,2,8,7,151.0,1.0,1.75,0.1875,1.0,2.0,
188,1,1,0,0,1,1,1,2,1,0.0,1.0,0.0,0.0,0.0,0.0,
22,2,3,0,1,2,4,2,6,5,31.0,0.5,1.75,0.1875,0.5,2.0,
319,4,6,0,0,4,6,4,10,9,170.0,0.6666666666666666,3.0,0.6666666666666666,1.1666666666666665,2.25,
706,1,2,0,0,1,2,1,3,2,31.0,0.5,1.0,0.0,0.0,1.0,
517,1,1,0,0,1,1,1,2,1,0.0,1.0,0.0,0.0,0.0,0.0,
693,1,1,0,0,1,1,1,2,1,0.0,1.0,0.0,0.0,0.0,0.0,
125,2,1,0,0,2,1,2,3,2,28.0,2.0,2.0,0.0,1.0,0.5,
388,2,1,0,1,2,2,2,4,3,15.0,1.0,1.5,0.25,0.5,1.0,
484,1,2,0,1,1,3,1,4,3,36.0,0.3333333333333333,1.0,0.0,0.0,1.5,
529,3,4,0,0,3,4,3,7,6,102.0,0.75,2.0,0.5,0.8333333333333333,1.875,
289,1,1,0,1,1,2,1,3,2,17.0,0.5,1.0,0.0,0.0,1.0,
355,1,1,0,0,1,1,1,2,1,0.0,1.0,0.0,0.0,0.0,0.0,
31,1,1,0,0,1,1,1,2,1,0.0,1.0,0.0,0.0,0.0,0.0,
300,2,1,0,0,2,1,2,3,2,2.0,2.0,2.0,0.0,1.0,0.5,
798,6,4,1,4,7,8,5,15,14,344.0,0.875,3.625,1.734375,1.2,2.46875,
449,2,4,1,0,3,4,3,7,6,164.0,0.75,3.0,0.0,1.5,1.5,
740,1,1,0,1,1,2,1,3,2,69.0,0.5,1.0,0.0,0.0,1.0,
725,2,2,0,0,2,2,2,4,3,67.0,1.0,1.5,0.25,0.5,1.0,
324,6,5,0,1,6,6,4,12,11,253.0,1.0,2.8333333333333335,0.8055555555555555,1.4166666666666665,2.25,
440,1,1,0,0,1,1,1,2,1,0.0,1.0,0.0,0.0,0.0,0.0,
380,3,0,0,2,3,2,3,5,4,99.0,1.5,2.5,0.25,1.0,0.875,
128,1,2,0,0,1,2,1,3,2,19.0,0.5,1.0,0.0,0.0,1.0,
379,10,9,0,3,10,12,5,22,21,244.0,0.8333333333333334,2.5833333333333335,0.9097222222222223,1.569047619047619,5.15625,
