ObID,HRI,HRL,LRI,LRL,Internals,Leaves,Height,Vertices,Size,Duration,RatioIL,MeanBar,StdBar,Beta1,Beta2,
796,2,1,0,0,2,1,2,3,2,67.0,2.0,2.0,0.0,1.0,0.5,
88,2,3,1,0,3,3,3,6,5,47.0,1.0,2.0,0.6666666666666666,0.8333333333333333,1.375,
222,21,18,1,8,22,26,12,48,47,582.0,0.8461538461538461,6.115384615384615,13.025147928994082,1.865279165279165,5.36962890625,
1565,6,1,0,1,6,2,4,8,7,391.0,3.0,4.0,0.0,1.2333333333333332,0.5,
41,0,1,1,0,1,1,1,2,1,0.0,1.0,0.0,0.0,0.0,0.0,
652,1,1,0,0,1,1,1,2,1,0.0,1.0,0.0,0.0,0.0,0.0,
1556,1,0,0,2,1,2,1,3,2,122.0,0.5,1.0,0.0,0.0,1.0,
921,1,2,0,1,1,3,1,4,3,19.0,0.3333333333333333,1.0,0.0,0.0,1.5,
1326,1,1,0,0,1,1,1,2,1,0.0,1.0,0.0,0.0,0.0,0.0,
800,1,0,0,1,1,1,1,2,1,0.0,1.0,0.0,0.0,0.0,0.0,
1538,1,0,0,1,1,1,1,2,1,0.0,1.0,0.0,0.0,0.0,0.0,
1330,3,3,0,0,3,3,3,6,5,74.0,1.0,1.6666666666666667,0.888888888888889,0.8333333333333333,1.375,
1655,1,1,0,0,1,1,1,2,1,0.0,1.0,0.0,0.0,0.0,0.0,
100,8,10,1,3,9,13,6,22,21,423.0,0.6923076923076923,3.3076923076923075,2.21301775147929,1.469047619047619,4.28125,
1387,2,2,0,0,2,2,2,4,3,8.0,1.0,1.5,0.25,0.5,1.0,
190,0,1,1,0,1,1,1,2,1,0.0,1.0,0.0,0.0,0.0,0.0,
953,3,1,0,1,3,2,3,5,4,80.0,1.5,2.5,0.25,1.0,0.875,
1267,2,1,0,0,2,1,2,3,2,20.0,2.0,2.0,0.0,1.0,0.5,
755,1,1,0,0,1,1,1,2,1,0.0,1.0,0.0,0.0,0.0,0.0,
1466,1,1,0,0,1,1,1,2,1,0.0,1.0,0.0,0.0,0.0,0.0,
341,0,2,1,0,1,2,1,3,2,0.0,0.5,1.0,0.0,0.0,1.0,
457,1,1,0,0,1,1,1,2,1,0.0,1.0,0.0,0.0,0.0,0.0,
699,7,4,0,3,7,7,4,14,13,171.0,1.0,3.5714285714285716,0.24489795918367344,1.4333333333333333,2.125,
1028,1,2,0,0,1,2,1,3,2,115.0,0.5,1.0,0.0,0.0,1.0,
531,3,0,0,3,3,3,3,6,5,42.0,1.0,1.6666666666666667,0.888888888888889,0.8333333333333333,1.375,
1268,1,1,0,0,1,1,1,2,1,0.0,1.0,0.0,0.0,0.0,0.0,
716,3,1,0,0,3,1,3,4,3,27.0,3.0,3.0,0.0,1.5,0.375,
1336,1,1,0,0,1,1,1,2,1,0.0,1.0,0.0,0.0,0.0,0.0,
995,1,2,0,0,1,2,1,3,2,142.0,0.5,1.0,0.0,0.0,1.0,
827,1,1,0,0,1,1,1,2,1,0.0,1.0,0.0,0.0,0.0,0.0,
1299,1,1,0,0,1,1,1,2,1,0.0,1.0,0.0,0.0,0.0,0.0,
212,0,2,1,0,1,2,1,3,2,4.0,0.5,1.0,0.0,0.0,1.0,
673,2,4,0,0,2,4,2,6,5,198.0,0.5,1.5,0.25,0.5,2.0,
379,1,0,0,1,1,1,1,2,1,0.0,1.0,0.0,0.0,0.0,0.0,
1076,2,0,0,2,2,2,2,4,3,88.0,1.0,1.5,0.25,0.5,1.0,
622,1,1,0,1,1,2,1,3,2,29.0,0.5,1.0,0.0,0.0,1.0,
1562,1,0,0,1,1,1,1,2,1,0.0,1.0,0.0,0.0,0.0,0.0,
1026,1,2,0,1,1,3,1,4,3,88.0,0.3333333333333333,1.0,0.0,0.0,1.5,
189,4,7,1,1,5,8,4,13,12,139.0,0.625,2.5,1.5,1.1666666666666665,3.125,
1060,12,4,0,6,12,10,8,22,21,243.0,1.2,4.7,4.609999999999999,1.7035714285714285,2.265625,
1177,2,2,0,0,2,2,2,4,3,34.0,1.0,1.5,0.25,0.5,1.0,
629,1,1,0,0,1,1,1,2,1,0.0,1.0,0.0,0.0,0.0,0.0,
964,1,2,0,0,1,2,1,3,2,33.0,0.5,1.0,0.0,0.0,1.0,
1138,1,1,0,0,1,1,1,2,1,0.0,1.0,0.0,0.0,0.0,0.0,
1668,1,1,0,0,1,1,1,2,1,0.0,1.0,0.0,0.0,0.0,0.0,
782,5,5,0,4,5,9,3,14,13,237.0,0.5555555555555556,1.5555555555555556,0.46913580246913583,1.0833333333333333,4.375,
859,1,1,0,0,1,1,1,2,1,0.0,1.0,0.0,0.0,0.0,0.0,
1242,4,8,0,1,4,9,3,13,12,188.0,0.4444444444444444,1.8888888888888888,0.3209876543209877,0.8333333333333333,4.375,
1478,1,0,0,1,1,1,1,2,1,0.0,1.0,0.0,0.0,0.0,0.0,
527,1,1,0,0,1,1,1,2,1,0.0,1.0,0.0,0.0,0.0,0.0,
572,2,2,0,0,2,2,2,4,3,53.0,1.0,1.5,0.25,0.5,1.0,
766,7,3,1,0,8,3,6,11,10,124.0,2.6666666666666665,3.6666666666666665,2.8888888888888893,1.269047619047619,0.96875,
1484,1,1,0,0,1,1,1,2,1,0.0,1.0,0.0,0.0,0.0,0.0,
522,3,1,1,1,4,2,4,6,5,161.0,2.0,2.5,2.25,0.9166666666666666,0.75,
869,1,0,0,1,1,1,1,2,1,0.0,1.0,0.0,0.0,0.0,0.0,
814,1,2,0,0,1,2,1,3,2,0.0,0.5,1.0,0.0,0.0,1.0,
110,3,5,1,1,4,6,3,10,9,95.0,0.6666666666666666,2.6666666666666665,0.2222222222222222,0.8333333333333333,2.5,
1369,1,1,0,0,1,1,1,2,1,0.0,1.0,0.0,0.0,0.0,0.0,
500,1,1,0,0,1,1,1,2,1,0.0,1.0,0.0,0.0,0.0,0.0,
906,4,5,0,1,4,6,4,10,9,200.0,0.6666666666666666,3.3333333333333335,0.2222222222222222,1.3333333333333333,2.0,
1604,2,1,0,0,2,1,2,3,2,22.0,2.0,2.0,0.0,1.0,0.5,
795,2,1,0,0,2,1,2,3,2,19.0,2.0,2.0,0.0,1.0,0.5,
1625,1,1,0,0,1,1,1,2,1,0.0,1.0,0.0,0.0,0.0,0.0,
224,3,2,1,0,4,2,3,6,5,53.0,2.0,2.5,0.25,0.8333333333333333,0.875,
602,3,1,0,0,3,1,3,4,3,190.0,3.0,3.0,0.0,1.5,0.375,
546,1,1,0,0,1,1,1,2,1,0.0,1.0,0.0,0.0,0.0,0.0,
444,1,1,0,0,1,1,1,2,1,0.0,1.0,0.0,0.0,0.0,0.0,
355,1,1,0,0,1,1,1,2,1,0.0,1.0,0.0,0.0,0.0,0.0,
1141,1,2,0,0,1,2,1,3,2,32.0,0.5,1.0,0.0,0.0,1.0,
748,2,0,0,1,2,1,2,3,2,59.0,2.0,2.0,0.0,1.0,0.5,
1560,1,1,0,0,1,1,1,2,1,0.0,1.0,0.0,0.0,0.0,0.0,
1512,8,5,0,1,8,6,7,14,13,303.0,1.3333333333333333,4.333333333333333,2.5555555555555554,1.4333333333333333,1.4921875,
263,5,8,1,1,6,9,4,15,14,348.0,0.6666666666666666,2.3333333333333335,1.1111111111111114,1.4166666666666665,3.75,
204,4,3,1,0,5,3,5,8,7,236.0,1.6666666666666667,4.0,0.6666666666666666,1.4166666666666665,0.78125,
1259,1,1,0,0,1,1,1,2,1,0.0,1.0,0.0,0.0,0.0,0.0,
74,9,11,1,2,10,13,6,23,22,215.0,0.7692307692307693,3.6923076923076925,1.5976331360946743,1.7666666666666666,3.8125,
266,3,2,0,0,3,2,3,5,4,125.0,1.5,3.0,0.0,1.5,0.75,
462,17,8,0,4,17,12,7,29,28,409.0,1.4166666666666667,5.416666666666667,1.743055555555556,2.34484126984127,1.796875,
290,1,0,0,1,1,1,1,2,1,0.0,1.0,0.0,0.0,0.0,0.0,
125,0,2,1,0,1,2,1,3,2,31.0,0.5,1.0,0.0,0.0,1.0,
1364,2,3,1,1,3,4,2,7,6,246.0,0.75,1.5,0.25,0.6666666666666666,2.0,
566,1,0,0,1,1,1,1,2,1,0.0,1.0,0.0,0.0,0.0,0.0,
477,2,1,0,0,2,1,2,3,2,4.0,2.0,2.0,0.0,1.0,0.5,
1605,1,1,0,0,1,1,1,2,1,0.0,1.0,0.0,0.0,0.0,0.0,
676,1,0,1,1,2,1,2,3,2,10.0,2.0,2.0,0.0,1.0,0.5,
1067,1,1,0,0,1,1,1,2,1,0.0,1.0,0.0,0.0,0.0,0.0,
970,1,0,0,1,1,1,1,2,1,0.0,1.0,0.0,0.0,0.0,0.0,
382,1,1,0,0,1,1,1,2,1,0.0,1.0,0.0,0.0,0.0,0.0,
221,0,1,1,0,1,1,1,2,1,0.0,1.0,0.0,0.0,0.0,0.0,
949,1,3,0,0,1,3,1,4,3,99.0,0.3333333333333333,1.0,0.0,0.0,1.5,
1491,1,0,0,2,1,2,1,3,2,9.0,0.5,1.0,0.0,0.0,1.0,
391,1,1,0,0,1,1,1,2,1,0.0,1.0,0.0,0.0,0.0,0.0,
756,1,1,0,0,1,1,1,2,1,0.0,1.0,0.0,0.0,0.0,0.0,
1486,1,1,0,0,1,1,1,2,1,0.0,1.0,0.0,0.0,0.0,0.0,
278,1,2,0,1,1,3,1,4,3,21.0,0.3333333333333333,1.0,0.0,0.0,1.5,
37,1,2,1,1,2,3,2,5,4,95.0,0.6666666666666666,1.6666666666666667,0.2222222222222222,0.5,1.5,
1683,9,3,0,2,9,5,7,14,13,182.0,1.8,5.2,1.7600000000000002,1.4357142857142857,0.8359375,
792,0,1,1,0,1,1,1,2,1,0.0,1.0,0.0,0.0,0.0,0.0,
1640,2,1,0,1,2,2,2,4,3,72.0,1.0,1.5,0.25,0.5,1.0,
313,1,1,0,0,1,1,1,2,1,0.0,1.0,0.0,0.0,0.0,0.0,
1620,1,1,0,0,1,1,1,2,1,0.0,1.0,0.0,0.0,0.0,0.0,
1088,1,1,0,0,1,1,1,2,1,0.0,1.0,0.0,0.0,0.0,0.0,
1053,1,1,0,0,1,1,1,2,1,0.0,1.0,0.0,0.0,0.0,0.0,
1153,1,1,0,0,1,1,1,2,1,0.0,1.0,0.0,0.0,0.0,0.0,
17,13,13,1,1,14,14,8,28,27,268.0,1.0,6.214285714285714,3.7397959183673466,2.0547619047619046,1.609375,
451,1,2,0,0,1,2,1,3,2,22.0,0.5,1.0,0.0,0.0,1.0,
803,1,0,0,1,1,1,1,2,1,0.0,1.0,0.0,0.0,0.0,0.0,
1164,3,2,0,0,3,2,3,5,4,107.0,1.5,2.0,1.0,0.8333333333333333,0.875,
309,1,1,0,0,1,1,1,2,1,0.0,1.0,0.0,0.0,0.0,0.0,
487,7,3,0,0,7,3,7,10,9,365.0,2.3333333333333335,5.666666666666667,1.5555555555555554,1.5333333333333332,0.3984375,
585,2,2,0,1,2,3,2,5,4,67.0,0.6666666666666666,2.0,0.0,1.0,1.5,
595,1,2,0,0,1,2,1,3,2,18.0,0.5,1.0,0.0,0.0,1.0,
659,3,2,0,1,3,3,3,6,5,89.0,1.0,1.6666666666666667,0.888888888888889,0.8333333333333333,1.375,
1411,1,1,0,1,1,2,1,3,2,16.0,0.5,1.0,0.0,0.0,1.0,
1679,2,1,0,1,2,2,2,4,3,17.0,1.0,1.5,0.25,0.5,1.0,
698,1,1,0,0,1,1,1,2,1,0.0,1.0,0.0,0.0,0.0,0.0,
1507,1,1,0,0,1,1,1,2,1,0.0,1.0,0.0,0.0,0.0,0.0,
306,4,3,0,3,4,6,3,10,9,165.0,0.6666666666666666,1.6666666666666667,0.5555555555555556,0.8333333333333333,2.875,
1530,1,1,0,0,1,1,1,2,1,0.0,1.0,0.0,0.0,0.0,0.0,
1455,1,1,0,1,1,2,1,3,2,42.0,0.5,1.0,0.0,0.0,1.0,
1298,4,4,0,1,4,5,4,9,8,260.0,0.8,2.8,0.96,0.9166666666666665,1.875,
625,1,0,0,1,1,1,1,2,1,0.0,1.0,0.0,0.0,0.0,0.0,
381,1,1,0,0,1,1,1,2,1,0.0,1.0,0.0,0.0,0.0,0.0,
856,1,1,0,0,1,1,1,2,1,0.0,1.0,0.0,0.0,0.0,0.0,
491,3,2,0,0,3,2,3,5,4,87.0,1.5,2.0,1.0,0.8333333333333333,0.875,
356,3,0,0,1,3,1,3,4,3,74.0,3.0,3.0,0.0,1.5,0.375,
1174,1,2,0,0,1,2,1,3,2,7.0,0.5,1.0,0.0,0.0,1.0,
917,1,0,0,1,1,1,1,2,1,0.0,1.0,0.0,0.0,0.0,0.0,
406,13,6,1,2,14,8,10,22,21,253.0,1.75,5.875,5.859375,1.5675324675324673,1.314453125,
1101,2,0,0,1,2,1,2,3,2,30.0,2.0,2.0,0.0,1.0,0.5,
1039,1,1,0,0,1,1,1,2,1,0.0,1.0,0.0,0.0,0.0,0.0,
1252,3,1,0,0,3,1,3,4,3,31.0,3.0,3.0,0.0,1.5,0.375,
689,1,2,0,0,1,2,1,3,2,47.0,0.5,1.0,0.0,0.0,1.0,
1222,1,1,0,0,1,1,1,2,1,0.0,1.0,0.0,0.0,0.0,0.0,
1218,1,1,0,0,1,1,1,2,1,0.0,1.0,0.0,0.0,0.0,0.0,
763,4,2,0,1,4,3,4,7,6,235.0,1.3333333333333333,2.0,2.0,0.9166666666666665,1.25,
1399,2,1,0,0,2,1,2,3,2,51.0,2.0,2.0,0.0,1.0,0.5,
1575,2,0,0,2,2,2,2,4,3,46.0,1.0,2.0,0.0,1.0,1.0,
1113,1,1,1,0,2,1,2,3,2,10.0,2.0,2.0,0.0,1.0,0.5,
81,19,16,1,6,20,22,5,42,41,546.0,0.9090909090909091,3.1363636363636362,1.3904958677685952,2.704365079365079,7.875,
891,1,1,0,1,1,2,1,3,2,52.0,0.5,1.0,0.0,0.0,1.0,
1426,1,1,0,0,1,1,1,2,1,0.0,1.0,0.0,0.0,0.0,0.0,
1198,2,2,0,0,2,2,2,4,3,65.0,1.0,2.0,0.0,1.0,1.0,
1106,1,0,0,1,1,1,1,2,1,0.0,1.0,0.0,0.0,0.0,0.0,
997,1,1,0,0,1,1,1,2,1,0.0,1.0,0.0,0.0,0.0,0.0,
1569,2,4,0,0,2,4,2,6,5,192.0,0.5,1.25,0.1875,0.5,2.0,
772,1,3,0,0,1,3,1,4,3,17.0,0.3333333333333333,1.0,0.0,0.0,1.5,
1614,1,0,0,1,1,1,1,2,1,0.0,1.0,0.0,0.0,0.0,0.0,
886,3,1,0,1,3,2,3,5,4,60.0,1.5,3.0,0.0,1.5,0.75,
1492,1,1,0,0,1,1,1,2,1,0.0,1.0,0.0,0.0,0.0,0.0,
1213,1,1,0,0,1,1,1,2,1,0.0,1.0,0.0,0.0,0.0,0.0,
1201,1,1,0,0,1,1,1,2,1,0.0,1.0,0.0,0.0,0.0,0.0,
132,5,6,2,3,7,9,4,16,15,208.0,0.7777777777777778,2.0,0.8888888888888888,1.1833333333333333,4.125,
205,1,4,1,0,2,4,2,6,5,61.0,0.5,1.25,0.1875,0.5,2.0,
745,3,2,0,2,3,4,3,7,6,141.0,0.75,2.5,0.25,1.0,1.75,
191,13,10,1,3,14,13,6,27,26,255.0,1.0769230769230769,3.8461538461538463,0.5917159763313611,1.8686507936507937,3.59375,
831,3,4,0,0,3,4,2,7,6,208.0,0.75,1.5,0.25,0.6666666666666666,2.0,
1430,1,1,0,0,1,1,1,2,1,0.0,1.0,0.0,0.0,0.0,0.0,
605,6,5,0,0,6,5,5,11,10,353.0,1.2,3.2,2.16,1.2833333333333332,1.65625,
1328,2,2,0,1,2,3,2,5,4,238.0,0.6666666666666666,1.3333333333333333,0.2222222222222222,0.5,1.5,
1415,1,0,0,1,1,1,1,2,1,0.0,1.0,0.0,0.0,0.0,0.0,
1161,1,0,0,2,1,2,1,3,2,28.0,0.5,1.0,0.0,0.0,1.0,
249,0,1,1,0,1,1,1,2,1,0.0,1.0,0.0,0.0,0.0,0.0,
91,3,2,1,1,4,3,4,7,6,125.0,1.3333333333333333,2.6666666666666665,1.5555555555555554,0.9166666666666666,1.125,
71,4,5,1,0,5,5,4,10,9,118.0,1.0,2.6,1.0400000000000003,1.1666666666666665,2.0,
614,1,1,0,0,1,1,1,2,1,0.0,1.0,0.0,0.0,0.0,0.0,
775,1,1,0,1,1,2,1,3,2,6.0,0.5,1.0,0.0,0.0,1.0,
1121,2,1,1,0,3,1,3,4,3,224.0,3.0,3.0,0.0,1.5,0.375,
1200,2,1,0,1,2,2,2,4,3,127.0,1.0,2.0,0.0,1.0,1.0,
344,1,1,0,0,1,1,1,2,1,0.0,1.0,0.0,0.0,0.0,0.0,
1125,1,2,0,0,1,2,1,3,2,12.0,0.5,1.0,0.0,0.0,1.0,
557,1,1,0,0,1,1,1,2,1,0.0,1.0,0.0,0.0,0.0,0.0,
1536,1,1,0,0,1,1,1,2,1,0.0,1.0,0.0,0.0,0.0,0.0,
1179,2,1,0,0,2,1,2,3,2,8.0,2.0,2.0,0.0,1.0,0.5,
601,1,2,0,1,1,3,1,4,3,21.0,0.3333333333333333,1.0,0.0,0.0,1.5,
1115,1,1,0,0,1,1,1,2,1,0.0,1.0,0.0,0.0,0.0,0.0,
1616,2,3,0,0,2,3,2,5,4,79.0,0.6666666666666666,1.6666666666666667,0.2222222222222222,0.5,1.5,
721,2,0,0,1,2,1,2,3,2,69.0,2.0,2.0,0.0,1.0,0.5,
1019,1,1,0,0,1,1,1,2,1,0.0,1.0,0.0,0.0,0.0,0.0,
253,1,2,0,0,1,2,1,3,2,8.0,0.5,1.0,0.0,0.0,1.0,
1119,0,0,1,1,1,1,1,2,1,0.0,1.0,0.0,0.0,0.0,0.0,
117,0,1,1,0,1,1,1,2,1,0.0,1.0,0.0,0.0,0.0,0.0,
549,2,3,0,0,2,3,2,5,4,60.0,0.6666666666666666,1.3333333333333333,0.2222222222222222,0.5,1.5,
1436,1,1,0,0,1,1,1,2,1,0.0,1.0,0.0,0.0,0.0,0.0,
401,1,2,0,0,1,2,1,3,2,3.0,0.5,1.0,0.0,0.0,1.0,
1685,2,0,0,1,2,1,2,3,2,36.0,2.0,2.0,0.0,1.0,0.5,
101,12,9,1,4,13,13,7,26,25,269.0,1.0,3.6923076923076925,1.5976331360946747,1.5591269841269841,3.9609375,
941,2,1,0,0,2,1,2,3,2,3.0,2.0,2.0,0.0,1.0,0.5,
1380,2,2,0,0,2,2,2,4,3,17.0,1.0,1.5,0.25,0.5,1.0,
1637,12,6,0,3,12,9,7,21,20,558.0,1.3333333333333333,5.222222222222222,2.617283950617284,1.9357142857142857,1.5703125,
1338,3,3,0,2,3,5,3,8,7,256.0,0.6,2.0,0.4,0.8333333333333333,2.375,
1451,1,0,0,1,1,1,1,2,1,0.0,1.0,0.0,0.0,0.0,0.0,
405,5,2,0,1,5,3,4,8,7,194.0,1.6666666666666667,3.0,0.6666666666666666,1.1666666666666665,1.125,
1443,1,2,0,0,1,2,1,3,2,27.0,0.5,1.0,0.0,0.0,1.0,
348,1,1,0,0,1,1,1,2,1,0.0,1.0,0.0,0.0,0.0,0.0,
398,1,1,0,1,1,2,1,3,2,6.0,0.5,1.0,0.0,0.0,1.0,
1681,1,1,0,0,1,1,1,2,1,0.0,1.0,0.0,0.0,0.0,0.0,
943,1,1,0,0,1,1,1,2,1,0.0,1.0,0.0,0.0,0.0,0.0,
1304,4,4,0,0,4,4,4,8,7,102.0,1.0,2.75,1.6875,0.9166666666666665,1.5,
65,1,1,1,0,2,1,2,3,2,4.0,2.0,2.0,0.0,1.0,0.5,
414,1,3,0,0,1,3,1,4,3,102.0,0.3333333333333333,1.0,0.0,0.0,1.5,
450,5,4,0,0,5,4,4,9,8,214.0,1.25,2.5,2.25,1.1666666666666665,1.5,
812,1,1,0,0,1,1,1,2,1,0.0,1.0,0.0,0.0,0.0,0.0,
758,3,2,0,0,3,2,2,5,4,119.0,1.5,2.0,0.0,0.6666666666666666,1.0,
148,8,5,0,3,8,8,6,16,15,331.0,1.0,4.375,2.484375,1.4333333333333333,1.78125,
102,4,3,2,0,6,3,5,9,8,48.0,2.0,3.6666666666666665,1.5555555555555554,1.0333333333333334,0.90625,
1504,2,4,0,1,2,5,2,7,6,271.0,0.4,1.2,0.16000000000000006,0.5,2.5,
364,3,1,0,0,3,1,3,4,3,52.0,3.0,3.0,0.0,1.5,0.375,
898,2,2,0,0,2,2,2,4,3,5.0,1.0,1.5,0.25,0.5,1.0,
1442,5,5,0,0,5,5,4,10,9,153.0,1.0,3.4,1.44,1.1666666666666665,1.5,
61,3,2,1,2,4,4,3,8,7,112.0,1.0,2.0,0.5,0.8333333333333333,1.875,
1490,1,2,0,0,1,2,1,3,2,23.0,0.5,1.0,0.0,0.0,1.0,
1351,1,2,0,0,1,2,1,3,2,4.0,0.5,1.0,0.0,0.0,1.0,
1672,1,1,0,0,1,1,1,2,1,0.0,1.0,0.0,0.0,0.0,0.0,
276,2,1,0,0,2,1,2,3,2,51.0,2.0,2.0,0.0,1.0,0.5,
1462,9,7,0,4,9,11,6,20,19,703.0,0.8181818181818182,3.909090909090909,1.355371900826446,1.6333333333333333,3.0625,
730,2,1,0,0,2,1,2,3,2,17.0,2.0,2.0,0.0,1.0,0.5,
188,0,3,1,0,1,3,1,4,3,22.0,0.3333333333333333,1.0,0.0,0.0,1.5,
1521,2,2,0,0,2,2,2,4,3,60.0,1.0,2.0,0.0,1.0,1.0,
1541,1,2,0,0,1,2,1,3,2,129.0,0.5,1.0,0.0,0.0,1.0,
821,1,1,0,0,1,1,1,2,1,0.0,1.0,0.0,0.0,0.0,0.0,
1461,10,4,0,2,10,6,7,16,15,377.0,1.6666666666666667,4.666666666666667,2.222222222222222,1.6357142857142857,1.2734375,
216,0,1,1,0,1,1,1,2,1,0.0,1.0,0.0,0.0,0.0,0.0,
1056,1,1,0,0,1,1,1,2,1,0.0,1.0,0.0,0.0,0.0,0.0,
410,2,1,0,0,2,1,2,3,2,50.0,2.0,2.0,0.0,1.0,0.5,
236,6,3,0,0,6,3,5,9,8,273.0,2.0,4.666666666666667,0.22222222222222224,1.7499999999999998,0.5625,
73,0,1,1,0,1,1,1,2,1,0.0,1.0,0.0,0.0,0.0,0.0,
1693,1,1,0,0,1,1,1,2,1,0.0,1.0,0.0,0.0,0.0,0.0,
1207,3,6,0,1,3,7,3,10,9,161.0,0.42857142857142855,1.5714285714285714,0.5306122448979591,0.8333333333333333,3.375,
260,1,1,0,1,1,2,1,3,2,36.0,0.5,1.0,0.0,0.0,1.0,
1224,1,3,0,0,1,3,1,4,3,44.0,0.3333333333333333,1.0,0.0,0.0,1.5,
1193,1,2,0,0,1,2,1,3,2,39.0,0.5,1.0,0.0,0.0,1.0,
1665,1,0,0,1,1,1,1,2,1,0.0,1.0,0.0,0.0,0.0,0.0,
8,2,4,1,0,3,4,3,7,6,49.0,0.75,2.25,0.6875,0.8333333333333333,1.75,
130,31,32,1,10,32,42,8,74,73,531.0,0.7619047619047619,4.119047619047619,2.0096371882086164,3.479906204906205,10.875,
151,0,1,1,0,1,1,1,2,1,0.0,1.0,0.0,0.0,0.0,0.0,
1258,1,1,0,2,1,3,1,4,3,11.0,0.3333333333333333,1.0,0.0,0.0,1.5,
43,10,9,1,3,11,12,7,23,22,463.0,0.9166666666666666,3.8333333333333335,2.138888888888889,1.457936507936508,3.5234375,
578,3,4,0,0,3,4,2,7,6,115.0,0.75,1.5,0.25,0.6666666666666666,2.0,
312,1,1,0,0,1,1,1,2,1,0.0,1.0,0.0,0.0,0.0,0.0,
534,2,1,0,1,2,2,2,4,3,66.0,1.0,1.5,0.25,0.5,1.0,
1173,1,1,0,0,1,1,1,2,1,0.0,1.0,0.0,0.0,0.0,0.0,
1217,1,2,0,0,1,2,1,3,2,21.0,0.5,1.0,0.0,0.0,1.0,
920,1,1,0,1,1,2,1,3,2,82.0,0.5,1.0,0.0,0.0,1.0,
461,1,1,0,0,1,1,1,2,1,0.0,1.0,0.0,0.0,0.0,0.0,
691,1,2,0,0,1,2,1,3,2,62.0,0.5,1.0,0.0,0.0,1.0,
1513,1,1,0,0,1,1,1,2,1,0.0,1.0,0.0,0.0,0.0,0.0,
769,1,1,0,0,1,1,1,2,1,0.0,1.0,0.0,0.0,0.0,0.0,
865,1,0,0,1,1,1,1,2,1,0.0,1.0,0.0,0.0,0.0,0.0,
749,2,3,0,0,2,3,2,5,4,48.0,0.6666666666666666,1.3333333333333333,0.2222222222222222,0.5,1.5,
159,0,1,1,0,1,1,1,2,1,0.0,1.0,0.0,0.0,0.0,0.0,
872,1,0,0,1,1,1,1,2,1,0.0,1.0,0.0,0.0,0.0,0.0,
165,1,1,1,1,2,2,2,4,3,30.0,1.0,1.5,0.25,0.5,1.0,
1485,1,1,1,0,2,1,2,3,2,83.0,2.0,2.0,0.0,1.0,0.5,
720,1,1,0,0,1,1,1,2,1,0.0,1.0,0.0,0.0,0.0,0.0,
846,2,1,0,0,2,1,2,3,2,96.0,2.0,2.0,0.0,1.0,0.5,
199,37,35,3,13,40,48,9,88,87,691.0,0.8333333333333334,5.5,3.6666666666666665,4.004434454434454,7.791015625,
209,1,1,1,0,2,1,2,3,2,32.0,2.0,2.0,0.0,1.0,0.5,
98,4,4,2,0,6,4,5,10,9,226.0,1.5,4.5,0.25,1.4166666666666665,0.8125,
329,1,1,1,0,2,1,2,3,2,165.0,2.0,2.0,0.0,1.0,0.5,
471,1,3,0,0,1,3,1,4,3,34.0,0.3333333333333333,1.0,0.0,0.0,1.5,
1635,1,1,0,0,1,1,1,2,1,0.0,1.0,0.0,0.0,0.0,0.0,
1008,4,3,0,1,4,4,4,8,7,268.0,1.0,2.5,1.25,0.9166666666666666,1.625,
1139,3,2,0,0,3,2,3,5,4,36.0,1.5,2.5,0.25,1.0,0.875,
283,2,1,0,0,2,1,2,3,2,11.0,2.0,2.0,0.0,1.0,0.5,
643,1,0,0,1,1,1,1,2,1,0.0,1.0,0.0,0.0,0.0,0.0,
1432,1,1,0,0,1,1,1,2,1,0.0,1.0,0.0,0.0,0.0,0.0,
1095,3,2,1,1,4,3,4,7,6,137.0,1.3333333333333333,2.6666666666666665,1.5555555555555554,0.9166666666666665,1.125,
1412,1,1,0,0,1,1,1,2,1,0.0,1.0,0.0,0.0,0.0,0.0,
420,0,1,1,0,1,1,1,2,1,0.0,1.0,0.0,0.0,0.0,0.0,
514,7,7,0,1,7,8,6,15,14,447.0,0.875,3.125,4.109375,1.1023809523809525,2.6875,
646,2,3,0,2,2,5,2,7,6,80.0,0.4,2.0,0.0,1.0,2.5,
1007,3,2,0,1,3,3,2,6,5,107.0,1.0,2.0,0.0,0.6666666666666666,1.5,
250,1,1,0,0,1,1,1,2,1,0.0,1.0,0.0,0.0,0.0,0.0,
512,1,1,0,0,1,1,1,2,1,0.0,1.0,0.0,0.0,0.0,0.0,
1133,3,1,0,2,3,3,3,6,5,216.0,1.0,2.3333333333333335,0.8888888888888888,0.8333333333333333,1.25,
713,1,0,0,1,1,1,1,2,1,0.0,1.0,0.0,0.0,0.0,0.0,
1514,2,2,0,0,2,2,2,4,3,13.0,1.0,2.0,0.0,1.0,1.0,
862,4,2,0,0,4,2,4,6,5,177.0,2.0,3.5,0.25,1.3333333333333333,0.625,
968,1,2,0,0,1,2,1,3,2,9.0,0.5,1.0,0.0,0.0,1.0,
686,2,1,0,0,2,1,2,3,2,1.0,2.0,2.0,0.0,1.0,0.5,
840,1,2,0,0,1,2,1,3,2,56.0,0.5,1.0,0.0,0.0,1.0,
1378,1,1,0,0,1,1,1,2,1,0.0,1.0,0.0,0.0,0.0,0.0,
1277,8,13,0,2,8,15,6,23,22,362.0,0.5333333333333333,3.3333333333333335,1.5555555555555551,1.4666666666666668,5.0,
108,1,2,1,1,2,3,2,5,4,98.0,0.6666666666666666,1.6666666666666667,0.2222222222222222,0.5,1.5,
504,1,2,0,1,1,3,1,4,3,84.0,0.3333333333333333,1.0,0.0,0.0,1.5,
732,1,2,0,0,1,2,1,3,2,18.0,0.5,1.0,0.0,0.0,1.0,
403,1,0,0,2,1,2,1,3,2,37.0,0.5,1.0,0.0,0.0,1.0,
1001,4,3,0,0,4,3,3,7,6,225.0,1.3333333333333333,2.3333333333333335,0.22222222222222224,0.8333333333333333,1.375,
1044,7,2,0,3,7,5,6,12,11,298.0,1.4,4.0,2.8,1.1023809523809522,1.40625,
1631,0,1,1,0,1,1,1,2,1,0.0,1.0,0.0,0.0,0.0,0.0,
515,2,1,0,0,2,1,2,3,2,8.0,2.0,2.0,0.0,1.0,0.5,
790,1,0,0,1,1,1,1,2,1,0.0,1.0,0.0,0.0,0.0,0.0,
1322,4,3,0,1,4,4,4,8,7,81.0,1.0,2.0,1.5,0.9166666666666666,1.75,
892,3,5,0,0,3,5,3,8,7,199.0,0.6,1.6,0.64,0.8333333333333333,2.375,
506,1,0,0,1,1,1,1,2,1,0.0,1.0,0.0,0.0,0.0,0.0,
412,1,0,0,1,1,1,1,2,1,0.0,1.0,0.0,0.0,0.0,0.0,
1597,1,1,0,0,1,1,1,2,1,0.0,1.0,0.0,0.0,0.0,0.0,
1097,1,1,0,0,1,1,1,2,1,0.0,1.0,0.0,0.0,0.0,0.0,
1472,3,1,0,1,3,2,3,5,4,120.0,1.5,3.0,0.0,1.5,0.75,
947,2,2,0,0,2,2,2,4,3,59.0,1.0,2.0,0.0,1.0,1.0,
449,1,1,0,0,1,1,1,2,1,0.0,1.0,0.0,0.0,0.0,0.0,
553,4,3,0,1,4,4,4,8,7,85.0,1.0,2.5,1.25,0.9166666666666665,1.625,
19,1,3,1,0,2,3,2,5,4,95.0,0.6666666666666666,1.3333333333333333,0.2222222222222222,0.5,1.5,
739,1,1,0,0,1,1,1,2,1,0.0,1.0,0.0,0.0,0.0,0.0,
223,0,0,1,1,1,1,1,2,1,0.0,1.0,0.0,0.0,0.0,0.0,
1036,1,1,0,0,1,1,1,2,1,0.0,1.0,0.0,0.0,0.0,0.0,
597,2,1,0,0,2,1,2,3,2,8.0,2.0,2.0,0.0,1.0,0.5,
674,2,1,0,0,2,1,2,3,2,2.0,2.0,2.0,0.0,1.0,0.5,
479,2,1,0,2,2,3,2,5,4,196.0,0.6666666666666666,1.3333333333333333,0.2222222222222222,0.5,1.5,
647,1,1,0,0,1,1,1,2,1,0.0,1.0,0.0,0.0,0.0,0.0,
679,2,2,0,0,2,2,2,4,3,14.0,1.0,1.5,0.25,0.5,1.0,
677,1,1,0,0,1,1,1,2,1,0.0,1.0,0.0,0.0,0.0,0.0,
1143,1,0,0,1,1,1,1,2,1,0.0,1.0,0.0,0.0,0.0,0.0,
395,2,1,0,0,2,1,2,3,2,65.0,2.0,2.0,0.0,1.0,0.5,
1678,1,1,0,0,1,1,1,2,1,0.0,1.0,0.0,0.0,0.0,0.0,
710,1,2,0,1,1,3,1,4,3,76.0,0.3333333333333333,1.0,0.0,0.0,1.5,
198,3,4,1,0,4,4,3,8,7,109.0,1.0,1.75,0.6875,0.8333333333333333,1.875,
568,1,1,0,0,1,1,1,2,1,0.0,1.0,0.0,0.0,0.0,0.0,
242,0,2,1,0,1,2,1,3,2,32.0,0.5,1.0,0.0,0.0,1.0,
374,5,5,0,3,5,8,5,13,12,375.0,0.625,2.5,2.0,1.0333333333333332,3.15625,
0,4,8,1,0,5,8,5,13,12,178.0,0.625,3.75,1.4375,1.1666666666666665,2.34375,
912,1,0,0,1,1,1,1,2,1,0.0,1.0,0.0,0.0,0.0,0.0,
277,1,1,0,0,1,1,1,2,1,0.0,1.0,0.0,0.0,0.0,0.0,
820,1,0,0,1,1,1,1,2,1,0.0,1.0,0.0,0.0,0.0,0.0,
147,1,2,1,0,2,2,2,4,3,16.0,1.0,1.5,0.25,0.5,1.0,
1032,1,1,0,0,1,1,1,2,1,0.0,1.0,0.0,0.0,0.0,0.0,
316,2,4,0,0,2,4,2,6,5,181.0,0.5,1.25,0.1875,0.5,2.0,
26,2,2,1,0,3,2,3,5,4,42.0,1.5,2.0,1.0,0.8333333333333333,0.875,
453,1,1,0,0,1,1,1,2,1,0.0,1.0,0.0,0.0,0.0,0.0,
939,1,1,0,0,1,1,1,2,1,0.0,1.0,0.0,0.0,0.0,0.0,
867,2,2,0,0,2,2,2,4,3,58.0,1.0,2.0,0.0,1.0,1.0,
913,1,1,0,0,1,1,1,2,1,0.0,1.0,0.0,0.0,0.0,0.0,
1034,1,2,0,0,1,2,1,3,2,18.0,0.5,1.0,0.0,0.0,1.0,
1549,1,1,0,0,1,1,1,2,1,0.0,1.0,0.0,0.0,0.0,0.0,
1098,1,1,0,0,1,1,1,2,1,0.0,1.0,0.0,0.0,0.0,0.0,
1397,3,1,0,1,3,2,3,5,4,307.0,1.5,3.0,0.0,1.5,0.75,
1593,1,2,0,0,1,2,1,3,2,0.0,0.5,1.0,0.0,0.0,1.0,
660,8,2,0,2,8,4,6,12,11,168.0,2.0,5.0,1.5,1.4333333333333336,0.71875,
589,6,3,0,2,6,5,6,11,10,174.0,1.2,2.8,2.9600000000000004,1.0666666666666667,1.96875,
1656,1,2,0,0,1,2,1,3,2,139.0,0.5,1.0,0.0,0.0,1.0,
14,4,3,1,0,5,3,5,8,7,168.0,1.6666666666666667,2.6666666666666665,2.8888888888888893,1.0333333333333332,1.15625,
752,1,1,0,0,1,1,1,2,1,0.0,1.0,0.0,0.0,0.0,0.0,
360,5,4,0,0,5,4,5,9,8,272.0,1.25,3.5,2.25,1.0333333333333332,1.15625,
215,0,0,1,1,1,1,1,2,1,0.0,1.0,0.0,0.0,0.0,0.0,
436,1,2,0,0,1,2,1,3,2,118.0,0.5,1.0,0.0,0.0,1.0,
992,2,3,0,2,2,5,2,7,6,124.0,0.4,1.4,0.24,0.5,2.5,
722,1,0,1,1,2,1,2,3,2,11.0,2.0,2.0,0.0,1.0,0.5,
1632,1,0,0,1,1,1,1,2,1,0.0,1.0,0.0,0.0,0.0,0.0,
815,2,0,0,1,2,1,2,3,2,4.0,2.0,2.0,0.0,1.0,0.5,
291,1,2,0,0,1,2,1,3,2,11.0,0.5,1.0,0.0,0.0,1.0,
961,1,1,0,0,1,1,1,2,1,0.0,1.0,0.0,0.0,0.0,0.0,
641,2,3,0,1,2,4,2,6,5,99.0,0.5,1.5,0.25,0.5,2.0,
540,5,4,0,3,5,7,5,12,11,237.0,0.7142857142857143,2.5714285714285716,1.959183673469388,1.0333333333333332,2.78125,
987,1,1,0,0,1,1,1,2,1,0.0,1.0,0.0,0.0,0.0,0.0,
1594,1,1,0,0,1,1,1,2,1,0.0,1.0,0.0,0.0,0.0,0.0,
402,1,1,0,0,1,1,1,2,1,0.0,1.0,0.0,0.0,0.0,0.0,
1357,1,1,0,1,1,2,1,3,2,78.0,0.5,1.0,0.0,0.0,1.0,
1574,2,1,0,0,2,1,2,3,2,20.0,2.0,2.0,0.0,1.0,0.5,
873,3,3,0,1,3,4,3,7,6,116.0,0.75,2.5,0.25,1.0,1.75,
459,1,1,0,0,1,1,1,2,1,0.0,1.0,0.0,0.0,0.0,0.0,
1516,2,2,0,0,2,2,2,4,3,43.0,1.0,1.5,0.25,0.5,1.0,
937,5,0,0,3,5,3,5,8,7,135.0,1.6666666666666667,3.3333333333333335,1.5555555555555554,1.1666666666666665,1.03125,
1673,1,1,0,0,1,1,1,2,1,0.0,1.0,0.0,0.0,0.0,0.0,
411,6,5,0,2,6,7,4,13,12,372.0,0.8571428571428571,2.7142857142857144,1.0612244897959184,1.2333333333333332,2.75,
1041,6,5,0,1,6,6,5,12,11,231.0,1.0,3.5,1.5833333333333333,1.2833333333333332,1.78125,
974,1,1,0,0,1,1,1,2,1,0.0,1.0,0.0,0.0,0.0,0.0,
1588,1,2,0,0,1,2,1,3,2,6.0,0.5,1.0,0.0,0.0,1.0,
787,1,1,0,0,1,1,1,2,1,0.0,1.0,0.0,0.0,0.0,0.0,
648,2,3,0,1,2,4,2,6,5,219.0,0.5,1.25,0.1875,0.5,2.0,
1409,3,1,0,0,3,1,3,4,3,134.0,3.0,3.0,0.0,1.5,0.375,
1691,3,3,0,0,3,3,3,6,5,78.0,1.0,1.6666666666666667,0.888888888888889,0.8333333333333333,1.375,
1149,7,6,0,1,7,7,6,14,13,405.0,1.0,5.285714285714286,3.061224489795918,1.2333333333333334,1.0625,
688,1,2,0,0,1,2,1,3,2,6.0,0.5,1.0,0.0,0.0,1.0,
1658,2,0,0,1,2,1,2,3,2,28.0,2.0,2.0,0.0,1.0,0.5,
1690,1,1,0,0,1,1,1,2,1,0.0,1.0,0.0,0.0,0.0,0.0,
367,12,11,0,5,12,16,7,28,27,342.0,0.75,4.5,2.625,2.0023809523809524,3.5859375,
1046,1,1,0,0,1,1,1,2,1,0.0,1.0,0.0,0.0,0.0,0.0,
825,1,0,0,1,1,1,1,2,1,0.0,1.0,0.0,0.0,0.0,0.0,
422,1,1,1,0,2,1,2,3,2,7.0,2.0,2.0,0.0,1.0,0.5,
378,1,1,0,0,1,1,1,2,1,0.0,1.0,0.0,0.0,0.0,0.0,
1368,2,1,0,0,2,1,2,3,2,6.0,2.0,2.0,0.0,1.0,0.5,
1261,1,0,0,1,1,1,1,2,1,0.0,1.0,0.0,0.0,0.0,0.0,
288,1,0,0,1,1,1,1,2,1,0.0,1.0,0.0,0.0,0.0,0.0,
690,1,1,0,0,1,1,1,2,1,0.0,1.0,0.0,0.0,0.0,0.0,
1592,1,1,0,0,1,1,1,2,1,0.0,1.0,0.0,0.0,0.0,0.0,
1148,8,7,0,0,8,7,5,15,14,183.0,1.1428571428571428,3.2857142857142856,1.6326530612244898,1.4333333333333331,2.28125,
1595,1,1,0,0,1,1,1,2,1,0.0,1.0,0.0,0.0,0.0,0.0,
969,2,0,0,1,2,1,2,3,2,40.0,2.0,2.0,0.0,1.0,0.5,
5,17,19,2,5,19,24,7,43,42,608.0,0.7916666666666666,4.333333333333333,2.2222222222222228,2.3666666666666667,5.7734375,
883,1,1,0,0,1,1,1,2,1,0.0,1.0,0.0,0.0,0.0,0.0,
661,1,1,0,0,1,1,1,2,1,0.0,1.0,0.0,0.0,0.0,0.0,
186,6,9,1,2,7,11,5,18,17,229.0,0.6363636363636364,3.1818181818181817,2.6942148760330578,1.2,3.625,
446,1,1,0,0,1,1,1,2,1,0.0,1.0,0.0,0.0,0.0,0.0,
1111,2,1,0,0,2,1,2,3,2,10.0,2.0,2.0,0.0,1.0,0.5,
853,1,1,0,0,1,1,1,2,1,0.0,1.0,0.0,0.0,0.0,0.0,
1009,1,1,0,0,1,1,1,2,1,0.0,1.0,0.0,0.0,0.0,0.0,
1168,1,1,0,0,1,1,1,2,1,0.0,1.0,0.0,0.0,0.0,0.0,
1546,1,1,0,0,1,1,1,2,1,0.0,1.0,0.0,0.0,0.0,0.0,
1175,1,0,0,1,1,1,1,2,1,0.0,1.0,0.0,0.0,0.0,0.0,
470,1,1,0,0,1,1,1,2,1,0.0,1.0,0.0,0.0,0.0,0.0,
206,0,1,1,0,1,1,1,2,1,0.0,1.0,0.0,0.0,0.0,0.0,
1664,1,3,0,0,1,3,1,4,3,101.0,0.3333333333333333,1.0,0.0,0.0,1.5,
298,1,2,0,0,1,2,1,3,2,4.0,0.5,1.0,0.0,0.0,1.0,
569,1,1,0,0,1,1,1,2,1,0.0,1.0,0.0,0.0,0.0,0.0,
1381,4,12,0,1,4,13,3,17,16,398.0,0.3076923076923077,1.3076923076923077,0.3668639053254438,0.8333333333333333,6.375,
38,9,9,1,7,10,16,4,26,25,186.0,0.625,2.5,0.5,1.7166666666666668,6.875,
372,1,1,0,0,1,1,1,2,1,0.0,1.0,0.0,0.0,0.0,0.0,
478,1,1,0,0,1,1,1,2,1,0.0,1.0,0.0,0.0,0.0,0.0,
881,1,2,0,0,1,2,1,3,2,95.0,0.5,1.0,0.0,0.0,1.0,
1661,1,1,0,0,1,1,1,2,1,0.0,1.0,0.0,0.0,0.0,0.0,
1531,4,6,0,3,4,9,4,13,12,223.0,0.4444444444444444,2.3333333333333335,1.3333333333333333,0.9166666666666665,3.75,
567,5,2,0,0,5,2,4,7,6,104.0,2.5,4.0,0.0,1.4999999999999998,0.5,
1421,1,3,0,0,1,3,1,4,3,40.0,0.3333333333333333,1.0,0.0,0.0,1.5,
1311,1,1,0,0,1,1,1,2,1,0.0,1.0,0.0,0.0,0.0,0.0,
705,1,1,0,1,1,2,1,3,2,134.0,0.5,1.0,0.0,0.0,1.0,
62,11,13,1,6,12,19,10,31,30,617.0,0.631578947368421,4.421052631578948,12.454293628808864,1.4023809523809525,5.515625,
294,1,1,0,0,1,1,1,2,1,0.0,1.0,0.0,0.0,0.0,0.0,
1385,1,1,0,0,1,1,1,2,1,0.0,1.0,0.0,0.0,0.0,0.0,
413,2,2,0,1,2,3,2,5,4,159.0,0.6666666666666666,1.6666666666666667,0.2222222222222222,0.5,1.5,
539,1,0,0,1,1,1,1,2,1,0.0,1.0,0.0,0.0,0.0,0.0,
1102,1,1,0,0,1,1,1,2,1,0.0,1.0,0.0,0.0,0.0,0.0,
1162,1,2,0,0,1,2,1,3,2,40.0,0.5,1.0,0.0,0.0,1.0,
1172,1,2,0,0,1,2,1,3,2,24.0,0.5,1.0,0.0,0.0,1.0,
233,6,5,1,1,7,6,6,13,12,134.0,1.1666666666666667,2.6666666666666665,3.222222222222222,1.1023809523809525,2.34375,
1118,2,0,0,1,2,1,2,3,2,35.0,2.0,2.0,0.0,1.0,0.5,
445,1,1,0,0,1,1,1,2,1,0.0,1.0,0.0,0.0,0.0,0.0,
644,1,1,0,0,1,1,1,2,1,0.0,1.0,0.0,0.0,0.0,0.0,
86,0,1,1,0,1,1,1,2,1,0.0,1.0,0.0,0.0,0.0,0.0,
113,0,1,1,0,1,1,1,2,1,0.0,1.0,0.0,0.0,0.0,0.0,
975,1,1,0,0,1,1,1,2,1,0.0,1.0,0.0,0.0,0.0,0.0,
608,4,7,0,1,4,8,4,12,11,284.0,0.5,2.875,0.359375,1.1666666666666665,3.125,
1519,1,1,0,1,1,2,1,3,2,18.0,0.5,1.0,0.0,0.0,1.0,
611,2,1,0,0,2,1,2,3,2,8.0,2.0,2.0,0.0,1.0,0.5,
321,5,3,0,2,5,5,4,10,9,258.0,1.0,2.6,1.44,0.9833333333333332,2.0,
1043,2,1,0,0,2,1,2,3,2,43.0,2.0,2.0,0.0,1.0,0.5,
884,8,6,0,2,8,8,5,16,15,187.0,1.0,3.125,2.359375,1.2119047619047618,2.6875,
642,2,2,0,1,2,3,2,5,4,49.0,0.6666666666666666,1.3333333333333333,0.2222222222222222,0.5,1.5,
1374,2,1,0,0,2,1,2,3,2,67.0,2.0,2.0,0.0,1.0,0.5,
1184,2,2,0,0,2,2,2,4,3,40.0,1.0,1.5,0.25,0.5,1.0,
78,0,1,1,0,1,1,1,2,1,0.0,1.0,0.0,0.0,0.0,0.0,
1025,2,2,0,0,2,2,2,4,3,31.0,1.0,1.5,0.25,0.5,1.0,
437,1,0,0,1,1,1,1,2,1,0.0,1.0,0.0,0.0,0.0,0.0,
1587,1,0,0,2,1,2,1,3,2,13.0,0.5,1.0,0.0,0.0,1.0,
704,1,1,1,1,2,2,2,4,3,90.0,1.0,2.0,0.0,1.0,1.0,
10,3,1,1,3,4,4,4,8,7,92.0,1.0,2.75,0.6875,1.1666666666666665,1.625,
89,0,1,1,0,1,1,1,2,1,0.0,1.0,0.0,0.0,0.0,0.0,
211,1,2,1,1,2,3,2,5,4,23.0,0.6666666666666666,1.3333333333333333,0.2222222222222222,0.5,1.5,
275,2,2,0,0,2,2,2,4,3,157.0,1.0,1.5,0.25,0.5,1.0,
774,2,1,0,0,2,1,2,3,2,19.0,2.0,2.0,0.0,1.0,0.5,
564,2,1,0,0,2,1,2,3,2,29.0,2.0,2.0,0.0,1.0,0.5,
1479,1,1,0,0,1,1,1,2,1,0.0,1.0,0.0,0.0,0.0,0.0,
1159,1,1,0,0,1,1,1,2,1,0.0,1.0,0.0,0.0,0.0,0.0,
919,1,2,0,1,1,3,1,4,3,50.0,0.3333333333333333,1.0,0.0,0.0,1.5,
1342,2,0,0,1,2,1,2,3,2,94.0,2.0,2.0,0.0,1.0,0.5,
663,1,0,0,1,1,1,1,2,1,0.0,1.0,0.0,0.0,0.0,0.0,
784,1,0,0,1,1,1,1,2,1,0.0,1.0,0.0,0.0,0.0,0.0,
1349,1,2,0,0,1,2,1,3,2,0.0,0.5,1.0,0.0,0.0,1.0,
654,4,1,0,1,4,2,4,6,5,238.0,2.0,3.5,0.25,1.3333333333333333,0.625,
554,3,1,0,1,3,2,3,5,4,125.0,1.5,2.0,1.0,0.8333333333333333,0.875,
1233,1,2,0,0,1,2,1,3,2,15.0,0.5,1.0,0.0,0.0,1.0,
1085,2,1,0,2,2,3,2,5,4,149.0,0.6666666666666666,2.0,0.0,1.0,1.5,
521,1,1,0,0,1,1,1,2,1,0.0,1.0,0.0,0.0,0.0,0.0,
1578,1,1,0,0,1,1,1,2,1,0.0,1.0,0.0,0.0,0.0,0.0,
1543,2,3,0,0,2,3,2,5,4,72.0,0.6666666666666666,1.6666666666666667,0.2222222222222222,0.5,1.5,
1144,2,1,0,0,2,1,2,3,2,27.0,2.0,2.0,0.0,1.0,0.5,
1610,1,1,0,0,1,1,1,2,1,0.0,1.0,0.0,0.0,0.0,0.0,
1308,2,1,0,1,2,2,2,4,3,63.0,1.0,1.5,0.25,0.5,1.0,
1006,1,1,0,0,1,1,1,2,1,0.0,1.0,0.0,0.0,0.0,0.0,
750,4,1,0,1,4,2,4,6,5,35.0,2.0,3.0,1.0,1.1666666666666665,0.75,
1320,1,1,0,0,1,1,1,2,1,0.0,1.0,0.0,0.0,0.0,0.0,
307,1,0,0,1,1,1,1,2,1,0.0,1.0,0.0,0.0,0.0,0.0,
262,2,2,0,0,2,2,2,4,3,20.0,1.0,2.0,0.0,1.0,1.0,
452,1,2,0,0,1,2,1,3,2,26.0,0.5,1.0,0.0,0.0,1.0,
149,0,1,1,0,1,1,1,2,1,0.0,1.0,0.0,0.0,0.0,0.0,
599,1,2,0,2,1,4,1,5,4,80.0,0.25,1.0,0.0,0.0,2.0,
1584,1,2,0,0,1,2,1,3,2,76.0,0.5,1.0,0.0,0.0,1.0,
347,2,2,0,0,2,2,2,4,3,46.0,1.0,1.5,0.25,0.5,1.0,
1205,2,0,0,2,2,2,2,4,3,13.0,1.0,1.5,0.25,0.5,1.0,
1334,5,3,0,0,5,3,4,8,7,124.0,1.6666666666666667,3.3333333333333335,0.22222222222222224,1.1666666666666665,1.0,
1262,1,1,0,0,1,1,1,2,1,0.0,1.0,0.0,0.0,0.0,0.0,
123,3,2,1,1,4,3,3,7,6,94.0,1.3333333333333333,2.6666666666666665,0.22222222222222224,1.1666666666666665,1.25,
924,1,0,0,1,1,1,1,2,1,0.0,1.0,0.0,0.0,0.0,0.0,
243,1,0,1,1,2,1,2,3,2,12.0,2.0,2.0,0.0,1.0,0.5,
1246,2,2,0,0,2,2,2,4,3,26.0,1.0,1.5,0.25,0.5,1.0,
1310,3,6,0,0,3,6,3,9,8,157.0,0.5,1.6666666666666667,0.5555555555555557,0.8333333333333333,2.875,
474,2,0,0,1,2,1,2,3,2,78.0,2.0,2.0,0.0,1.0,0.5,
1404,1,1,0,0,1,1,1,2,1,0.0,1.0,0.0,0.0,0.0,0.0,
1585,1,1,0,0,1,1,1,2,1,0.0,1.0,0.0,0.0,0.0,0.0,
22,2,1,1,1,3,2,3,5,4,34.0,1.5,3.0,0.0,1.5,0.75,
1591,2,1,0,0,2,1,2,3,2,80.0,2.0,2.0,0.0,1.0,0.5,
823,3,3,0,0,3,3,3,6,5,340.0,1.0,2.3333333333333335,0.8888888888888888,0.8333333333333333,1.25,
1689,1,3,0,0,1,3,1,4,3,206.0,0.3333333333333333,1.0,0.0,0.0,1.5,
1296,2,1,0,1,2,2,2,4,3,98.0,1.0,1.5,0.25,0.5,1.0,
58,0,1,1,0,1,1,1,2,1,0.0,1.0,0.0,0.0,0.0,0.0,
1132,1,2,0,0,1,2,1,3,2,3.0,0.5,1.0,0.0,0.0,1.0,
915,2,2,0,1,2,3,2,5,4,63.0,0.6666666666666666,1.3333333333333333,0.2222222222222222,0.5,1.5,
826,1,1,0,0,1,1,1,2,1,0.0,1.0,0.0,0.0,0.0,0.0,
1618,1,2,0,1,1,3,1,4,3,6.0,0.3333333333333333,1.0,0.0,0.0,1.5,
1692,2,2,0,1,2,3,2,5,4,86.0,0.6666666666666666,2.0,0.0,1.0,1.5,
377,1,1,0,0,1,1,1,2,1,0.0,1.0,0.0,0.0,0.0,0.0,
1061,1,1,0,0,1,1,1,2,1,0.0,1.0,0.0,0.0,0.0,0.0,
733,1,0,0,2,1,2,1,3,2,107.0,0.5,1.0,0.0,0.0,1.0,
1534,5,1,0,1,5,2,4,7,6,209.0,2.5,3.0,1.0,0.9833333333333334,0.75,
797,3,1,0,0,3,1,3,4,3,65.0,3.0,3.0,0.0,1.5,0.375,
1071,2,2,0,1,2,3,2,5,4,35.0,0.6666666666666666,1.6666666666666667,0.2222222222222222,0.5,1.5,
1166,6,7,0,2,6,9,4,15,14,232.0,0.6666666666666666,2.5555555555555554,1.1358024691358024,1.1833333333333333,3.75,
473,3,2,0,0,3,2,3,5,4,63.0,1.5,2.0,1.0,0.8333333333333333,0.875,
442,1,1,0,0,1,1,1,2,1,0.0,1.0,0.0,0.0,0.0,0.0,
465,5,2,0,1,5,3,4,8,7,110.0,1.6666666666666667,3.3333333333333335,0.8888888888888888,1.5,1.0,
1055,3,4,0,0,3,4,2,7,6,127.0,0.75,1.75,0.1875,0.6666666666666666,2.0,
916,1,0,0,1,1,1,1,2,1,0.0,1.0,0.0,0.0,0.0,0.0,
1074,1,0,0,1,1,1,1,2,1,0.0,1.0,0.0,0.0,0.0,0.0,
693,7,6,0,3,7,9,5,16,15,297.0,0.7777777777777778,3.4444444444444446,1.1358024691358024,1.2333333333333334,2.90625,
508,1,0,0,1,1,1,1,2,1,0.0,1.0,0.0,0.0,0.0,0.0,
1108,2,3,0,0,2,3,2,5,4,163.0,0.6666666666666666,1.6666666666666667,0.2222222222222222,0.5,1.5,
893,1,1,0,0,1,1,1,2,1,0.0,1.0,0.0,0.0,0.0,0.0,
1027,5,1,1,3,6,4,5,10,9,279.0,1.5,2.25,2.6875,1.0333333333333332,1.65625,
516,1,1,0,1,1,2,1,3,2,61.0,0.5,1.0,0.0,0.0,1.0,
1441,1,1,0,0,1,1,1,2,1,0.0,1.0,0.0,0.0,0.0,0.0,
978,1,1,0,0,1,1,1,2,1,0.0,1.0,0.0,0.0,0.0,0.0,
609,2,0,0,1,2,1,2,3,2,41.0,2.0,2.0,0.0,1.0,0.5,
308,2,1,0,0,2,1,2,3,2,55.0,2.0,2.0,0.0,1.0,0.5,
440,4,3,1,2,5,5,4,10,9,216.0,1.0,2.4,1.8400000000000003,0.9833333333333334,2.0,
144,5,6,1,1,6,7,6,13,12,202.0,0.8571428571428571,3.4285714285714284,3.387755102040816,1.0666666666666667,2.15625,
326,1,0,0,1,1,1,1,2,1,0.0,1.0,0.0,0.0,0.0,0.0,
292,1,0,0,1,1,1,1,2,1,0.0,1.0,0.0,0.0,0.0,0.0,
1623,2,1,0,0,2,1,2,3,2,6.0,2.0,2.0,0.0,1.0,0.5,
1145,1,2,0,0,1,2,1,3,2,5.0,0.5,1.0,0.0,0.0,1.0,
1323,1,3,0,0,1,3,1,4,3,46.0,0.3333333333333333,1.0,0.0,0.0,1.5,
447,2,0,0,1,2,1,2,3,2,68.0,2.0,2.0,0.0,1.0,0.5,
179,0,0,1,1,1,1,1,2,1,0.0,1.0,0.0,0.0,0.0,0.0,
384,2,0,0,2,2,2,2,4,3,72.0,1.0,1.5,0.25,0.5,1.0,
684,4,1,0,0,4,1,4,5,4,140.0,4.0,4.0,0.0,1.8333333333333333,0.25,
126,3,2,1,0,4,2,3,6,5,117.0,2.0,2.5,0.25,0.8333333333333333,0.875,
1669,5,3,0,3,5,6,3,11,10,235.0,0.8333333333333334,2.3333333333333335,0.5555555555555556,0.9,2.625,
507,4,1,0,2,4,3,3,7,6,99.0,1.3333333333333333,2.3333333333333335,0.22222222222222224,0.8333333333333333,1.375,
1418,1,1,0,0,1,1,1,2,1,0.0,1.0,0.0,0.0,0.0,0.0,
1626,1,1,0,0,1,1,1,2,1,0.0,1.0,0.0,0.0,0.0,0.0,
1480,1,1,0,1,1,2,1,3,2,80.0,0.5,1.0,0.0,0.0,1.0,
1278,2,0,0,3,2,3,2,5,4,44.0,0.6666666666666666,1.3333333333333333,0.2222222222222222,0.5,1.5,
1154,1,0,0,1,1,1,1,2,1,0.0,1.0,0.0,0.0,0.0,0.0,
1468,1,1,0,0,1,1,1,2,1,0.0,1.0,0.0,0.0,0.0,0.0,
20,0,1,1,0,1,1,1,2,1,0.0,1.0,0.0,0.0,0.0,0.0,
1613,1,1,0,0,1,1,1,2,1,0.0,1.0,0.0,0.0,0.0,0.0,
99,41,37,2,15,43,52,13,95,94,554.0,0.8269230769230769,5.865384615384615,8.46264792899408,2.7845426589234634,8.8560791015625,
493,3,2,0,0,3,2,3,5,4,70.0,1.5,2.5,0.25,1.0,0.875,
759,1,0,0,2,1,2,1,3,2,36.0,0.5,1.0,0.0,0.0,1.0,
318,1,1,0,0,1,1,1,2,1,0.0,1.0,0.0,0.0,0.0,0.0,
1431,1,1,0,0,1,1,1,2,1,0.0,1.0,0.0,0.0,0.0,0.0,
175,1,1,1,0,2,1,2,3,2,30.0,2.0,2.0,0.0,1.0,0.5,
719,1,1,0,0,1,1,1,2,1,0.0,1.0,0.0,0.0,0.0,0.0,
532,1,1,0,0,1,1,1,2,1,0.0,1.0,0.0,0.0,0.0,0.0,
1379,1,2,0,0,1,2,1,3,2,4.0,0.5,1.0,0.0,0.0,1.0,
744,1,1,0,0,1,1,1,2,1,0.0,1.0,0.0,0.0,0.0,0.0,
18,2,2,1,1,3,3,3,6,5,81.0,1.0,2.3333333333333335,0.8888888888888888,0.8333333333333333,1.25,
788,3,1,0,1,3,2,3,5,4,101.0,1.5,2.5,0.25,1.0,0.875,
261,7,7,0,1,7,8,5,15,14,179.0,0.875,2.625,1.984375,1.4833333333333334,3.03125,
284,3,3,0,3,3,6,3,9,8,143.0,0.5,2.3333333333333335,0.888888888888889,0.8333333333333333,2.5,
1170,1,0,0,1,1,1,1,2,1,0.0,1.0,0.0,0.0,0.0,0.0,
1280,2,1,0,0,2,1,2,3,2,11.0,2.0,2.0,0.0,1.0,0.5,
1652,1,1,0,0,1,1,1,2,1,0.0,1.0,0.0,0.0,0.0,0.0,
53,4,5,1,2,5,7,3,12,11,158.0,0.7142857142857143,2.142857142857143,0.4081632653061225,0.9,3.25,
669,1,0,0,1,1,1,1,2,1,0.0,1.0,0.0,0.0,0.0,0.0,
50,3,5,2,1,5,6,3,11,10,115.0,0.8333333333333334,1.8333333333333333,0.8055555555555557,0.9,2.75,
1058,2,2,0,0,2,2,2,4,3,36.0,1.0,2.0,0.0,1.0,1.0,
1191,3,3,0,3,3,6,2,9,8,177.0,0.5,1.6666666666666667,0.22222222222222224,0.6666666666666666,3.0,
1475,1,1,0,0,1,1,1,2,1,0.0,1.0,0.0,0.0,0.0,0.0,
301,2,2,0,1,2,3,2,5,4,55.0,0.6666666666666666,2.0,0.0,1.0,1.5,
701,0,1,1,0,1,1,1,2,1,0.0,1.0,0.0,0.0,0.0,0.0,
153,3,5,1,1,4,6,3,10,9,197.0,0.6666666666666666,2.1666666666666665,0.8055555555555555,1.1666666666666665,2.625,
1653,3,3,0,3,3,6,3,9,8,162.0,0.5,2.6666666666666665,0.5555555555555555,0.8333333333333333,2.375,
135,0,0,1,1,1,1,1,2,1,0.0,1.0,0.0,0.0,0.0,0.0,
1343,2,1,0,0,2,1,2,3,2,11.0,2.0,2.0,0.0,1.0,0.5,
1266,3,0,0,1,3,1,3,4,3,64.0,3.0,3.0,0.0,1.5,0.375,
346,1,2,0,1,1,3,1,4,3,59.0,0.3333333333333333,1.0,0.0,0.0,1.5,
761,1,1,0,0,1,1,1,2,1,0.0,1.0,0.0,0.0,0.0,0.0,
1362,10,7,0,1,10,8,7,18,17,263.0,1.25,3.875,2.109375,1.2734126984126986,2.3359375,
1294,2,0,0,1,2,1,2,3,2,30.0,2.0,2.0,0.0,1.0,0.5,
388,1,1,0,1,1,2,1,3,2,15.0,0.5,1.0,0.0,0.0,1.0,
562,1,1,0,0,1,1,1,2,1,0.0,1.0,0.0,0.0,0.0,0.0,
1506,3,4,0,0,3,4,2,7,6,68.0,0.75,1.5,0.25,0.6666666666666666,2.0,
1029,1,0,0,1,1,1,1,2,1,0.0,1.0,0.0,0.0,0.0,0.0,
1659,3,2,0,3,3,5,2,8,7,68.0,0.6,1.4,0.24,0.6666666666666666,2.5,
630,1,1,0,1,1,2,1,3,2,23.0,0.5,1.0,0.0,0.0,1.0,
1313,0,1,1,0,1,1,1,2,1,0.0,1.0,0.0,0.0,0.0,0.0,
94,1,1,1,0,2,1,2,3,2,35.0,2.0,2.0,0.0,1.0,0.5,
552,1,1,0,0,1,1,1,2,1,0.0,1.0,0.0,0.0,0.0,0.0,
1666,1,1,0,0,1,1,1,2,1,0.0,1.0,0.0,0.0,0.0,0.0,
1120,3,4,1,1,4,5,3,9,8,308.0,0.8,2.0,0.8,0.8333333333333333,2.25,
1256,7,11,1,2,8,13,5,21,20,701.0,0.6153846153846154,2.923076923076923,1.301775147928994,1.2357142857142858,4.78125,
954,1,0,0,1,1,1,1,2,1,0.0,1.0,0.0,0.0,0.0,0.0,
1497,3,2,0,1,3,3,2,6,5,142.0,1.0,2.0,0.0,0.6666666666666666,1.5,
52,0,1,1,0,1,1,1,2,1,0.0,1.0,0.0,0.0,0.0,0.0,
256,2,3,0,0,2,3,2,5,4,230.0,0.6666666666666666,1.3333333333333333,0.2222222222222222,0.5,1.5,
376,2,3,1,1,3,4,2,7,6,72.0,0.75,1.5,0.25,0.6666666666666666,2.0,
1050,1,1,0,1,1,2,1,3,2,2.0,0.5,1.0,0.0,0.0,1.0,
324,1,1,0,0,1,1,1,2,1,0.0,1.0,0.0,0.0,0.0,0.0,
1503,1,1,0,0,1,1,1,2,1,0.0,1.0,0.0,0.0,0.0,0.0,
1642,2,1,0,0,2,1,2,3,2,15.0,2.0,2.0,0.0,1.0,0.5,
1178,1,0,1,1,2,1,2,3,2,11.0,2.0,2.0,0.0,1.0,0.5,
172,0,1,1,0,1,1,1,2,1,0.0,1.0,0.0,0.0,0.0,0.0,
225,3,1,0,1,3,2,3,5,4,52.0,1.5,2.0,1.0,0.8333333333333333,0.875,
590,2,3,0,0,2,3,2,5,4,109.0,0.6666666666666666,1.3333333333333333,0.2222222222222222,0.5,1.5,
1057,1,2,1,0,2,2,2,4,3,87.0,1.0,1.5,0.25,0.5,1.0,
1283,1,1,0,0,1,1,1,2,1,0.0,1.0,0.0,0.0,0.0,0.0,
1373,1,1,0,0,1,1,1,2,1,0.0,1.0,0.0,0.0,0.0,0.0,
340,1,1,0,0,1,1,1,2,1,0.0,1.0,0.0,0.0,0.0,0.0,
1463,1,2,0,0,1,2,1,3,2,2.0,0.5,1.0,0.0,0.0,1.0,
49,26,24,1,14,27,38,11,65,64,717.0,0.7105263157894737,6.921052631578948,4.493767313019391,2.6998556998557,3.5009765625,
1395,2,1,0,1,2,2,2,4,3,50.0,1.0,1.5,0.25,0.5,1.0,
1035,1,3,0,0,1,3,1,4,3,61.0,0.3333333333333333,1.0,0.0,0.0,1.5,
1660,7,3,0,2,7,5,6,12,11,319.0,1.4,3.2,3.7599999999999993,1.2666666666666666,1.59375,
485,0,0,1,1,1,1,1,2,1,0.0,1.0,0.0,0.0,0.0,0.0,
424,2,2,0,0,2,2,2,4,3,83.0,1.0,1.5,0.25,0.5,1.0,
1014,2,2,0,0,2,2,2,4,3,36.0,1.0,2.0,0.0,1.0,1.0,
397,1,2,0,0,1,2,1,3,2,3.0,0.5,1.0,0.0,0.0,1.0,
1638,4,2,0,1,4,3,4,7,6,155.0,1.3333333333333333,3.6666666666666665,0.22222222222222224,1.3333333333333333,0.875,
550,1,1,0,0,1,1,1,2,1,0.0,1.0,0.0,0.0,0.0,0.0,
248,2,0,0,1,2,1,2,3,2,93.0,2.0,2.0,0.0,1.0,0.5,
1612,1,1,0,0,1,1,1,2,1,0.0,1.0,0.0,0.0,0.0,0.0,
1452,1,1,0,0,1,1,1,2,1,0.0,1.0,0.0,0.0,0.0,0.0,
1150,4,2,0,2,4,4,4,8,7,121.0,1.0,3.0,0.5,1.1666666666666665,1.5,
1264,2,1,0,0,2,1,2,3,2,3.0,2.0,2.0,0.0,1.0,0.5,
1339,3,1,0,1,3,2,3,5,4,142.0,1.5,2.5,0.25,1.0,0.875,
1579,1,0,0,1,1,1,1,2,1,0.0,1.0,0.0,0.0,0.0,0.0,
639,15,11,0,8,15,19,6,34,33,424.0,0.7894736842105263,4.2631578947368425,1.772853185595568,1.696825396825397,4.5,
142,0,1,1,0,1,1,1,2,1,0.0,1.0,0.0,0.0,0.0,0.0,
1015,2,1,0,1,2,2,2,4,3,28.0,1.0,1.5,0.25,0.5,1.0,
725,1,1,0,1,1,2,1,3,2,79.0,0.5,1.0,0.0,0.0,1.0,
352,1,1,0,0,1,1,1,2,1,0.0,1.0,0.0,0.0,0.0,0.0,
1671,3,3,0,1,3,4,3,7,6,173.0,0.75,2.0,1.0,0.8333333333333333,1.75,
1686,1,1,0,0,1,1,1,2,1,0.0,1.0,0.0,0.0,0.0,0.0,
106,0,1,1,0,1,1,1,2,1,0.0,1.0,0.0,0.0,0.0,0.0,
1573,1,1,0,0,1,1,1,2,1,0.0,1.0,0.0,0.0,0.0,0.0,
878,1,2,0,1,1,3,1,4,3,58.0,0.3333333333333333,1.0,0.0,0.0,1.5,
1347,2,1,0,0,2,1,2,3,2,4.0,2.0,2.0,0.0,1.0,0.5,
612,3,1,0,0,3,1,3,4,3,59.0,3.0,3.0,0.0,1.5,0.375,
268,1,0,0,1,1,1,1,2,1,0.0,1.0,0.0,0.0,0.0,0.0,
1220,1,1,0,0,1,1,1,2,1,0.0,1.0,0.0,0.0,0.0,0.0,
925,1,1,0,0,1,1,1,2,1,0.0,1.0,0.0,0.0,0.0,0.0,
650,1,1,0,0,1,1,1,2,1,0.0,1.0,0.0,0.0,0.0,0.0,
973,2,2,0,0,2,2,2,4,3,39.0,1.0,1.5,0.25,0.5,1.0,
655,1,1,0,1,1,2,1,3,2,16.0,0.5,1.0,0.0,0.0,1.0,
559,1,1,0,1,1,2,1,3,2,9.0,0.5,1.0,0.0,0.0,1.0,
120,0,3,1,2,1,5,1,6,5,79.0,0.2,1.0,0.0,0.0,2.5,
1447,1,2,0,0,1,2,1,3,2,80.0,0.5,1.0,0.0,0.0,1.0,
843,1,1,0,0,1,1,1,2,1,0.0,1.0,0.0,0.0,0.0,0.0,
164,8,3,2,4,10,7,10,17,16,360.0,1.4285714285714286,5.714285714285714,14.775510204081632,1.191269841269841,1.576171875,
3,3,1,1,0,4,1,4,5,4,30.0,4.0,4.0,0.0,1.8333333333333333,0.25,
111,5,7,2,3,7,10,5,17,16,181.0,0.7,3.5,1.05,1.2333333333333334,3.1875,
7,0,3,1,0,1,3,1,4,3,74.0,0.3333333333333333,1.0,0.0,0.0,1.5,
432,4,1,0,0,4,1,4,5,4,73.0,4.0,4.0,0.0,1.8333333333333333,0.25,
911,3,0,0,2,3,2,3,5,4,76.0,1.5,3.0,0.0,1.5,0.75,
834,2,2,0,0,2,2,2,4,3,45.0,1.0,1.5,0.25,0.5,1.0,
1458,1,1,0,0,1,1,1,2,1,0.0,1.0,0.0,0.0,0.0,0.0,
714,0,0,1,1,1,1,1,2,1,0.0,1.0,0.0,0.0,0.0,0.0,
1386,1,1,0,0,1,1,1,2,1,0.0,1.0,0.0,0.0,0.0,0.0,
1064,1,2,0,0,1,2,1,3,2,9.0,0.5,1.0,0.0,0.0,1.0,
1082,2,1,0,2,2,3,2,5,4,150.0,0.6666666666666666,1.6666666666666667,0.2222222222222222,0.5,1.5,
1406,1,2,0,0,1,2,1,3,2,7.0,0.5,1.0,0.0,0.0,1.0,
993,4,2,0,0,4,2,4,6,5,163.0,2.0,2.5,2.25,0.9166666666666665,0.75,
1091,1,0,0,1,1,1,1,2,1,0.0,1.0,0.0,0.0,0.0,0.0,
35,3,3,1,0,4,3,4,7,6,119.0,1.3333333333333333,3.6666666666666665,0.22222222222222224,1.3333333333333333,0.875,
247,2,0,0,1,2,1,2,3,2,46.0,2.0,2.0,0.0,1.0,0.5,
1182,1,1,0,0,1,1,1,2,1,0.0,1.0,0.0,0.0,0.0,0.0,
573,6,6,0,2,6,8,5,14,13,498.0,0.75,2.125,1.359375,1.0333333333333332,3.65625,
946,1,1,0,0,1,1,1,2,1,0.0,1.0,0.0,0.0,0.0,0.0,
1518,1,1,0,0,1,1,1,2,1,0.0,1.0,0.0,0.0,0.0,0.0,
603,1,5,0,0,1,5,1,6,5,120.0,0.2,1.0,0.0,0.0,2.5,
966,1,2,0,0,1,2,1,3,2,17.0,0.5,1.0,0.0,0.0,1.0,
1645,1,1,0,0,1,1,1,2,1,0.0,1.0,0.0,0.0,0.0,0.0,
1302,4,4,0,0,4,4,4,8,7,68.0,1.0,1.75,1.6875,0.9166666666666666,1.75,
620,2,0,0,1,2,1,2,3,2,34.0,2.0,2.0,0.0,1.0,0.5,
1586,1,1,0,0,1,1,1,2,1,0.0,1.0,0.0,0.0,0.0,0.0,
999,1,2,0,0,1,2,1,3,2,32.0,0.5,1.0,0.0,0.0,1.0,
176,0,1,1,0,1,1,1,2,1,0.0,1.0,0.0,0.0,0.0,0.0,
1306,1,1,0,0,1,1,1,2,1,0.0,1.0,0.0,0.0,0.0,0.0,
789,1,1,0,0,1,1,1,2,1,0.0,1.0,0.0,0.0,0.0,0.0,
833,3,1,0,0,3,1,3,4,3,25.0,3.0,3.0,0.0,1.5,0.375,
357,1,1,0,0,1,1,1,2,1,0.0,1.0,0.0,0.0,0.0,0.0,
218,0,1,1,0,1,1,1,2,1,0.0,1.0,0.0,0.0,0.0,0.0,
1229,1,1,0,0,1,1,1,2,1,0.0,1.0,0.0,0.0,0.0,0.0,
383,1,3,0,0,1,3,1,4,3,54.0,0.3333333333333333,1.0,0.0,0.0,1.5,
530,1,1,0,0,1,1,1,2,1,0.0,1.0,0.0,0.0,0.0,0.0,
282,1,0,0,1,1,1,1,2,1,0.0,1.0,0.0,0.0,0.0,0.0,
1324,2,3,0,0,2,3,2,5,4,27.0,0.6666666666666666,1.3333333333333333,0.2222222222222222,0.5,1.5,
1352,2,1,0,0,2,1,2,3,2,36.0,2.0,2.0,0.0,1.0,0.5,
1427,4,3,0,5,4,8,3,12,11,262.0,0.5,2.0,0.25,0.8333333333333333,3.875,
328,3,1,0,0,3,1,3,4,3,47.0,3.0,3.0,0.0,1.5,0.375,
1365,1,1,0,0,1,1,1,2,1,0.0,1.0,0.0,0.0,0.0,0.0,
517,1,0,0,1,1,1,1,2,1,0.0,1.0,0.0,0.0,0.0,0.0,
588,1,1,0,0,1,1,1,2,1,0.0,1.0,0.0,0.0,0.0,0.0,
845,1,1,0,0,1,1,1,2,1,0.0,1.0,0.0,0.0,0.0,0.0,
804,2,1,0,0,2,1,2,3,2,60.0,2.0,2.0,0.0,1.0,0.5,
712,3,1,0,1,3,2,3,5,4,65.0,1.5,2.5,0.25,1.0,0.875,
127,3,2,1,1,4,3,4,7,6,124.0,1.3333333333333333,2.3333333333333335,1.5555555555555554,0.9166666666666665,1.25,
695,1,1,0,0,1,1,1,2,1,0.0,1.0,0.0,0.0,0.0,0.0,
1265,0,1,1,0,1,1,1,2,1,0.0,1.0,0.0,0.0,0.0,0.0,
1273,3,3,0,0,3,3,3,6,5,116.0,1.0,2.6666666666666665,0.22222222222222224,1.0,1.25,
258,2,1,0,4,2,5,2,7,6,125.0,0.4,2.0,0.0,1.0,2.5,
295,2,2,0,0,2,2,2,4,3,128.0,1.0,2.0,0.0,1.0,1.0,
373,2,0,0,1,2,1,2,3,2,13.0,2.0,2.0,0.0,1.0,0.5,
621,2,2,0,0,2,2,2,4,3,55.0,1.0,1.5,0.25,0.5,1.0,
665,2,3,0,1,2,4,2,6,5,79.0,0.5,1.5,0.25,0.5,2.0,
526,2,0,0,1,2,1,2,3,2,4.0,2.0,2.0,0.0,1.0,0.5,
1005,1,2,0,1,1,3,1,4,3,26.0,0.3333333333333333,1.0,0.0,0.0,1.5,
36,0,1,1,0,1,1,1,2,1,0.0,1.0,0.0,0.0,0.0,0.0,
1315,2,1,0,0,2,1,2,3,2,32.0,2.0,2.0,0.0,1.0,0.5,
863,0,1,1,0,1,1,1,2,1,0.0,1.0,0.0,0.0,0.0,0.0,
25,10,8,1,2,11,10,6,21,20,237.0,1.1,4.5,2.25,1.8119047619047617,2.28125,
60,8,11,1,2,9,13,6,22,21,295.0,0.6923076923076923,4.384615384615385,1.467455621301775,1.9333333333333331,3.03125,
385,2,4,0,1,2,5,2,7,6,276.0,0.4,1.4,0.24,0.5,2.5,
1454,2,1,0,0,2,1,2,3,2,42.0,2.0,2.0,0.0,1.0,0.5,
495,1,0,0,1,1,1,1,2,1,0.0,1.0,0.0,0.0,0.0,0.0,
1434,3,1,0,1,3,2,3,5,4,92.0,1.5,3.0,0.0,1.5,0.75,
66,0,1,1,0,1,1,1,2,1,0.0,1.0,0.0,0.0,0.0,0.0,
241,12,7,1,5,13,12,9,25,24,377.0,1.0833333333333333,5.5,5.583333333333333,1.5273809523809525,2.259765625,
184,4,7,1,1,5,8,5,13,12,187.0,0.625,2.875,1.359375,1.1666666666666665,3.15625,
794,1,0,0,2,1,2,1,3,2,61.0,0.5,1.0,0.0,0.0,1.0,
482,1,1,0,0,1,1,1,2,1,0.0,1.0,0.0,0.0,0.0,0.0,
1522,2,0,0,1,2,1,2,3,2,35.0,2.0,2.0,0.0,1.0,0.5,
45,1,3,1,0,2,3,2,5,4,140.0,0.6666666666666666,1.6666666666666667,0.2222222222222222,0.5,1.5,
1078,1,1,0,0,1,1,1,2,1,0.0,1.0,0.0,0.0,0.0,0.0,
456,1,1,0,0,1,1,1,2,1,0.0,1.0,0.0,0.0,0.0,0.0,
666,3,2,0,1,3,3,3,6,5,227.0,1.0,2.3333333333333335,0.8888888888888888,0.8333333333333333,1.25,
751,1,1,0,0,1,1,1,2,1,0.0,1.0,0.0,0.0,0.0,0.0,
570,1,0,0,1,1,1,1,2,1,0.0,1.0,0.0,0.0,0.0,0.0,
139,1,0,1,1,2,1,2,3,2,49.0,2.0,2.0,0.0,1.0,0.5,
618,2,2,0,1,2,3,2,5,4,102.0,0.6666666666666666,1.3333333333333333,0.2222222222222222,0.5,1.5,
239,8,3,0,1,8,4,6,12,11,247.0,2.0,4.75,2.6875,1.6833333333333331,0.84375,
1682,4,4,0,1,4,5,3,9,8,128.0,0.8,2.2,0.15999999999999998,0.8333333333333333,2.375,
1633,15,13,0,5,15,18,7,33,32,295.0,0.8333333333333334,4.333333333333333,2.666666666666666,1.596897546897547,4.1484375,
952,2,2,0,0,2,2,2,4,3,37.0,1.0,1.5,0.25,0.5,1.0,
431,2,1,0,0,2,1,2,3,2,16.0,2.0,2.0,0.0,1.0,0.5,
1363,1,1,0,0,1,1,1,2,1,0.0,1.0,0.0,0.0,0.0,0.0,
988,2,3,0,1,2,4,2,6,5,120.0,0.5,1.75,0.1875,0.5,2.0,
680,1,1,0,1,1,2,1,3,2,68.0,0.5,1.0,0.0,0.0,1.0,
254,2,0,0,2,2,2,2,4,3,25.0,1.0,1.5,0.25,0.5,1.0,
1408,2,1,0,0,2,1,2,3,2,31.0,2.0,2.0,0.0,1.0,0.5,
851,1,1,0,0,1,1,1,2,1,0.0,1.0,0.0,0.0,0.0,0.0,
1297,1,1,0,0,1,1,1,2,1,0.0,1.0,0.0,0.0,0.0,0.0,
1012,1,1,0,0,1,1,1,2,1,0.0,1.0,0.0,0.0,0.0,0.0,
44,13,10,1,3,14,13,6,27,26,285.0,1.0769230769230769,4.384615384615385,1.467455621301775,2.2785714285714285,3.0,
1439,1,1,0,0,1,1,1,2,1,0.0,1.0,0.0,0.0,0.0,0.0,
365,1,1,0,0,1,1,1,2,1,0.0,1.0,0.0,0.0,0.0,0.0,
195,2,0,1,1,3,1,3,4,3,91.0,3.0,3.0,0.0,1.5,0.375,
1390,1,0,0,1,1,1,1,2,1,0.0,1.0,0.0,0.0,0.0,0.0,
80,0,1,1,0,1,1,1,2,1,0.0,1.0,0.0,0.0,0.0,0.0,
208,0,1,1,0,1,1,1,2,1,0.0,1.0,0.0,0.0,0.0,0.0,
885,1,2,0,0,1,2,1,3,2,14.0,0.5,1.0,0.0,0.0,1.0,
1487,3,1,0,1,3,2,3,5,4,57.0,1.5,2.5,0.25,1.0,0.875,
829,3,1,0,0,3,1,3,4,3,37.0,3.0,3.0,0.0,1.5,0.375,
129,0,1,1,0,1,1,1,2,1,0.0,1.0,0.0,0.0,0.0,0.0,
185,0,1,1,1,1,2,1,3,2,85.0,0.5,1.0,0.0,0.0,1.0,
498,1,1,0,0,1,1,1,2,1,0.0,1.0,0.0,0.0,0.0,0.0,
1286,1,1,0,0,1,1,1,2,1,0.0,1.0,0.0,0.0,0.0,0.0,
922,2,1,0,1,2,2,2,4,3,40.0,1.0,2.0,0.0,1.0,1.0,
1545,3,4,0,1,3,5,3,8,7,152.0,0.6,2.0,0.8,0.8333333333333333,2.25,
1453,1,1,0,0,1,1,1,2,1,0.0,1.0,0.0,0.0,0.0,0.0,
1038,2,2,0,1,2,3,2,5,4,322.0,0.6666666666666666,1.3333333333333333,0.2222222222222222,0.5,1.5,
600,3,1,0,1,3,2,3,5,4,27.0,1.5,3.0,0.0,1.5,0.75,
1269,2,1,0,1,2,2,2,4,3,13.0,1.0,1.5,0.25,0.5,1.0,
1216,2,4,0,1,2,5,2,7,6,92.0,0.4,1.2,0.16000000000000006,0.5,2.5,
1371,1,0,0,1,1,1,1,2,1,0.0,1.0,0.0,0.0,0.0,0.0,
1048,0,1,1,0,1,1,1,2,1,0.0,1.0,0.0,0.0,0.0,0.0,
1087,1,1,0,0,1,1,1,2,1,0.0,1.0,0.0,0.0,0.0,0.0,
4,2,2,1,0,3,2,3,5,4,92.0,1.5,2.5,0.25,1.0,0.875,
1171,1,1,0,0,1,1,1,2,1,0.0,1.0,0.0,0.0,0.0,0.0,
1405,1,2,0,0,1,2,1,3,2,2.0,0.5,1.0,0.0,0.0,1.0,
836,1,0,0,1,1,1,1,2,1,0.0,1.0,0.0,0.0,0.0,0.0,
1649,0,0,1,1,1,1,1,2,1,0.0,1.0,0.0,0.0,0.0,0.0,
1496,1,1,0,0,1,1,1,2,1,0.0,1.0,0.0,0.0,0.0,0.0,
1301,1,2,0,0,1,2,1,3,2,57.0,0.5,1.0,0.0,0.0,1.0,
1335,1,1,0,0,1,1,1,2,1,0.0,1.0,0.0,0.0,0.0,0.0,
813,1,1,0,0,1,1,1,2,1,0.0,1.0,0.0,0.0,0.0,0.0,
1599,1,1,0,0,1,1,1,2,1,0.0,1.0,0.0,0.0,0.0,0.0,
1566,3,0,0,4,3,4,3,7,6,131.0,0.75,2.25,0.1875,1.0,1.875,
1228,3,1,0,1,3,2,3,5,4,182.0,1.5,2.5,0.25,1.0,0.875,
1247,1,3,0,0,1,3,1,4,3,47.0,0.3333333333333333,1.0,0.0,0.0,1.5,
1354,1,2,0,0,1,2,1,3,2,5.0,0.5,1.0,0.0,0.0,1.0,
1011,2,2,1,0,3,2,3,5,4,100.0,1.5,2.5,0.25,1.0,0.875,
27,2,2,1,0,3,2,3,5,4,77.0,1.5,2.5,0.25,1.0,0.875,
1070,1,1,0,0,1,1,1,2,1,0.0,1.0,0.0,0.0,0.0,0.0,
1563,1,1,0,0,1,1,1,2,1,0.0,1.0,0.0,0.0,0.0,0.0,
509,2,1,0,0,2,1,2,3,2,18.0,2.0,2.0,0.0,1.0,0.5,
1684,2,1,0,0,2,1,2,3,2,43.0,2.0,2.0,0.0,1.0,0.5,
768,3,4,0,3,3,7,3,10,9,303.0,0.42857142857142855,2.2857142857142856,0.48979591836734704,0.8333333333333333,3.125,
982,1,0,0,1,1,1,1,2,1,0.0,1.0,0.0,0.0,0.0,0.0,
545,1,1,0,1,1,2,1,3,2,8.0,0.5,1.0,0.0,0.0,1.0,
1568,4,4,0,1,4,5,4,9,8,243.0,0.8,3.0,0.8,1.1666666666666665,1.875,
583,1,1,0,0,1,1,1,2,1,0.0,1.0,0.0,0.0,0.0,0.0,
1195,1,1,0,2,1,3,1,4,3,27.0,0.3333333333333333,1.0,0.0,0.0,1.5,
345,1,1,0,0,1,1,1,2,1,0.0,1.0,0.0,0.0,0.0,0.0,
1146,2,1,0,0,2,1,2,3,2,6.0,2.0,2.0,0.0,1.0,0.5,
1576,2,2,0,3,2,5,2,7,6,83.0,0.4,1.6,0.24,0.5,2.5,
293,1,0,0,1,1,1,1,2,1,0.0,1.0,0.0,0.0,0.0,0.0,
1107,8,6,0,3,8,9,3,17,16,186.0,0.8888888888888888,2.5555555555555554,0.2469135802469136,1.65,3.875,
1687,1,3,0,0,1,3,1,4,3,92.0,0.3333333333333333,1.0,0.0,0.0,1.5,
56,6,3,1,1,7,4,7,11,10,108.0,1.75,5.75,1.1875,1.5333333333333332,0.4921875,
1465,1,0,0,1,1,1,1,2,1,0.0,1.0,0.0,0.0,0.0,0.0,
173,4,4,1,2,5,6,5,11,10,160.0,0.8333333333333334,3.0,2.6666666666666665,1.0333333333333332,2.0625,
902,3,4,0,2,3,6,3,9,8,210.0,0.5,2.1666666666666665,0.13888888888888884,1.0,2.875,
632,2,1,0,1,2,2,2,4,3,17.0,1.0,1.5,0.25,0.5,1.0,
1155,1,1,0,0,1,1,1,2,1,0.0,1.0,0.0,0.0,0.0,0.0,
296,2,1,0,1,2,2,2,4,3,126.0,1.0,1.5,0.25,0.5,1.0,
1325,2,2,0,0,2,2,2,4,3,57.0,1.0,2.0,0.0,1.0,1.0,
396,1,3,0,0,1,3,1,4,3,69.0,0.3333333333333333,1.0,0.0,0.0,1.5,
1290,6,2,0,0,6,2,4,8,7,84.0,3.0,3.5,0.25,0.9833333333333333,0.625,
1526,3,1,0,0,3,1,3,4,3,43.0,3.0,3.0,0.0,1.5,0.375,
499,1,1,0,0,1,1,1,2,1,0.0,1.0,0.0,0.0,0.0,0.0,
537,1,1,0,0,1,1,1,2,1,0.0,1.0,0.0,0.0,0.0,0.0,
1353,1,0,0,1,1,1,1,2,1,0.0,1.0,0.0,0.0,0.0,0.0,
1634,2,1,0,0,2,1,2,3,2,7.0,2.0,2.0,0.0,1.0,0.5,
82,1,1,2,1,3,2,3,5,4,59.0,1.5,2.5,0.25,1.0,0.875,
989,2,1,0,1,2,2,2,4,3,23.0,1.0,1.5,0.25,0.5,1.0,
399,1,1,0,0,1,1,1,2,1,0.0,1.0,0.0,0.0,0.0,0.0,
998,1,1,0,0,1,1,1,2,1,0.0,1.0,0.0,0.0,0.0,0.0,
594,2,1,0,1,2,2,2,4,3,133.0,1.0,2.0,0.0,1.0,1.0,
580,1,1,0,0,1,1,1,2,1,0.0,1.0,0.0,0.0,0.0,0.0,
1607,0,1,1,0,1,1,1,2,1,0.0,1.0,0.0,0.0,0.0,0.0,
136,2,2,1,2,3,4,2,7,6,179.0,0.75,1.75,0.1875,0.6666666666666666,2.0,
1135,5,5,0,0,5,5,4,10,9,144.0,1.0,2.6,1.8400000000000003,1.1666666666666665,1.875,
366,1,1,0,0,1,1,1,2,1,0.0,1.0,0.0,0.0,0.0,0.0,
1537,1,2,0,1,1,3,1,4,3,91.0,0.3333333333333333,1.0,0.0,0.0,1.5,
951,4,3,0,0,4,3,4,7,6,135.0,1.3333333333333333,2.3333333333333335,1.5555555555555554,0.9166666666666666,1.25,
137,15,15,1,9,16,24,7,40,39,542.0,0.6666666666666666,5.083333333333333,1.5763888888888884,2.3226190476190474,4.1484375,
1081,1,1,0,0,1,1,1,2,1,0.0,1.0,0.0,0.0,0.0,0.0,
177,3,3,1,3,4,6,3,10,9,226.0,0.6666666666666666,2.0,0.3333333333333333,0.8333333333333333,2.875,
359,4,5,0,1,4,6,4,10,9,168.0,0.6666666666666666,2.5,2.25,0.9166666666666665,2.25,
1206,5,2,0,0,5,2,5,7,6,145.0,2.5,3.5,2.25,1.1666666666666665,0.65625,
1251,1,1,0,0,1,1,1,2,1,0.0,1.0,0.0,0.0,0.0,0.0,
34,0,1,1,0,1,1,1,2,1,0.0,1.0,0.0,0.0,0.0,0.0,
207,3,3,1,0,4,3,4,7,6,32.0,1.3333333333333333,3.3333333333333335,0.22222222222222224,1.3333333333333333,1.0,
122,3,2,1,2,4,4,4,8,7,103.0,1.0,2.25,1.6875,0.9166666666666666,1.625,
1680,1,1,0,0,1,1,1,2,1,0.0,1.0,0.0,0.0,0.0,0.0,
31,0,4,1,0,1,4,1,5,4,140.0,0.25,1.0,0.0,0.0,2.0,
1337,2,3,0,0,2,3,2,5,4,77.0,0.6666666666666666,1.6666666666666667,0.2222222222222222,0.5,1.5,
623,1,1,0,0,1,1,1,2,1,0.0,1.0,0.0,0.0,0.0,0.0,
1110,0,1,1,0,1,1,1,2,1,0.0,1.0,0.0,0.0,0.0,0.0,
1109,1,1,0,0,1,1,1,2,1,0.0,1.0,0.0,0.0,0.0,0.0,
816,1,0,0,1,1,1,1,2,1,0.0,1.0,0.0,0.0,0.0,0.0,
1621,2,3,0,2,2,5,2,7,6,268.0,0.4,1.2,0.16000000000000006,0.5,2.5,
737,2,0,0,1,2,1,2,3,2,15.0,2.0,2.0,0.0,1.0,0.5,
1394,3,1,0,0,3,1,3,4,3,18.0,3.0,3.0,0.0,1.5,0.375,
1002,1,1,0,0,1,1,1,2,1,0.0,1.0,0.0,0.0,0.0,0.0,
29,2,3,1,1,3,4,3,7,6,58.0,0.75,1.75,0.6875,0.8333333333333333,1.875,
369,2,1,0,1,2,2,2,4,3,128.0,1.0,1.5,0.25,0.5,1.0,
511,2,1,0,0,2,1,2,3,2,52.0,2.0,2.0,0.0,1.0,0.5,
1197,5,6,0,0,5,6,4,11,10,244.0,0.8333333333333334,2.0,1.0,0.9833333333333334,2.75,
1360,1,1,0,0,1,1,1,2,1,0.0,1.0,0.0,0.0,0.0,0.0,
657,2,0,0,1,2,1,2,3,2,4.0,2.0,2.0,0.0,1.0,0.5,
1271,1,1,0,0,1,1,1,2,1,0.0,1.0,0.0,0.0,0.0,0.0,
535,1,1,0,0,1,1,1,2,1,0.0,1.0,0.0,0.0,0.0,0.0,
494,3,0,1,1,4,1,4,5,4,89.0,4.0,4.0,0.0,1.8333333333333333,0.25,
333,1,1,0,0,1,1,1,2,1,0.0,1.0,0.0,0.0,0.0,0.0,
64,2,2,1,0,3,2,3,5,4,88.0,1.5,2.0,1.0,0.8333333333333333,0.875,
1489,1,1,0,0,1,1,1,2,1,0.0,1.0,0.0,0.0,0.0,0.0,
914,2,0,0,1,2,1,2,3,2,29.0,2.0,2.0,0.0,1.0,0.5,
767,1,1,0,0,1,1,1,2,1,0.0,1.0,0.0,0.0,0.0,0.0,
380,1,1,0,0,1,1,1,2,1,0.0,1.0,0.0,0.0,0.0,0.0,
163,0,1,1,0,1,1,1,2,1,0.0,1.0,0.0,0.0,0.0,0.0,
439,5,7,0,0,5,7,5,12,11,246.0,0.7142857142857143,3.142857142857143,2.122448979591837,1.0333333333333332,2.28125,
1249,1,1,0,1,1,2,1,3,2,60.0,0.5,1.0,0.0,0.0,1.0,
1615,1,1,0,0,1,1,1,2,1,0.0,1.0,0.0,0.0,0.0,0.0,
1624,1,1,0,0,1,1,1,2,1,0.0,1.0,0.0,0.0,0.0,0.0,
1444,1,1,0,0,1,1,1,2,1,0.0,1.0,0.0,0.0,0.0,0.0,
697,1,2,0,0,1,2,1,3,2,61.0,0.5,1.0,0.0,0.0,1.0,
490,2,2,0,0,2,2,2,4,3,62.0,1.0,2.0,0.0,1.0,1.0,
1567,2,3,0,1,2,4,2,6,5,20.0,0.5,1.5,0.25,0.5,2.0,
353,1,1,0,1,1,2,1,3,2,2.0,0.5,1.0,0.0,0.0,1.0,
1054,2,2,0,0,2,2,2,4,3,124.0,1.0,1.5,0.25,0.5,1.0,
1498,1,2,0,0,1,2,1,3,2,28.0,0.5,1.0,0.0,0.0,1.0,
1532,1,2,0,1,1,3,1,4,3,47.0,0.3333333333333333,1.0,0.0,0.0,1.5,
1239,2,0,0,1,2,1,2,3,2,93.0,2.0,2.0,0.0,1.0,0.5,
339,2,2,0,2,2,4,2,6,5,114.0,0.5,1.25,0.1875,0.5,2.0,
1093,1,1,0,0,1,1,1,2,1,0.0,1.0,0.0,0.0,0.0,0.0,
1630,4,1,0,1,4,2,4,6,5,176.0,2.0,2.5,2.25,0.9166666666666665,0.75,
1212,3,3,0,2,3,5,3,8,7,66.0,0.6,2.0,0.8,0.8333333333333333,2.25,
520,2,2,0,0,2,2,2,4,3,78.0,1.0,2.0,0.0,1.0,1.0,
12,0,1,1,0,1,1,1,2,1,0.0,1.0,0.0,0.0,0.0,0.0,
466,2,2,0,1,2,3,2,5,4,66.0,0.6666666666666666,1.6666666666666667,0.2222222222222222,0.5,1.5,
1089,1,0,0,1,1,1,1,2,1,0.0,1.0,0.0,0.0,0.0,0.0,
1527,1,1,0,0,1,1,1,2,1,0.0,1.0,0.0,0.0,0.0,0.0,
1079,2,1,0,1,2,2,2,4,3,70.0,1.0,2.0,0.0,1.0,1.0,
587,2,2,0,0,2,2,2,4,3,44.0,1.0,2.0,0.0,1.0,1.0,
350,1,2,0,0,1,2,1,3,2,26.0,0.5,1.0,0.0,0.0,1.0,
876,1,2,0,1,1,3,1,4,3,48.0,0.3333333333333333,1.0,0.0,0.0,1.5,
1127,1,3,0,0,1,3,1,4,3,10.0,0.3333333333333333,1.0,0.0,0.0,1.5,
860,2,2,0,0,2,2,2,4,3,116.0,1.0,2.0,0.0,1.0,1.0,
1288,1,2,0,0,1,2,1,3,2,116.0,0.5,1.0,0.0,0.0,1.0,
458,2,1,0,0,2,1,2,3,2,14.0,2.0,2.0,0.0,1.0,0.5,
529,4,3,0,2,4,5,3,9,8,229.0,0.8,2.4,0.24,0.8333333333333333,2.25,
561,1,0,0,1,1,1,1,2,1,0.0,1.0,0.0,0.0,0.0,0.0,
463,2,0,0,1,2,1,2,3,2,36.0,2.0,2.0,0.0,1.0,0.5,
1460,2,1,0,0,2,1,2,3,2,15.0,2.0,2.0,0.0,1.0,0.5,
593,3,6,0,0,3,6,3,9,8,226.0,0.5,2.5,0.25,1.0,2.625,
1501,7,4,0,3,7,7,6,14,13,309.0,1.0,3.5714285714285716,3.3877551020408165,1.1023809523809522,2.34375,
675,1,1,0,0,1,1,1,2,1,0.0,1.0,0.0,0.0,0.0,0.0,
1180,1,1,0,0,1,1,1,2,1,0.0,1.0,0.0,0.0,0.0,0.0,
1250,1,0,0,1,1,1,1,2,1,0.0,1.0,0.0,0.0,0.0,0.0,
847,1,2,0,1,1,3,1,4,3,100.0,0.3333333333333333,1.0,0.0,0.0,1.5,
875,3,1,0,1,3,2,3,5,4,163.0,1.5,2.5,0.25,1.0,0.875,
46,1,2,2,0,3,2,2,5,4,35.0,1.5,2.0,0.0,0.6666666666666666,1.0,
1122,4,6,0,0,4,6,3,10,9,182.0,0.6666666666666666,2.5,0.25,1.1666666666666665,2.625,
1051,1,1,0,0,1,1,1,2,1,0.0,1.0,0.0,0.0,0.0,0.0,
626,1,1,0,0,1,1,1,2,1,0.0,1.0,0.0,0.0,0.0,0.0,
1016,1,1,0,1,1,2,1,3,2,61.0,0.5,1.0,0.0,0.0,1.0,
781,2,0,0,1,2,1,2,3,2,16.0,2.0,2.0,0.0,1.0,0.5,
1393,1,1,0,0,1,1,1,2,1,0.0,1.0,0.0,0.0,0.0,0.0,
1515,1,1,0,0,1,1,1,2,1,0.0,1.0,0.0,0.0,0.0,0.0,
421,1,0,0,2,1,2,1,3,2,28.0,0.5,1.0,0.0,0.0,1.0,
1636,1,1,0,0,1,1,1,2,1,0.0,1.0,0.0,0.0,0.0,0.0,
1643,1,1,0,0,1,1,1,2,1,0.0,1.0,0.0,0.0,0.0,0.0,
523,1,0,0,1,1,1,1,2,1,0.0,1.0,0.0,0.0,0.0,0.0,
548,1,1,0,1,1,2,1,3,2,1.0,0.5,1.0,0.0,0.0,1.0,
835,2,4,0,1,2,5,2,7,6,132.0,0.4,1.2,0.16,0.5,2.5,
984,2,2,0,1,2,3,2,5,4,51.0,0.6666666666666666,1.6666666666666667,0.2222222222222222,0.5,1.5,
638,0,1,1,0,1,1,1,2,1,0.0,1.0,0.0,0.0,0.0,0.0,
107,3,3,1,0,4,3,4,7,6,99.0,1.3333333333333333,2.3333333333333335,1.5555555555555554,0.9166666666666666,1.25,
777,1,2,0,0,1,2,1,3,2,47.0,0.5,1.0,0.0,0.0,1.0,
1345,1,1,0,0,1,1,1,2,1,0.0,1.0,0.0,0.0,0.0,0.0,
467,1,1,0,0,1,1,1,2,1,0.0,1.0,0.0,0.0,0.0,0.0,
1464,2,2,0,0,2,2,2,4,3,69.0,1.0,2.0,0.0,1.0,1.0,
114,41,29,1,10,42,39,7,81,80,411.0,1.0769230769230769,4.17948717948718,2.660092044707429,4.268614718614719,10.40625,
1572,1,1,0,0,1,1,1,2,1,0.0,1.0,0.0,0.0,0.0,0.0,
880,1,1,0,0,1,1,1,2,1,0.0,1.0,0.0,0.0,0.0,0.0,
429,1,0,0,1,1,1,1,2,1,0.0,1.0,0.0,0.0,0.0,0.0,
897,3,1,0,0,3,1,3,4,3,82.0,3.0,3.0,0.0,1.5,0.375,
558,6,8,0,0,6,8,4,14,13,224.0,0.75,2.875,1.109375,1.4166666666666665,3.0,
1619,1,1,0,1,1,2,1,3,2,5.0,0.5,1.0,0.0,0.0,1.0,
1590,1,0,0,1,1,1,1,2,1,0.0,1.0,0.0,0.0,0.0,0.0,
1639,1,2,0,0,1,2,1,3,2,37.0,0.5,1.0,0.0,0.0,1.0,
1375,3,2,0,0,3,2,3,5,4,182.0,1.5,2.5,0.25,1.0,0.875,
619,4,3,0,4,4,7,2,11,10,134.0,0.5714285714285714,1.5714285714285714,0.24489795918367346,1.0,3.5,
754,1,1,1,0,2,1,2,3,2,30.0,2.0,2.0,0.0,1.0,0.5,
908,1,1,0,1,1,2,1,3,2,42.0,0.5,1.0,0.0,0.0,1.0,
226,1,0,0,2,1,2,1,3,2,30.0,0.5,1.0,0.0,0.0,1.0,
394,5,6,0,2,5,8,5,13,12,247.0,0.625,2.875,1.609375,1.0333333333333332,3.03125,
1609,1,1,0,1,1,2,1,3,2,34.0,0.5,1.0,0.0,0.0,1.0,
1080,4,2,0,0,4,2,4,6,5,123.0,2.0,2.5,2.25,0.9166666666666665,0.75,
155,1,2,1,1,2,3,2,5,4,57.0,0.6666666666666666,2.0,0.0,1.0,1.5,
1013,2,1,0,0,2,1,2,3,2,11.0,2.0,2.0,0.0,1.0,0.5,
841,1,3,0,1,1,4,1,5,4,319.0,0.25,1.0,0.0,0.0,2.0,
92,9,7,1,2,10,9,7,19,18,348.0,1.1111111111111112,3.5555555555555554,3.580246913580247,1.4357142857142857,2.7421875,
607,2,1,0,0,2,1,2,3,2,19.0,2.0,2.0,0.0,1.0,0.5,
616,1,2,0,0,1,2,1,3,2,8.0,0.5,1.0,0.0,0.0,1.0,
370,3,1,0,1,3,2,3,5,4,91.0,1.5,2.0,1.0,0.8333333333333333,0.875,
72,0,1,2,1,2,2,2,4,3,198.0,1.0,2.0,0.0,1.0,1.0,
1520,1,3,0,0,1,3,1,4,3,30.0,0.3333333333333333,1.0,0.0,0.0,1.5,
1117,3,2,0,0,3,2,3,5,4,53.0,1.5,2.5,0.25,1.0,0.875,
234,1,0,0,1,1,1,1,2,1,0.0,1.0,0.0,0.0,0.0,0.0,
1459,2,0,0,1,2,1,2,3,2,24.0,2.0,2.0,0.0,1.0,0.5,
717,1,1,0,0,1,1,1,2,1,0.0,1.0,0.0,0.0,0.0,0.0,
1152,1,1,0,0,1,1,1,2,1,0.0,1.0,0.0,0.0,0.0,0.0,
809,1,5,0,1,1,6,1,7,6,128.0,0.16666666666666666,1.0,0.0,0.0,3.0,
818,1,2,0,1,1,3,1,4,3,16.0,0.3333333333333333,1.0,0.0,0.0,1.5,
889,1,2,0,0,1,2,1,3,2,20.0,0.5,1.0,0.0,0.0,1.0,
1165,1,1,0,1,1,2,1,3,2,63.0,0.5,1.0,0.0,0.0,1.0,
1389,1,1,0,0,1,1,1,2,1,0.0,1.0,0.0,0.0,0.0,0.0,
1068,2,2,0,0,2,2,2,4,3,80.0,1.0,1.5,0.25,0.5,1.0,
128,0,1,1,0,1,1,1,2,1,0.0,1.0,0.0,0.0,0.0,0.0,
1160,1,0,0,1,1,1,1,2,1,0.0,1.0,0.0,0.0,0.0,0.0,
708,1,1,0,0,1,1,1,2,1,0.0,1.0,0.0,0.0,0.0,0.0,
1650,1,1,0,0,1,1,1,2,1,0.0,1.0,0.0,0.0,0.0,0.0,
1644,1,1,0,0,1,1,1,2,1,0.0,1.0,0.0,0.0,0.0,0.0,
1042,1,1,0,0,1,1,1,2,1,0.0,1.0,0.0,0.0,0.0,0.0,
1392,1,1,0,0,1,1,1,2,1,0.0,1.0,0.0,0.0,0.0,0.0,
1237,1,2,0,0,1,2,1,3,2,2.0,0.5,1.0,0.0,0.0,1.0,
976,1,1,0,0,1,1,1,2,1,0.0,1.0,0.0,0.0,0.0,0.0,
839,1,1,0,0,1,1,1,2,1,0.0,1.0,0.0,0.0,0.0,0.0,
1158,1,1,0,0,1,1,1,2,1,0.0,1.0,0.0,0.0,0.0,0.0,
1181,1,2,0,0,1,2,1,3,2,61.0,0.5,1.0,0.0,0.0,1.0,
904,2,3,0,1,2,4,2,6,5,118.0,0.5,1.25,0.1875,0.5,2.0,
392,4,1,0,2,4,3,3,7,6,211.0,1.3333333333333333,2.3333333333333335,0.8888888888888888,1.1666666666666665,1.25,
1103,4,1,0,2,4,3,4,7,6,23.0,1.3333333333333333,3.3333333333333335,0.22222222222222224,1.3333333333333333,1.0,
783,1,1,0,0,1,1,1,2,1,0.0,1.0,0.0,0.0,0.0,0.0,
1010,2,4,0,2,2,6,2,8,7,206.0,0.3333333333333333,1.3333333333333333,0.22222222222222224,0.5,3.0,
1456,1,1,0,0,1,1,1,2,1,0.0,1.0,0.0,0.0,0.0,0.0,
178,1,1,1,0,2,1,2,3,2,39.0,2.0,2.0,0.0,1.0,0.5,
481,4,2,0,2,4,4,3,8,7,110.0,1.0,2.0,0.5,0.8333333333333333,1.875,
513,1,0,0,1,1,1,1,2,1,0.0,1.0,0.0,0.0,0.0,0.0,
1157,1,0,0,1,1,1,1,2,1,0.0,1.0,0.0,0.0,0.0,0.0,
1467,1,2,0,0,1,2,1,3,2,13.0,0.5,1.0,0.0,0.0,1.0,
1140,1,0,0,1,1,1,1,2,1,0.0,1.0,0.0,0.0,0.0,0.0,
635,2,1,0,0,2,1,2,3,2,6.0,2.0,2.0,0.0,1.0,0.5,
895,2,1,0,0,2,1,2,3,2,9.0,2.0,2.0,0.0,1.0,0.5,
416,1,2,0,1,1,3,1,4,3,43.0,0.3333333333333333,1.0,0.0,0.0,1.5,
544,2,3,0,0,2,3,2,5,4,73.0,0.6666666666666666,1.3333333333333333,0.2222222222222222,0.5,1.5,
519,1,1,0,0,1,1,1,2,1,0.0,1.0,0.0,0.0,0.0,0.0,
476,1,1,0,0,1,1,1,2,1,0.0,1.0,0.0,0.0,0.0,0.0,
16,3,5,1,1,4,6,3,10,9,83.0,0.6666666666666666,1.8333333333333333,0.8055555555555557,0.8333333333333333,2.75,
1424,1,1,0,0,1,1,1,2,1,0.0,1.0,0.0,0.0,0.0,0.0,
1257,1,1,0,0,1,1,1,2,1,0.0,1.0,0.0,0.0,0.0,0.0,
441,1,2,0,2,1,4,1,5,4,240.0,0.25,1.0,0.0,0.0,2.0,
145,11,13,1,3,12,16,5,28,27,162.0,0.75,3.1875,1.15234375,1.6464285714285714,5.53125,
83,1,2,1,0,2,2,2,4,3,106.0,1.0,2.0,0.0,1.0,1.0,
905,2,1,0,0,2,1,2,3,2,10.0,2.0,2.0,0.0,1.0,0.5,
235,5,2,0,2,5,4,4,9,8,165.0,1.25,2.75,1.1875,1.1666666666666665,1.5,
297,8,7,0,3,8,10,7,18,17,175.0,0.8,3.4,2.8400000000000003,1.2690476190476192,3.3671875,
711,1,2,0,0,1,2,1,3,2,28.0,0.5,1.0,0.0,0.0,1.0,
24,4,1,1,2,5,3,4,8,7,145.0,1.6666666666666667,3.6666666666666665,0.22222222222222224,1.1666666666666665,0.875,
143,0,3,1,0,1,3,1,4,3,22.0,0.3333333333333333,1.0,0.0,0.0,1.5,
610,3,4,0,0,3,4,3,7,6,230.0,0.75,1.75,0.6875,0.8333333333333333,1.875,
1147,1,1,0,0,1,1,1,2,1,0.0,1.0,0.0,0.0,0.0,0.0,
636,1,2,0,0,1,2,1,3,2,60.0,0.5,1.0,0.0,0.0,1.0,
811,1,1,0,0,1,1,1,2,1,0.0,1.0,0.0,0.0,0.0,0.0,
1282,1,0,0,2,1,2,1,3,2,163.0,0.5,1.0,0.0,0.0,1.0,
390,1,1,0,0,1,1,1,2,1,0.0,1.0,0.0,0.0,0.0,0.0,
983,4,1,0,1,4,2,4,6,5,84.0,2.0,3.5,0.25,1.3333333333333333,0.625,
265,2,2,0,0,2,2,2,4,3,47.0,1.0,1.5,0.25,0.5,1.0,
182,10,6,1,3,11,9,7,20,19,227.0,1.2222222222222223,4.888888888888889,4.54320987654321,1.9666666666666666,2.0078125,
1018,2,3,0,0,2,3,2,5,4,77.0,0.6666666666666666,2.0,0.0,1.0,1.5,
888,6,5,0,3,6,8,4,14,13,264.0,0.75,3.0,0.25,1.4166666666666665,3.0,
501,1,0,0,1,1,1,1,2,1,0.0,1.0,0.0,0.0,0.0,0.0,
762,2,1,0,0,2,1,2,3,2,41.0,2.0,2.0,0.0,1.0,0.5,
140,4,3,1,3,5,6,5,11,10,266.0,0.8333333333333334,4.333333333333333,0.22222222222222224,1.5833333333333333,1.3125,
671,3,6,0,2,3,8,3,11,10,88.0,0.375,1.875,0.609375,0.8333333333333333,3.75,
592,5,2,0,2,5,4,3,9,8,259.0,1.25,2.5,0.25,0.9,1.75,
1022,1,0,0,1,1,1,1,2,1,0.0,1.0,0.0,0.0,0.0,0.0,
971,4,4,0,1,4,5,3,9,8,175.0,0.8,2.0,0.4,0.8333333333333333,2.375,
1500,1,1,0,1,1,2,1,3,2,20.0,0.5,1.0,0.0,0.0,1.0,
1214,3,0,0,1,3,1,3,4,3,39.0,3.0,3.0,0.0,1.5,0.375,
560,1,1,0,0,1,1,1,2,1,0.0,1.0,0.0,0.0,0.0,0.0,
743,1,1,0,1,1,2,1,3,2,34.0,0.5,1.0,0.0,0.0,1.0,
765,5,3,0,0,5,3,4,8,7,66.0,1.6666666666666667,2.6666666666666665,1.5555555555555556,1.1666666666666665,1.125,
692,1,1,0,0,1,1,1,2,1,0.0,1.0,0.0,0.0,0.0,0.0,
289,1,1,0,0,1,1,1,2,1,0.0,1.0,0.0,0.0,0.0,0.0,
1211,1,1,0,0,1,1,1,2,1,0.0,1.0,0.0,0.0,0.0,0.0,
598,2,3,0,2,2,5,2,7,6,103.0,0.4,1.2,0.16,0.5,2.5,
1550,1,0,0,1,1,1,1,2,1,0.0,1.0,0.0,0.0,0.0,0.0,
981,2,1,0,0,2,1,2,3,2,16.0,2.0,2.0,0.0,1.0,0.5,
518,2,2,0,1,2,3,2,5,4,148.0,0.6666666666666666,1.3333333333333333,0.2222222222222222,0.5,1.5,
838,1,1,0,0,1,1,1,2,1,0.0,1.0,0.0,0.0,0.0,0.0,
1318,1,0,0,1,1,1,1,2,1,0.0,1.0,0.0,0.0,0.0,0.0,
1407,1,1,0,0,1,1,1,2,1,0.0,1.0,0.0,0.0,0.0,0.0,
1667,1,1,0,0,1,1,1,2,1,0.0,1.0,0.0,0.0,0.0,0.0,
729,1,0,0,1,1,1,1,2,1,0.0,1.0,0.0,0.0,0.0,0.0,
393,1,1,0,0,1,1,1,2,1,0.0,1.0,0.0,0.0,0.0,0.0,
1253,1,1,0,0,1,1,1,2,1,0.0,1.0,0.0,0.0,0.0,0.0,
682,1,1,0,0,1,1,1,2,1,0.0,1.0,0.0,0.0,0.0,0.0,
121,3,5,2,0,5,5,3,10,9,94.0,1.0,2.2,0.5599999999999999,1.0833333333333333,2.25,
460,1,2,0,0,1,2,1,3,2,21.0,0.5,1.0,0.0,0.0,1.0,
1270,1,2,0,0,1,2,1,3,2,27.0,0.5,1.0,0.0,0.0,1.0,
434,1,2,0,0,1,2,1,3,2,31.0,0.5,1.0,0.0,0.0,1.0,
668,2,0,0,2,2,2,2,4,3,24.0,1.0,2.0,0.0,1.0,1.0,
93,5,7,1,0,6,7,5,13,12,194.0,0.8571428571428571,3.5714285714285716,1.1020408163265307,1.0333333333333334,2.15625,
1435,1,0,0,1,1,1,1,2,1,0.0,1.0,0.0,0.0,0.0,0.0,
1186,1,1,0,0,1,1,1,2,1,0.0,1.0,0.0,0.0,0.0,0.0,
202,0,1,1,0,1,1,1,2,1,0.0,1.0,0.0,0.0,0.0,0.0,
363,1,1,0,0,1,1,1,2,1,0.0,1.0,0.0,0.0,0.0,0.0,
1094,1,0,0,1,1,1,1,2,1,0.0,1.0,0.0,0.0,0.0,0.0,
510,2,0,0,1,2,1,2,3,2,14.0,2.0,2.0,0.0,1.0,0.5,
472,1,1,0,0,1,1,1,2,1,0.0,1.0,0.0,0.0,0.0,0.0,
651,1,0,0,1,1,1,1,2,1,0.0,1.0,0.0,0.0,0.0,0.0,
556,1,1,0,0,1,1,1,2,1,0.0,1.0,0.0,0.0,0.0,0.0,
703,1,1,0,0,1,1,1,2,1,0.0,1.0,0.0,0.0,0.0,0.0,
1232,4,5,0,3,4,8,4,12,11,176.0,0.5,2.625,1.234375,0.9166666666666665,3.125,
317,1,0,0,2,1,2,1,3,2,3.0,0.5,1.0,0.0,0.0,1.0,
736,1,1,0,0,1,1,1,2,1,0.0,1.0,0.0,0.0,0.0,0.0,
158,3,2,1,1,4,3,4,7,6,107.0,1.3333333333333333,2.0,2.0,0.9166666666666665,1.25,
1547,1,1,0,0,1,1,1,2,1,0.0,1.0,0.0,0.0,0.0,0.0,
1003,2,1,0,0,2,1,2,3,2,7.0,2.0,2.0,0.0,1.0,0.5,
1580,1,1,0,0,1,1,1,2,1,0.0,1.0,0.0,0.0,0.0,0.0,
303,1,1,0,0,1,1,1,2,1,0.0,1.0,0.0,0.0,0.0,0.0,
219,5,3,1,3,6,6,5,12,11,284.0,1.0,3.5,1.25,1.2333333333333332,1.9375,
319,1,0,0,1,1,1,1,2,1,0.0,1.0,0.0,0.0,0.0,0.0,
1124,4,4,0,0,4,4,4,8,7,154.0,1.0,3.25,1.6875,0.9166666666666666,1.25,
1358,5,1,0,1,5,2,5,7,6,368.0,2.5,4.0,1.0,1.4166666666666665,0.53125,
955,1,1,0,0,1,1,1,2,1,0.0,1.0,0.0,0.0,0.0,0.0,
1355,2,0,0,1,2,1,2,3,2,31.0,2.0,2.0,0.0,1.0,0.5,
879,1,1,1,1,2,2,2,4,3,12.0,1.0,2.0,0.0,1.0,1.0,
850,1,1,0,0,1,1,1,2,1,0.0,1.0,0.0,0.0,0.0,0.0,
386,1,1,0,0,1,1,1,2,1,0.0,1.0,0.0,0.0,0.0,0.0,
1402,1,1,0,0,1,1,1,2,1,0.0,1.0,0.0,0.0,0.0,0.0,
160,0,1,2,0,2,1,2,3,2,2.0,2.0,2.0,0.0,1.0,0.5,
1231,2,1,0,0,2,1,2,3,2,13.0,2.0,2.0,0.0,1.0,0.5,
830,3,3,0,0,3,3,3,6,5,124.0,1.0,1.6666666666666667,0.888888888888889,0.8333333333333333,1.375,
900,1,1,0,0,1,1,1,2,1,0.0,1.0,0.0,0.0,0.0,0.0,
197,28,20,1,11,29,31,10,60,59,518.0,0.9354838709677419,7.161290322580645,6.6514047866805415,2.7523171273171276,3.2578125,
779,1,1,0,1,1,2,1,3,2,107.0,0.5,1.0,0.0,0.0,1.0,
824,1,1,0,0,1,1,1,2,1,0.0,1.0,0.0,0.0,0.0,0.0,
1554,1,0,0,1,1,1,1,2,1,0.0,1.0,0.0,0.0,0.0,0.0,
887,2,3,0,0,2,3,2,5,4,35.0,0.6666666666666666,1.6666666666666667,0.2222222222222222,0.5,1.5,
338,1,1,0,0,1,1,1,2,1,0.0,1.0,0.0,0.0,0.0,0.0,
1676,1,2,0,0,1,2,1,3,2,0.0,0.5,1.0,0.0,0.0,1.0,
408,1,1,0,0,1,1,1,2,1,0.0,1.0,0.0,0.0,0.0,0.0,
85,1,2,1,1,2,3,2,5,4,59.0,0.6666666666666666,1.3333333333333333,0.2222222222222222,0.5,1.5,
1542,0,0,1,1,1,1,1,2,1,0.0,1.0,0.0,0.0,0.0,0.0,
810,2,4,1,1,3,5,3,8,7,201.0,0.6,2.2,0.5599999999999999,0.8333333333333333,2.25,
2,0,1,1,0,1,1,1,2,1,0.0,1.0,0.0,0.0,0.0,0.0,
935,1,3,0,0,1,3,1,4,3,25.0,0.3333333333333333,1.0,0.0,0.0,1.5,
1023,1,0,0,1,1,1,1,2,1,0.0,1.0,0.0,0.0,0.0,0.0,
1581,2,1,0,0,2,1,2,3,2,205.0,2.0,2.0,0.0,1.0,0.5,
210,1,3,1,0,2,3,2,5,4,50.0,0.6666666666666666,1.3333333333333333,0.2222222222222222,0.5,1.5,
1598,1,0,1,1,2,1,2,3,2,15.0,2.0,2.0,0.0,1.0,0.5,
1583,1,0,0,1,1,1,1,2,1,0.0,1.0,0.0,0.0,0.0,0.0,
133,17,17,1,3,18,20,7,38,37,268.0,0.9,3.95,1.3475000000000001,1.9445526695526696,5.4609375,
1156,2,1,0,1,2,2,2,4,3,43.0,1.0,1.5,0.25,0.5,1.0,
1020,4,1,0,2,4,3,4,7,6,128.0,1.3333333333333333,3.3333333333333335,0.22222222222222224,1.3333333333333333,1.0,
1319,1,3,0,1,1,4,1,5,4,116.0,0.25,1.0,0.0,0.0,2.0,
1090,3,3,1,0,4,3,4,7,6,136.0,1.3333333333333333,2.6666666666666665,0.8888888888888888,1.1666666666666665,1.25,
1629,2,3,0,1,2,4,2,6,5,121.0,0.5,1.5,0.25,0.5,2.0,
1511,1,1,0,0,1,1,1,2,1,0.0,1.0,0.0,0.0,0.0,0.0,
1366,1,0,0,1,1,1,1,2,1,0.0,1.0,0.0,0.0,0.0,0.0,
1285,1,1,0,1,1,2,1,3,2,45.0,0.5,1.0,0.0,0.0,1.0,
907,3,1,0,1,3,2,3,5,4,64.0,1.5,2.0,1.0,0.8333333333333333,0.875,
1235,2,2,0,1,2,3,2,5,4,125.0,0.6666666666666666,1.6666666666666667,0.2222222222222222,0.5,1.5,
1641,1,2,0,0,1,2,1,3,2,29.0,0.5,1.0,0.0,0.0,1.0,
1438,1,0,0,1,1,1,1,2,1,0.0,1.0,0.0,0.0,0.0,0.0,
1688,0,0,1,1,1,1,1,2,1,0.0,1.0,0.0,0.0,0.0,0.0,
842,1,0,0,1,1,1,1,2,1,0.0,1.0,0.0,0.0,0.0,0.0,
334,1,0,0,1,1,1,1,2,1,0.0,1.0,0.0,0.0,0.0,0.0,
1073,1,0,0,1,1,1,1,2,1,0.0,1.0,0.0,0.0,0.0,0.0,
1346,1,1,0,1,1,2,1,3,2,49.0,0.5,1.0,0.0,0.0,1.0,
604,1,1,0,0,1,1,1,2,1,0.0,1.0,0.0,0.0,0.0,0.0,
996,1,3,0,1,1,4,1,5,4,118.0,0.25,1.0,0.0,0.0,2.0,
1272,1,0,0,1,1,1,1,2,1,0.0,1.0,0.0,0.0,0.0,0.0,
9,0,1,1,0,1,1,1,2,1,0.0,1.0,0.0,0.0,0.0,0.0,
63,0,1,1,0,1,1,1,2,1,0.0,1.0,0.0,0.0,0.0,0.0,
901,1,0,0,1,1,1,1,2,1,0.0,1.0,0.0,0.0,0.0,0.0,
1606,1,1,0,0,1,1,1,2,1,0.0,1.0,0.0,0.0,0.0,0.0,
965,2,1,0,0,2,1,2,3,2,96.0,2.0,2.0,0.0,1.0,0.5,
1477,1,2,0,0,1,2,1,3,2,43.0,0.5,1.0,0.0,0.0,1.0,
770,1,2,0,0,1,2,1,3,2,28.0,0.5,1.0,0.0,0.0,1.0,
1131,1,1,0,0,1,1,1,2,1,0.0,1.0,0.0,0.0,0.0,0.0,
230,4,1,0,1,4,2,4,6,5,296.0,2.0,4.0,0.0,1.8333333333333333,0.5,
1457,1,1,0,0,1,1,1,2,1,0.0,1.0,0.0,0.0,0.0,0.0,
1450,2,1,0,0,2,1,2,3,2,20.0,2.0,2.0,0.0,1.0,0.5,
1072,0,1,1,0,1,1,1,2,1,0.0,1.0,0.0,0.0,0.0,0.0,
1190,1,3,0,0,1,3,1,4,3,141.0,0.3333333333333333,1.0,0.0,0.0,1.5,
1410,1,1,0,0,1,1,1,2,1,0.0,1.0,0.0,0.0,0.0,0.0,
994,1,1,0,0,1,1,1,2,1,0.0,1.0,0.0,0.0,0.0,0.0,
1333,1,1,0,0,1,1,1,2,1,0.0,1.0,0.0,0.0,0.0,0.0,
400,5,4,0,1,5,5,4,10,9,120.0,1.0,2.8,1.3599999999999999,1.1666666666666665,1.875,
798,1,4,0,0,1,4,1,5,4,124.0,0.25,1.0,0.0,0.0,2.0,
426,1,2,0,0,1,2,1,3,2,7.0,0.5,1.0,0.0,0.0,1.0,
854,1,1,0,1,1,2,1,3,2,50.0,0.5,1.0,0.0,0.0,1.0,
281,1,0,0,1,1,1,1,2,1,0.0,1.0,0.0,0.0,0.0,0.0,
183,0,1,1,0,1,1,1,2,1,0.0,1.0,0.0,0.0,0.0,0.0,
617,8,6,0,3,8,9,5,17,16,210.0,0.8888888888888888,2.888888888888889,0.7654320987654322,1.2119047619047618,3.53125,
584,1,2,0,0,1,2,1,3,2,11.0,0.5,1.0,0.0,0.0,1.0,
1340,2,3,0,0,2,3,2,5,4,183.0,0.6666666666666666,1.3333333333333333,0.2222222222222222,0.5,1.5,
1260,1,1,0,0,1,1,1,2,1,0.0,1.0,0.0,0.0,0.0,0.0,
469,6,3,0,2,6,5,6,11,10,335.0,1.2,3.2,2.96,1.0666666666666667,1.71875,
1470,2,0,0,1,2,1,2,3,2,11.0,2.0,2.0,0.0,1.0,0.5,
1663,1,1,0,0,1,1,1,2,1,0.0,1.0,0.0,0.0,0.0,0.0,
59,4,6,1,2,5,8,3,13,12,180.0,0.625,2.25,0.4375,1.0833333333333333,3.625,
246,5,4,0,2,5,6,4,11,10,146.0,0.8333333333333334,2.3333333333333335,1.2222222222222223,0.9833333333333334,2.5,
640,4,2,0,3,4,5,3,9,8,244.0,0.8,2.0,0.4,0.8333333333333333,2.375,
1293,3,0,0,1,3,1,3,4,3,18.0,3.0,3.0,0.0,1.5,0.375,
6,0,1,1,0,1,1,1,2,1,0.0,1.0,0.0,0.0,0.0,0.0,
866,2,2,0,1,2,3,2,5,4,153.0,0.6666666666666666,1.6666666666666667,0.2222222222222222,0.5,1.5,
150,0,1,1,0,1,1,1,2,1,0.0,1.0,0.0,0.0,0.0,0.0,
1284,3,3,0,2,3,5,2,8,7,112.0,0.6,1.6,0.24,0.6666666666666666,2.5,
404,1,2,0,0,1,2,1,3,2,21.0,0.5,1.0,0.0,0.0,1.0,
1571,1,0,0,1,1,1,1,2,1,0.0,1.0,0.0,0.0,0.0,0.0,
1483,1,1,0,0,1,1,1,2,1,0.0,1.0,0.0,0.0,0.0,0.0,
524,2,0,0,1,2,1,2,3,2,1.0,2.0,2.0,0.0,1.0,0.5,
1499,3,3,0,1,3,4,2,7,6,156.0,0.75,1.75,0.1875,0.6666666666666666,2.0,
1361,2,2,0,0,2,2,2,4,3,12.0,1.0,2.0,0.0,1.0,1.0,
1112,3,2,0,0,3,2,3,5,4,37.0,1.5,2.0,1.0,0.8333333333333333,0.875,
152,11,8,1,5,12,13,7,25,24,167.0,0.9230769230769231,4.538461538461538,2.4023668639053253,1.7214285714285715,2.9609375,
678,1,0,0,1,1,1,1,2,1,0.0,1.0,0.0,0.0,0.0,0.0,
934,1,1,0,0,1,1,1,2,1,0.0,1.0,0.0,0.0,0.0,0.0,
871,1,1,0,0,1,1,1,2,1,0.0,1.0,0.0,0.0,0.0,0.0,
822,3,1,0,0,3,1,3,4,3,62.0,3.0,3.0,0.0,1.5,0.375,
259,3,4,0,1,3,5,3,8,7,111.0,0.6,2.2,0.5599999999999999,0.8333333333333333,2.25,
536,1,1,0,1,1,2,1,3,2,2.0,0.5,1.0,0.0,0.0,1.0,
1603,1,1,0,0,1,1,1,2,1,0.0,1.0,0.0,0.0,0.0,0.0,
245,26,28,0,12,26,40,8,66,65,743.0,0.65,4.075,3.6193749999999993,2.4853396603396605,11.5546875,
577,1,1,0,0,1,1,1,2,1,0.0,1.0,0.0,0.0,0.0,0.0,
896,2,3,0,0,2,3,2,5,4,70.0,0.6666666666666666,1.6666666666666667,0.2222222222222222,0.5,1.5,
1052,3,2,0,1,3,3,3,6,5,164.0,1.0,2.3333333333333335,0.22222222222222224,1.0,1.375,
726,1,0,0,1,1,1,1,2,1,0.0,1.0,0.0,0.0,0.0,0.0,
21,0,1,1,0,1,1,1,2,1,0.0,1.0,0.0,0.0,0.0,0.0,
427,2,0,0,1,2,1,2,3,2,142.0,2.0,2.0,0.0,1.0,0.5,
1544,1,0,0,1,1,1,1,2,1,0.0,1.0,0.0,0.0,0.0,0.0,
877,1,1,0,1,1,2,1,3,2,21.0,0.5,1.0,0.0,0.0,1.0,
1017,1,1,0,0,1,1,1,2,1,0.0,1.0,0.0,0.0,0.0,0.0,
1104,1,1,0,0,1,1,1,2,1,0.0,1.0,0.0,0.0,0.0,0.0,
1398,0,1,1,1,1,2,1,3,2,50.0,0.5,1.0,0.0,0.0,1.0,
948,1,1,0,0,1,1,1,2,1,0.0,1.0,0.0,0.0,0.0,0.0,
1030,1,0,0,1,1,1,1,2,1,0.0,1.0,0.0,0.0,0.0,0.0,
858,1,1,0,0,1,1,1,2,1,0.0,1.0,0.0,0.0,0.0,0.0,
87,3,4,1,0,4,4,2,8,7,63.0,1.0,1.75,0.1875,1.0,2.0,
354,1,1,0,0,1,1,1,2,1,0.0,1.0,0.0,0.0,0.0,0.0,
715,1,1,0,0,1,1,1,2,1,0.0,1.0,0.0,0.0,0.0,0.0,
672,2,4,0,2,2,6,2,8,7,148.0,0.3333333333333333,1.5,0.25,0.5,3.0,
1289,4,1,0,0,4,1,4,5,4,98.0,4.0,4.0,0.0,1.8333333333333333,0.25,
1525,2,1,0,0,2,1,2,3,2,47.0,2.0,2.0,0.0,1.0,0.5,
489,0,2,1,0,1,2,1,3,2,3.0,0.5,1.0,0.0,0.0,1.0,
986,1,1,0,0,1,1,1,2,1,0.0,1.0,0.0,0.0,0.0,0.0,
57,7,6,1,0,8,6,4,14,13,181.0,1.3333333333333333,3.3333333333333335,0.2222222222222222,1.7333333333333332,2.0,
837,2,1,0,0,2,1,2,3,2,2.0,2.0,2.0,0.0,1.0,0.5,
252,1,1,0,0,1,1,1,2,1,0.0,1.0,0.0,0.0,0.0,0.0,
257,8,4,0,2,8,6,5,14,13,210.0,1.3333333333333333,2.8333333333333335,1.8055555555555554,1.4333333333333333,2.28125,
547,3,3,0,1,3,4,3,7,6,216.0,0.75,1.75,0.6875,0.8333333333333333,1.875,
96,43,28,3,7,46,35,13,81,80,480.0,1.3142857142857143,6.914285714285715,8.249795918367347,3.000649857538402,4.154541015625,
371,6,5,0,2,6,7,4,13,12,334.0,0.8571428571428571,2.7142857142857144,0.7755102040816327,1.4166666666666665,2.75,
890,1,1,0,0,1,1,1,2,1,0.0,1.0,0.0,0.0,0.0,0.0,
1062,1,0,0,1,1,1,1,2,1,0.0,1.0,0.0,0.0,0.0,0.0,
505,1,1,0,0,1,1,1,2,1,0.0,1.0,0.0,0.0,0.0,0.0,
1327,1,1,0,0,1,1,1,2,1,0.0,1.0,0.0,0.0,0.0,0.0,
279,3,3,0,0,3,3,2,6,5,132.0,1.0,2.0,0.0,0.6666666666666666,1.5,
119,0,1,1,0,1,1,1,2,1,0.0,1.0,0.0,0.0,0.0,0.0,
42,17,16,1,2,18,18,10,36,35,447.0,1.0,4.722222222222222,5.311728395061729,1.6963536463536462,4.220703125,
1163,4,2,0,0,4,2,4,6,5,55.0,2.0,2.5,2.25,0.9166666666666665,0.75,
68,10,8,1,2,11,10,7,21,20,343.0,1.1,3.9,2.0900000000000003,1.6023809523809525,2.8984375,
1627,3,3,0,0,3,3,3,6,5,44.0,1.0,2.3333333333333335,0.22222222222222224,1.0,1.375,
75,0,1,1,0,1,1,1,2,1,0.0,1.0,0.0,0.0,0.0,0.0,
1647,2,1,0,0,2,1,2,3,2,13.0,2.0,2.0,0.0,1.0,0.5,
84,0,1,1,0,1,1,1,2,1,0.0,1.0,0.0,0.0,0.0,0.0,
634,2,1,0,0,2,1,2,3,2,67.0,2.0,2.0,0.0,1.0,0.5,
1555,1,1,0,0,1,1,1,2,1,0.0,1.0,0.0,0.0,0.0,0.0,
805,1,2,0,0,1,2,1,3,2,30.0,0.5,1.0,0.0,0.0,1.0,
926,1,1,0,0,1,1,1,2,1,0.0,1.0,0.0,0.0,0.0,0.0,
503,1,1,0,0,1,1,1,2,1,0.0,1.0,0.0,0.0,0.0,0.0,
664,1,1,0,0,1,1,1,2,1,0.0,1.0,0.0,0.0,0.0,0.0,
1417,1,2,0,0,1,2,1,3,2,19.0,0.5,1.0,0.0,0.0,1.0,
418,2,2,0,0,2,2,2,4,3,32.0,1.0,1.5,0.25,0.5,1.0,
267,3,2,0,0,3,2,3,5,4,106.0,1.5,2.5,0.25,1.0,0.875,
910,2,0,0,1,2,1,2,3,2,93.0,2.0,2.0,0.0,1.0,0.5,
1096,1,1,0,0,1,1,1,2,1,0.0,1.0,0.0,0.0,0.0,0.0,
168,2,3,1,0,3,3,3,6,5,209.0,1.0,2.3333333333333335,0.22222222222222224,1.0,1.375,
55,1,0,1,1,2,1,2,3,2,7.0,2.0,2.0,0.0,1.0,0.5,
141,0,3,1,0,1,3,1,4,3,66.0,0.3333333333333333,1.0,0.0,0.0,1.5,
724,1,1,0,1,1,2,1,3,2,77.0,0.5,1.0,0.0,0.0,1.0,
1416,4,4,0,0,4,4,3,8,7,143.0,1.0,2.0,0.5,0.8333333333333333,1.875,
1123,2,1,0,1,2,2,2,4,3,92.0,1.0,2.0,0.0,1.0,1.0,
1561,2,2,0,0,2,2,2,4,3,43.0,1.0,1.5,0.25,0.5,1.0,
1553,2,1,0,0,2,1,2,3,2,14.0,2.0,2.0,0.0,1.0,0.5,
738,2,2,0,0,2,2,2,4,3,152.0,1.0,2.0,0.0,1.0,1.0,
1049,1,1,0,0,1,1,1,2,1,0.0,1.0,0.0,0.0,0.0,0.0,
1377,1,2,0,0,1,2,1,3,2,55.0,0.5,1.0,0.0,0.0,1.0,
40,0,1,1,0,1,1,1,2,1,0.0,1.0,0.0,0.0,0.0,0.0,
1341,2,1,0,0,2,1,2,3,2,5.0,2.0,2.0,0.0,1.0,0.5,
229,2,4,0,0,2,4,2,6,5,71.0,0.5,1.75,0.1875,0.5,2.0,
237,9,8,0,3,9,11,7,20,19,186.0,0.8181818181818182,3.6363636363636362,3.6859504132231407,1.292857142857143,3.359375,
161,1,1,1,0,2,1,2,3,2,29.0,2.0,2.0,0.0,1.0,0.5,
1208,1,1,0,0,1,1,1,2,1,0.0,1.0,0.0,0.0,0.0,0.0,
423,1,1,0,0,1,1,1,2,1,0.0,1.0,0.0,0.0,0.0,0.0,
1509,6,1,0,1,6,2,5,8,7,224.0,3.0,4.0,1.0,1.2333333333333334,0.53125,
931,1,1,0,0,1,1,1,2,1,0.0,1.0,0.0,0.0,0.0,0.0,
1582,1,4,0,2,1,6,1,7,6,202.0,0.16666666666666666,1.0,0.0,0.0,3.0,
938,1,1,0,0,1,1,1,2,1,0.0,1.0,0.0,0.0,0.0,0.0,
1471,1,1,0,0,1,1,1,2,1,0.0,1.0,0.0,0.0,0.0,0.0,
1473,5,4,0,0,5,4,4,9,8,157.0,1.25,4.0,0.0,1.5,1.0,
727,1,0,0,1,1,1,1,2,1,0.0,1.0,0.0,0.0,0.0,0.0,
1570,1,1,0,0,1,1,1,2,1,0.0,1.0,0.0,0.0,0.0,0.0,
438,3,3,1,0,4,3,4,7,6,103.0,1.3333333333333333,2.6666666666666665,0.8888888888888888,1.1666666666666665,1.25,
1065,3,4,0,0,3,4,3,7,6,158.0,0.75,2.0,1.0,0.8333333333333333,1.75,
1276,2,2,0,0,2,2,2,4,3,100.0,1.0,2.0,0.0,1.0,1.0,
1126,3,3,0,0,3,3,3,6,5,97.0,1.0,2.0,0.6666666666666666,0.8333333333333333,1.375,
1617,2,1,0,0,2,1,2,3,2,56.0,2.0,2.0,0.0,1.0,0.5,
1495,1,0,0,1,1,1,1,2,1,0.0,1.0,0.0,0.0,0.0,0.0,
273,1,1,0,1,1,2,1,3,2,46.0,0.5,1.0,0.0,0.0,1.0,
808,5,1,0,3,5,4,3,9,8,99.0,1.25,2.0,1.0,0.8999999999999999,1.75,
496,1,1,0,0,1,1,1,2,1,0.0,1.0,0.0,0.0,0.0,0.0,
90,1,1,1,0,2,1,2,3,2,19.0,2.0,2.0,0.0,1.0,0.5,
864,1,1,0,0,1,1,1,2,1,0.0,1.0,0.0,0.0,0.0,0.0,
1189,1,1,0,0,1,1,1,2,1,0.0,1.0,0.0,0.0,0.0,0.0,
455,3,2,0,2,3,4,2,7,6,83.0,0.75,1.5,0.25,0.6666666666666666,2.0,
746,1,1,0,0,1,1,1,2,1,0.0,1.0,0.0,0.0,0.0,0.0,
492,2,1,0,0,2,1,2,3,2,20.0,2.0,2.0,0.0,1.0,0.5,
475,2,1,0,0,2,1,2,3,2,27.0,2.0,2.0,0.0,1.0,0.5,
201,1,0,1,1,2,1,2,3,2,2.0,2.0,2.0,0.0,1.0,0.5,
169,4,3,1,2,5,5,3,10,9,84.0,1.0,2.0,0.8,1.0833333333333333,2.25,
1414,1,1,0,0,1,1,1,2,1,0.0,1.0,0.0,0.0,0.0,0.0,
351,1,1,0,1,1,2,1,3,2,16.0,0.5,1.0,0.0,0.0,1.0,
1420,1,1,0,0,1,1,1,2,1,0.0,1.0,0.0,0.0,0.0,0.0,
817,1,1,0,0,1,1,1,2,1,0.0,1.0,0.0,0.0,0.0,0.0,
116,1,1,1,0,2,1,2,3,2,11.0,2.0,2.0,0.0,1.0,0.5,
280,1,2,0,0,1,2,1,3,2,11.0,0.5,1.0,0.0,0.0,1.0,
801,1,2,0,0,1,2,1,3,2,16.0,0.5,1.0,0.0,0.0,1.0,
238,2,0,0,2,2,2,2,4,3,35.0,1.0,2.0,0.0,1.0,1.0,
760,4,2,0,3,4,5,4,9,8,299.0,0.8,3.2,0.15999999999999998,1.3333333333333333,1.75,
1413,1,1,0,1,1,2,1,3,2,10.0,0.5,1.0,0.0,0.0,1.0,
156,0,1,1,0,1,1,1,2,1,0.0,1.0,0.0,0.0,0.0,0.0,
936,4,4,0,0,4,4,3,8,7,213.0,1.0,2.5,0.25,1.1666666666666665,1.75,
933,1,1,0,0,1,1,1,2,1,0.0,1.0,0.0,0.0,0.0,0.0,
551,3,2,0,1,3,3,2,6,5,41.0,1.0,2.0,0.0,0.6666666666666666,1.5,
486,1,1,0,0,1,1,1,2,1,0.0,1.0,0.0,0.0,0.0,0.0,
687,3,2,0,1,3,3,2,6,5,124.0,1.0,1.6666666666666667,0.2222222222222222,0.6666666666666666,1.5,
1317,1,1,0,0,1,1,1,2,1,0.0,1.0,0.0,0.0,0.0,0.0,
1312,1,1,0,0,1,1,1,2,1,0.0,1.0,0.0,0.0,0.0,0.0,
1557,2,2,0,0,2,2,2,4,3,52.0,1.0,1.5,0.25,0.5,1.0,
1307,1,1,0,0,1,1,1,2,1,0.0,1.0,0.0,0.0,0.0,0.0,
1066,8,11,0,0,8,11,4,19,18,517.0,0.7272727272727273,2.3636363636363638,1.140495867768595,1.7333333333333332,4.625,
1287,1,1,0,0,1,1,1,2,1,0.0,1.0,0.0,0.0,0.0,0.0,
300,2,1,0,0,2,1,2,3,2,48.0,2.0,2.0,0.0,1.0,0.5,
591,1,1,0,0,1,1,1,2,1,0.0,1.0,0.0,0.0,0.0,0.0,
1372,2,0,0,2,2,2,2,4,3,68.0,1.0,1.5,0.25,0.5,1.0,
923,2,1,0,0,2,1,2,3,2,52.0,2.0,2.0,0.0,1.0,0.5,
368,1,2,0,0,1,2,1,3,2,32.0,0.5,1.0,0.0,0.0,1.0,
757,6,4,1,2,7,6,5,13,12,256.0,1.1666666666666667,4.166666666666667,1.1388888888888886,1.6666666666666665,1.46875,
1244,1,2,0,0,1,2,1,3,2,103.0,0.5,1.0,0.0,0.0,1.0,
543,1,2,0,0,1,2,1,3,2,1.0,0.5,1.0,0.0,0.0,1.0,
336,1,0,0,1,1,1,1,2,1,0.0,1.0,0.0,0.0,0.0,0.0,
1303,4,4,0,1,4,5,4,9,8,240.0,0.8,2.4,1.0400000000000003,0.9166666666666665,2.125,
337,1,1,0,0,1,1,1,2,1,0.0,1.0,0.0,0.0,0.0,0.0,
95,0,2,1,0,1,2,1,3,2,48.0,0.5,1.0,0.0,0.0,1.0,
709,1,1,0,1,1,2,1,3,2,23.0,0.5,1.0,0.0,0.0,1.0,
1236,3,1,0,1,3,2,2,5,4,112.0,1.5,2.0,0.0,0.6666666666666666,1.0,
707,1,0,0,1,1,1,1,2,1,0.0,1.0,0.0,0.0,0.0,0.0,
1433,1,2,0,1,1,3,1,4,3,126.0,0.3333333333333333,1.0,0.0,0.0,1.5,
1359,4,2,0,3,4,5,3,9,8,195.0,0.8,2.0,0.8,1.1666666666666665,2.25,
980,1,1,0,0,1,1,1,2,1,0.0,1.0,0.0,0.0,0.0,0.0,
11,0,1,1,0,1,1,1,2,1,0.0,1.0,0.0,0.0,0.0,0.0,
310,2,1,0,0,2,1,2,3,2,28.0,2.0,2.0,0.0,1.0,0.5,
1204,2,1,0,0,2,1,2,3,2,8.0,2.0,2.0,0.0,1.0,0.5,
1648,1,0,0,2,1,2,1,3,2,108.0,0.5,1.0,0.0,0.0,1.0,
525,1,2,0,0,1,2,1,3,2,4.0,0.5,1.0,0.0,0.0,1.0,
430,7,5,0,1,7,6,4,13,12,204.0,1.1666666666666667,3.1666666666666665,0.8055555555555555,1.3833333333333333,2.125,
960,1,0,0,1,1,1,1,2,1,0.0,1.0,0.0,0.0,0.0,0.0,
1376,1,1,0,0,1,1,1,2,1,0.0,1.0,0.0,0.0,0.0,0.0,
1314,1,1,0,0,1,1,1,2,1,0.0,1.0,0.0,0.0,0.0,0.0,
488,1,2,0,0,1,2,1,3,2,12.0,0.5,1.0,0.0,0.0,1.0,
1215,2,3,0,1,2,4,2,6,5,147.0,0.5,1.5,0.25,0.5,2.0,
927,1,1,0,1,1,2,1,3,2,1.0,0.5,1.0,0.0,0.0,1.0,
670,1,2,0,0,1,2,1,3,2,49.0,0.5,1.0,0.0,0.0,1.0,
576,1,0,0,1,1,1,1,2,1,0.0,1.0,0.0,0.0,0.0,0.0,
1539,6,2,0,0,6,2,4,8,7,112.0,3.0,3.5,0.25,0.9833333333333333,0.625,
909,2,1,0,0,2,1,2,3,2,30.0,2.0,2.0,0.0,1.0,0.5,
1196,1,1,0,1,1,2,1,3,2,3.0,0.5,1.0,0.0,0.0,1.0,
963,1,2,0,0,1,2,1,3,2,14.0,0.5,1.0,0.0,0.0,1.0,
1524,1,1,0,1,1,2,1,3,2,79.0,0.5,1.0,0.0,0.0,1.0,
375,1,1,0,0,1,1,1,2,1,0.0,1.0,0.0,0.0,0.0,0.0,
1209,4,1,0,0,4,1,4,5,4,28.0,4.0,4.0,0.0,1.8333333333333333,0.25,
1600,3,2,0,0,3,2,3,5,4,190.0,1.5,2.0,1.0,0.8333333333333333,0.875,
718,0,1,1,0,1,1,1,2,1,0.0,1.0,0.0,0.0,0.0,0.0,
1241,2,2,0,0,2,2,2,4,3,42.0,1.0,2.0,0.0,1.0,1.0,
735,1,0,0,1,1,1,1,2,1,0.0,1.0,0.0,0.0,0.0,0.0,
958,1,2,0,0,1,2,1,3,2,19.0,0.5,1.0,0.0,0.0,1.0,
1114,1,1,0,0,1,1,1,2,1,0.0,1.0,0.0,0.0,0.0,0.0,
918,3,2,0,0,3,2,3,5,4,41.0,1.5,2.0,1.0,0.8333333333333333,0.875,
685,1,0,0,1,1,1,1,2,1,0.0,1.0,0.0,0.0,0.0,0.0,
734,1,1,0,0,1,1,1,2,1,0.0,1.0,0.0,0.0,0.0,0.0,
1602,1,1,0,0,1,1,1,2,1,0.0,1.0,0.0,0.0,0.0,0.0,
1601,4,3,0,0,4,3,4,7,6,375.0,1.3333333333333333,3.3333333333333335,0.8888888888888888,1.1666666666666665,1.0,
1169,1,1,0,0,1,1,1,2,1,0.0,1.0,0.0,0.0,0.0,0.0,
180,1,1,1,1,2,2,2,4,3,17.0,1.0,1.5,0.25,0.5,1.0,
979,1,1,0,0,1,1,1,2,1,0.0,1.0,0.0,0.0,0.0,0.0,
67,16,12,1,5,17,17,9,34,33,530.0,1.0,6.352941176470588,5.40484429065744,1.281299256299256,2.3359375,
1505,1,1,0,0,1,1,1,2,1,0.0,1.0,0.0,0.0,0.0,0.0,
138,0,1,1,0,1,1,1,2,1,0.0,1.0,0.0,0.0,0.0,0.0,
47,17,15,2,2,19,17,9,36,35,453.0,1.1176470588235294,6.9411764705882355,1.7024221453287192,2.178246753246753,1.21484375,
1488,3,2,0,0,3,2,3,5,4,52.0,1.5,2.5,0.25,1.0,0.875,
1077,1,1,0,0,1,1,1,2,1,0.0,1.0,0.0,0.0,0.0,0.0,
170,0,2,1,0,1,2,1,3,2,27.0,0.5,1.0,0.0,0.0,1.0,
582,1,0,0,1,1,1,1,2,1,0.0,1.0,0.0,0.0,0.0,0.0,
930,2,0,0,1,2,1,2,3,2,7.0,2.0,2.0,0.0,1.0,0.5,
1024,1,2,0,0,1,2,1,3,2,103.0,0.5,1.0,0.0,0.0,1.0,
1321,1,1,0,1,1,2,1,3,2,56.0,0.5,1.0,0.0,0.0,1.0,
187,0,0,1,1,1,1,1,2,1,0.0,1.0,0.0,0.0,0.0,0.0,
131,1,1,1,0,2,1,2,3,2,15.0,2.0,2.0,0.0,1.0,0.5,
464,1,1,0,0,1,1,1,2,1,0.0,1.0,0.0,0.0,0.0,0.0,
331,1,2,0,2,1,4,1,5,4,130.0,0.25,1.0,0.0,0.0,2.0,
228,2,2,0,0,2,2,2,4,3,137.0,1.0,1.5,0.25,0.5,1.0,
454,1,1,0,0,1,1,1,2,1,0.0,1.0,0.0,0.0,0.0,0.0,
1316,1,0,0,1,1,1,1,2,1,0.0,1.0,0.0,0.0,0.0,0.0,
1449,3,1,0,0,3,1,3,4,3,75.0,3.0,3.0,0.0,1.5,0.375,
264,1,1,0,0,1,1,1,2,1,0.0,1.0,0.0,0.0,0.0,0.0,
1611,1,1,0,0,1,1,1,2,1,0.0,1.0,0.0,0.0,0.0,0.0,
615,1,1,0,0,1,1,1,2,1,0.0,1.0,0.0,0.0,0.0,0.0,
771,2,1,0,0,2,1,2,3,2,22.0,2.0,2.0,0.0,1.0,0.5,
806,2,0,0,1,2,1,2,3,2,4.0,2.0,2.0,0.0,1.0,0.5,
928,2,1,0,0,2,1,2,3,2,51.0,2.0,2.0,0.0,1.0,0.5,
33,8,9,2,1,10,10,6,20,19,548.0,1.0,3.2,2.3599999999999994,1.4357142857142855,3.375,
15,1,4,1,0,2,4,2,6,5,136.0,0.5,1.75,0.1875,0.5,2.0,
443,1,1,0,0,1,1,1,2,1,0.0,1.0,0.0,0.0,0.0,0.0,
1403,1,1,0,0,1,1,1,2,1,0.0,1.0,0.0,0.0,0.0,0.0,
1069,1,1,0,0,1,1,1,2,1,0.0,1.0,0.0,0.0,0.0,0.0,
1448,1,1,0,0,1,1,1,2,1,0.0,1.0,0.0,0.0,0.0,0.0,
581,1,2,0,0,1,2,1,3,2,49.0,0.5,1.0,0.0,0.0,1.0,
1099,1,0,0,1,1,1,1,2,1,0.0,1.0,0.0,0.0,0.0,0.0,
1151,1,0,0,1,1,1,1,2,1,0.0,1.0,0.0,0.0,0.0,0.0,
1004,2,1,0,1,2,2,2,4,3,35.0,1.0,1.5,0.25,0.5,1.0,
1295,1,1,0,0,1,1,1,2,1,0.0,1.0,0.0,0.0,0.0,0.0,
1675,1,1,1,0,2,1,2,3,2,106.0,2.0,2.0,0.0,1.0,0.5,
419,3,4,0,0,3,4,3,7,6,51.0,0.75,2.25,0.1875,1.0,1.875,
1225,1,0,0,1,1,1,1,2,1,0.0,1.0,0.0,0.0,0.0,0.0,
1401,3,2,0,1,3,3,2,6,5,117.0,1.0,2.0,0.0,0.6666666666666666,1.5,
1608,3,4,0,1,3,5,3,8,7,178.0,0.6,2.6,0.6400000000000002,0.8333333333333333,2.0,
950,2,4,0,1,2,5,2,7,6,118.0,0.4,1.2,0.16,0.5,2.5,
311,4,2,0,4,4,6,3,10,9,149.0,0.6666666666666666,2.6666666666666665,0.2222222222222222,1.1666666666666665,2.5,
848,4,4,0,0,4,4,4,8,7,173.0,1.0,2.75,1.6875,0.9166666666666665,1.5,
571,4,1,0,1,4,2,3,6,5,23.0,2.0,3.0,0.0,1.1666666666666665,0.75,
868,1,1,0,0,1,1,1,2,1,0.0,1.0,0.0,0.0,0.0,0.0,
1657,5,6,1,2,6,8,4,14,13,294.0,0.75,1.875,0.859375,1.1833333333333333,3.75,
322,3,2,0,2,3,4,2,7,6,269.0,0.75,1.75,0.1875,0.6666666666666666,2.0,
1674,2,1,0,0,2,1,2,3,2,47.0,2.0,2.0,0.0,1.0,0.5,
1425,2,1,0,0,2,1,2,3,2,3.0,2.0,2.0,0.0,1.0,0.5,
1445,2,3,0,1,2,4,2,6,5,145.0,0.5,1.25,0.1875,0.5,2.0,
874,2,2,0,0,2,2,2,4,3,65.0,1.0,1.5,0.25,0.5,1.0,
627,5,2,0,3,5,5,4,10,9,218.0,1.0,3.8,0.15999999999999998,1.5,1.375,
1528,1,2,0,1,1,3,1,4,3,68.0,0.3333333333333333,1.0,0.0,0.0,1.5,
1535,1,1,0,0,1,1,1,2,1,0.0,1.0,0.0,0.0,0.0,0.0,
1086,1,0,0,1,1,1,1,2,1,0.0,1.0,0.0,0.0,0.0,0.0,
1047,3,3,0,0,3,3,3,6,5,172.0,1.0,2.3333333333333335,0.8888888888888888,0.8333333333333333,1.25,
1510,1,1,0,0,1,1,1,2,1,0.0,1.0,0.0,0.0,0.0,0.0,
776,1,1,0,0,1,1,1,2,1,0.0,1.0,0.0,0.0,0.0,0.0,
1059,1,2,0,0,1,2,1,3,2,12.0,0.5,1.0,0.0,0.0,1.0,
967,2,1,0,0,2,1,2,3,2,5.0,2.0,2.0,0.0,1.0,0.5,
645,5,1,0,0,5,1,5,6,5,125.0,5.0,5.0,0.0,2.083333333333333,0.15625,
1383,1,0,1,1,2,1,2,3,2,20.0,2.0,2.0,0.0,1.0,0.5,
773,1,1,0,0,1,1,1,2,1,0.0,1.0,0.0,0.0,0.0,0.0,
894,1,1,0,0,1,1,1,2,1,0.0,1.0,0.0,0.0,0.0,0.0,
1199,2,0,0,1,2,1,2,3,2,38.0,2.0,2.0,0.0,1.0,0.5,
1332,2,1,0,0,2,1,2,3,2,37.0,2.0,2.0,0.0,1.0,0.5,
780,1,3,0,0,1,3,1,4,3,104.0,0.3333333333333333,1.0,0.0,0.0,1.5,
1100,2,2,0,0,2,2,2,4,3,61.0,1.0,1.5,0.25,0.5,1.0,
991,4,7,0,2,4,9,2,13,12,213.0,0.4444444444444444,1.3333333333333333,0.22222222222222227,1.0,4.5,
124,2,1,1,1,3,2,3,5,4,99.0,1.5,2.5,0.25,1.0,0.875,
417,2,3,0,0,2,3,2,5,4,91.0,0.6666666666666666,1.3333333333333333,0.2222222222222222,0.5,1.5,
1021,1,3,0,0,1,3,1,4,3,138.0,0.3333333333333333,1.0,0.0,0.0,1.5,
314,3,1,0,0,3,1,3,4,3,57.0,3.0,3.0,0.0,1.5,0.375,
1238,2,1,0,0,2,1,2,3,2,53.0,2.0,2.0,0.0,1.0,0.5,
285,1,1,0,0,1,1,1,2,1,0.0,1.0,0.0,0.0,0.0,0.0,
227,3,2,0,0,3,2,3,5,4,214.0,1.5,2.0,1.0,0.8333333333333333,0.875,
220,1,0,0,1,1,1,1,2,1,0.0,1.0,0.0,0.0,0.0,0.0,
533,1,0,0,1,1,1,1,2,1,0.0,1.0,0.0,0.0,0.0,0.0,
134,0,2,1,0,1,2,1,3,2,21.0,0.5,1.0,0.0,0.0,1.0,
1129,1,0,0,1,1,1,1,2,1,0.0,1.0,0.0,0.0,0.0,0.0,
656,1,0,0,1,1,1,1,2,1,0.0,1.0,0.0,0.0,0.0,0.0,
903,1,1,0,0,1,1,1,2,1,0.0,1.0,0.0,0.0,0.0,0.0,
1370,1,1,0,1,1,2,1,3,2,71.0,0.5,1.0,0.0,0.0,1.0,
48,13,13,1,1,14,14,5,28,27,277.0,1.0,3.5,1.25,1.8214285714285714,4.5,
28,0,1,1,0,1,1,1,2,1,0.0,1.0,0.0,0.0,0.0,0.0,
232,0,1,1,1,1,2,1,3,2,6.0,0.5,1.0,0.0,0.0,1.0,
1194,1,1,0,0,1,1,1,2,1,0.0,1.0,0.0,0.0,0.0,0.0,
1440,2,1,0,2,2,3,2,5,4,61.0,0.6666666666666666,2.0,0.0,1.0,1.5,
1,0,0,1,1,1,1,1,2,1,0.0,1.0,0.0,0.0,0.0,0.0,
484,2,1,0,0,2,1,2,3,2,53.0,2.0,2.0,0.0,1.0,0.5,
1203,1,1,0,0,1,1,1,2,1,0.0,1.0,0.0,0.0,0.0,0.0,
731,1,1,0,0,1,1,1,2,1,0.0,1.0,0.0,0.0,0.0,0.0,
1628,3,1,0,1,3,2,2,5,4,25.0,1.5,2.0,0.0,0.6666666666666666,1.0,
181,0,3,1,0,1,3,1,4,3,34.0,0.3333333333333333,1.0,0.0,0.0,1.5,
1662,1,0,0,1,1,1,1,2,1,0.0,1.0,0.0,0.0,0.0,0.0,
70,3,3,1,0,4,3,4,7,6,83.0,1.3333333333333333,3.3333333333333335,0.8888888888888888,1.1666666666666665,1.0,
79,1,1,2,2,3,3,3,6,5,86.0,1.0,2.3333333333333335,0.22222222222222224,1.0,1.375,
807,2,4,0,0,2,4,2,6,5,141.0,0.5,1.5,0.25,0.5,2.0,
940,1,0,0,1,1,1,1,2,1,0.0,1.0,0.0,0.0,0.0,0.0,
1529,1,0,0,1,1,1,1,2,1,0.0,1.0,0.0,0.0,0.0,0.0,
1188,2,2,0,0,2,2,2,4,3,149.0,1.0,2.0,0.0,1.0,1.0,
802,1,1,0,0,1,1,1,2,1,0.0,1.0,0.0,0.0,0.0,0.0,
213,1,2,1,0,2,2,2,4,3,25.0,1.0,2.0,0.0,1.0,1.0,
631,1,1,0,0,1,1,1,2,1,0.0,1.0,0.0,0.0,0.0,0.0,
741,1,1,0,0,1,1,1,2,1,0.0,1.0,0.0,0.0,0.0,0.0,
1400,1,2,0,0,1,2,1,3,2,24.0,0.5,1.0,0.0,0.0,1.0,
1348,2,1,0,1,2,2,2,4,3,5.0,1.0,1.5,0.25,0.5,1.0,
1083,1,1,0,0,1,1,1,2,1,0.0,1.0,0.0,0.0,0.0,0.0,
1031,2,1,0,0,2,1,2,3,2,2.0,2.0,2.0,0.0,1.0,0.5,
1670,2,1,0,0,2,1,2,3,2,29.0,2.0,2.0,0.0,1.0,0.5,
579,2,1,0,1,2,2,2,4,3,31.0,1.0,1.5,0.25,0.5,1.0,
1275,1,1,0,0,1,1,1,2,1,0.0,1.0,0.0,0.0,0.0,0.0,
342,3,2,0,1,3,3,3,6,5,141.0,1.0,2.0,0.6666666666666666,0.8333333333333333,1.375,
702,1,4,0,0,1,4,1,5,4,128.0,0.25,1.0,0.0,0.0,2.0,
104,1,4,1,1,2,5,2,7,6,119.0,0.4,1.4,0.24,0.5,2.5,
217,0,1,1,0,1,1,1,2,1,0.0,1.0,0.0,0.0,0.0,0.0,
335,1,1,0,0,1,1,1,2,1,0.0,1.0,0.0,0.0,0.0,0.0,
596,3,1,0,4,3,5,2,8,7,196.0,0.6,1.8,0.16,0.6666666666666666,2.5,
785,2,2,0,0,2,2,2,4,3,97.0,1.0,1.5,0.25,0.5,1.0,
793,1,1,0,1,1,2,1,3,2,14.0,0.5,1.0,0.0,0.0,1.0,
1185,1,1,0,1,1,2,1,3,2,3.0,0.5,1.0,0.0,0.0,1.0,
1192,3,3,0,1,3,4,3,7,6,68.0,0.75,1.75,0.6875,0.8333333333333333,1.875,
1000,1,1,0,0,1,1,1,2,1,0.0,1.0,0.0,0.0,0.0,0.0,
753,1,0,0,1,1,1,1,2,1,0.0,1.0,0.0,0.0,0.0,0.0,
1494,2,2,0,0,2,2,2,4,3,43.0,1.0,1.5,0.25,0.5,1.0,
480,1,1,0,0,1,1,1,2,1,0.0,1.0,0.0,0.0,0.0,0.0,
1622,1,1,0,1,1,2,1,3,2,4.0,0.5,1.0,0.0,0.0,1.0,
1210,2,5,0,3,2,8,2,10,9,370.0,0.25,1.125,0.109375,0.5,4.0,
54,26,19,1,4,27,23,11,50,49,410.0,1.173913043478261,7.608695652173913,7.455576559546311,2.2392468642468644,2.12255859375,
870,1,1,0,1,1,2,1,3,2,10.0,0.5,1.0,0.0,0.0,1.0,
1344,3,1,0,0,3,1,3,4,3,216.0,3.0,3.0,0.0,1.5,0.375,
1037,1,2,0,0,1,2,1,3,2,19.0,0.5,1.0,0.0,0.0,1.0,
929,1,1,0,0,1,1,1,2,1,0.0,1.0,0.0,0.0,0.0,0.0,
942,1,1,0,0,1,1,1,2,1,0.0,1.0,0.0,0.0,0.0,0.0,
407,1,0,0,1,1,1,1,2,1,0.0,1.0,0.0,0.0,0.0,0.0,
269,1,1,0,0,1,1,1,2,1,0.0,1.0,0.0,0.0,0.0,0.0,
1248,1,2,0,0,1,2,1,3,2,28.0,0.5,1.0,0.0,0.0,1.0,
899,4,4,0,1,4,5,2,9,8,148.0,0.8,1.8,0.16,1.0,2.5,
255,3,2,0,0,3,2,3,5,4,64.0,1.5,2.0,1.0,0.8333333333333333,0.875,
694,7,4,0,1,7,5,4,12,11,85.0,1.4,2.6,1.04,1.1833333333333333,2.0,
194,0,1,1,0,1,1,1,2,1,0.0,1.0,0.0,0.0,0.0,0.0,
343,2,2,0,1,2,3,2,5,4,109.0,0.6666666666666666,2.0,0.0,1.0,1.5,
956,1,0,0,1,1,1,1,2,1,0.0,1.0,0.0,0.0,0.0,0.0,
1281,2,1,0,0,2,1,2,3,2,19.0,2.0,2.0,0.0,1.0,0.5,
325,1,1,0,0,1,1,1,2,1,0.0,1.0,0.0,0.0,0.0,0.0,
330,1,1,0,0,1,1,1,2,1,0.0,1.0,0.0,0.0,0.0,0.0,
985,2,3,0,0,2,3,2,5,4,50.0,0.6666666666666666,1.6666666666666667,0.2222222222222222,0.5,1.5,
76,2,2,1,0,3,2,3,5,4,15.0,1.5,2.5,0.25,1.0,0.875,
271,1,1,0,0,1,1,1,2,1,0.0,1.0,0.0,0.0,0.0,0.0,
1226,3,2,0,0,3,2,2,5,4,207.0,1.5,2.0,0.0,0.6666666666666666,1.0,
251,2,2,1,1,3,3,2,6,5,124.0,1.0,1.6666666666666667,0.2222222222222222,0.6666666666666666,1.5,
162,0,1,1,0,1,1,1,2,1,0.0,1.0,0.0,0.0,0.0,0.0,
1033,1,1,0,0,1,1,1,2,1,0.0,1.0,0.0,0.0,0.0,0.0,
799,1,2,0,0,1,2,1,3,2,8.0,0.5,1.0,0.0,0.0,1.0,
1300,2,1,0,0,2,1,2,3,2,35.0,2.0,2.0,0.0,1.0,0.5,
497,4,4,0,1,4,5,3,9,8,197.0,0.8,2.2,0.5599999999999999,0.8333333333333333,2.25,
977,2,1,0,0,2,1,2,3,2,9.0,2.0,2.0,0.0,1.0,0.5,
574,1,1,0,0,1,1,1,2,1,0.0,1.0,0.0,0.0,0.0,0.0,
861,1,1,0,2,1,3,1,4,3,117.0,0.3333333333333333,1.0,0.0,0.0,1.5,
696,2,1,0,0,2,1,2,3,2,8.0,2.0,2.0,0.0,1.0,0.5,
1596,1,1,0,1,1,2,1,3,2,5.0,0.5,1.0,0.0,0.0,1.0,
1502,2,3,0,0,2,3,2,5,4,125.0,0.6666666666666666,1.3333333333333333,0.2222222222222222,0.5,1.5,
389,1,2,0,1,1,3,1,4,3,59.0,0.3333333333333333,1.0,0.0,0.0,1.5,
1105,2,0,0,1,2,1,2,3,2,6.0,2.0,2.0,0.0,1.0,0.5,
349,1,1,0,0,1,1,1,2,1,0.0,1.0,0.0,0.0,0.0,0.0,
1384,1,1,0,0,1,1,1,2,1,0.0,1.0,0.0,0.0,0.0,0.0,
315,1,2,0,0,1,2,1,3,2,9.0,0.5,1.0,0.0,0.0,1.0,
69,2,3,1,0,3,3,3,6,5,94.0,1.0,2.6666666666666665,0.22222222222222224,1.0,1.25,
109,0,1,1,0,1,1,1,2,1,0.0,1.0,0.0,0.0,0.0,0.0,
1382,1,0,0,1,1,1,1,2,1,0.0,1.0,0.0,0.0,0.0,0.0,
1654,1,1,0,0,1,1,1,2,1,0.0,1.0,0.0,0.0,0.0,0.0,
706,1,1,0,0,1,1,1,2,1,0.0,1.0,0.0,0.0,0.0,0.0,
857,2,1,1,0,3,1,3,4,3,2.0,3.0,3.0,0.0,1.5,0.375,
1230,1,0,0,1,1,1,1,2,1,0.0,1.0,0.0,0.0,0.0,0.0,
167,1,2,1,0,2,2,2,4,3,87.0,1.0,1.5,0.25,0.5,1.0,
637,1,1,0,0,1,1,1,2,1,0.0,1.0,0.0,0.0,0.0,0.0,
1142,1,0,0,1,1,1,1,2,1,0.0,1.0,0.0,0.0,0.0,0.0,
287,1,1,0,0,1,1,1,2,1,0.0,1.0,0.0,0.0,0.0,0.0,
658,1,1,0,0,1,1,1,2,1,0.0,1.0,0.0,0.0,0.0,0.0,
1388,3,1,0,1,3,2,2,5,4,30.0,1.5,2.0,0.0,0.6666666666666666,1.0,
1419,2,1,0,0,2,1,2,3,2,4.0,2.0,2.0,0.0,1.0,0.5,
1243,1,1,0,0,1,1,1,2,1,0.0,1.0,0.0,0.0,0.0,0.0,
1176,1,2,0,0,1,2,1,3,2,24.0,0.5,1.0,0.0,0.0,1.0,
502,1,1,0,0,1,1,1,2,1,0.0,1.0,0.0,0.0,0.0,0.0,
1558,10,12,0,2,10,14,4,24,23,354.0,0.7142857142857143,3.0714285714285716,0.4948979591836734,1.4714285714285713,5.125,
683,3,0,0,1,3,1,3,4,3,133.0,3.0,3.0,0.0,1.5,0.375,
962,1,1,0,0,1,1,1,2,1,0.0,1.0,0.0,0.0,0.0,0.0,
932,1,1,0,0,1,1,1,2,1,0.0,1.0,0.0,0.0,0.0,0.0,
844,1,1,0,0,1,1,1,2,1,0.0,1.0,0.0,0.0,0.0,0.0,
1552,4,1,0,1,4,2,3,6,5,224.0,2.0,3.0,0.0,1.1666666666666665,0.75,
538,1,1,0,0,1,1,1,2,1,0.0,1.0,0.0,0.0,0.0,0.0,
723,2,3,0,0,2,3,2,5,4,75.0,0.6666666666666666,1.6666666666666667,0.2222222222222222,0.5,1.5,
1523,1,0,0,1,1,1,1,2,1,0.0,1.0,0.0,0.0,0.0,0.0,
1533,1,3,0,0,1,3,1,4,3,38.0,0.3333333333333333,1.0,0.0,0.0,1.5,
193,19,13,1,8,20,21,5,41,40,264.0,0.9523809523809523,3.0952380952380953,0.8480725623582765,2.8607142857142853,7.53125,
77,3,6,1,0,4,6,3,10,9,140.0,0.6666666666666666,2.1666666666666665,0.47222222222222215,0.8333333333333333,2.75,
747,2,2,0,0,2,2,2,4,3,46.0,1.0,1.5,0.25,0.5,1.0,
1234,1,1,0,0,1,1,1,2,1,0.0,1.0,0.0,0.0,0.0,0.0,
1493,1,0,0,1,1,1,1,2,1,0.0,1.0,0.0,0.0,0.0,0.0,
304,1,1,0,1,1,2,1,3,2,17.0,0.5,1.0,0.0,0.0,1.0,
1437,2,3,0,2,2,5,2,7,6,375.0,0.4,1.4,0.24,0.5,2.5,
1183,1,1,0,0,1,1,1,2,1,0.0,1.0,0.0,0.0,0.0,0.0,
613,1,0,0,1,1,1,1,2,1,0.0,1.0,0.0,0.0,0.0,0.0,
662,0,0,1,1,1,1,1,2,1,0.0,1.0,0.0,0.0,0.0,0.0,
1227,1,0,0,2,1,2,1,3,2,1.0,0.5,1.0,0.0,0.0,1.0,
1075,3,3,0,0,3,3,2,6,5,100.0,1.0,1.6666666666666667,0.2222222222222222,0.6666666666666666,1.5,
742,4,0,0,1,4,1,4,5,4,168.0,4.0,4.0,0.0,1.8333333333333333,0.25,
667,2,2,0,1,2,3,2,5,4,99.0,0.6666666666666666,1.6666666666666667,0.2222222222222222,0.5,1.5,
97,6,2,1,2,7,4,7,11,10,377.0,1.75,5.0,2.5,1.4,0.7734375,
13,20,16,1,5,21,21,8,42,41,300.0,1.0,4.142857142857143,2.9795918367346936,1.9999861249861253,5.578125,
327,1,1,0,0,1,1,1,2,1,0.0,1.0,0.0,0.0,0.0,0.0,
1274,1,3,0,0,1,3,1,4,3,77.0,0.3333333333333333,1.0,0.0,0.0,1.5,
1045,2,2,0,1,2,3,2,5,4,73.0,0.6666666666666666,1.3333333333333333,0.2222222222222222,0.5,1.5,
1646,2,2,0,0,2,2,2,4,3,39.0,1.0,1.5,0.25,0.5,1.0,
1040,3,1,0,1,3,2,3,5,4,122.0,1.5,2.0,1.0,0.8333333333333333,0.875,
1551,1,1,0,0,1,1,1,2,1,0.0,1.0,0.0,0.0,0.0,0.0,
112,1,0,1,1,2,1,2,3,2,14.0,2.0,2.0,0.0,1.0,0.5,
1474,1,1,1,0,2,1,2,3,2,15.0,2.0,2.0,0.0,1.0,0.5,
1482,1,1,0,0,1,1,1,2,1,0.0,1.0,0.0,0.0,0.0,0.0,
302,1,1,0,0,1,1,1,2,1,0.0,1.0,0.0,0.0,0.0,0.0,
1329,1,1,0,0,1,1,1,2,1,0.0,1.0,0.0,0.0,0.0,0.0,
103,6,4,1,1,7,5,5,12,11,155.0,1.4,3.6,1.04,1.069047619047619,1.53125,
1309,1,1,0,1,1,2,1,3,2,89.0,0.5,1.0,0.0,0.0,1.0,
945,5,1,0,0,5,1,5,6,5,101.0,5.0,5.0,0.0,2.083333333333333,0.15625,
575,1,0,0,2,1,2,1,3,2,123.0,0.5,1.0,0.0,0.0,1.0,
541,1,0,0,1,1,1,1,2,1,0.0,1.0,0.0,0.0,0.0,0.0,
819,0,1,1,0,1,1,1,2,1,0.0,1.0,0.0,0.0,0.0,0.0,
1564,1,2,0,1,1,3,1,4,3,106.0,0.3333333333333333,1.0,0.0,0.0,1.5,
786,0,0,1,1,1,1,1,2,1,0.0,1.0,0.0,0.0,0.0,0.0,
1202,1,0,0,1,1,1,1,2,1,0.0,1.0,0.0,0.0,0.0,0.0,
1356,3,2,0,2,3,4,3,7,6,187.0,0.75,2.5,0.75,0.8333333333333333,1.625,
791,3,3,0,1,3,4,2,7,6,127.0,0.75,2.0,0.0,0.6666666666666666,2.0,
146,2,4,1,3,3,7,3,10,9,170.0,0.42857142857142855,2.0,0.5714285714285714,0.8333333333333333,3.25,
483,2,1,0,1,2,2,2,4,3,60.0,1.0,1.5,0.25,0.5,1.0,
240,4,1,0,1,4,2,4,6,5,47.0,2.0,3.0,1.0,1.1666666666666665,0.75,
700,1,2,0,0,1,2,1,3,2,69.0,0.5,1.0,0.0,0.0,1.0,
118,1,1,1,2,2,3,2,5,4,20.0,0.6666666666666666,1.6666666666666667,0.2222222222222222,0.5,1.5,
778,1,1,0,0,1,1,1,2,1,0.0,1.0,0.0,0.0,0.0,0.0,
272,5,1,1,2,6,3,6,9,8,203.0,2.0,3.3333333333333335,4.222222222222222,1.0666666666666667,0.96875,
1092,1,1,0,0,1,1,1,2,1,0.0,1.0,0.0,0.0,0.0,0.0,
1063,2,5,0,1,2,6,2,8,7,583.0,0.3333333333333333,2.0,0.0,1.0,3.0,
1134,2,3,0,1,2,4,2,6,5,62.0,0.5,1.75,0.1875,0.5,2.0,
468,1,1,0,0,1,1,1,2,1,0.0,1.0,0.0,0.0,0.0,0.0,
320,3,3,0,0,3,3,3,6,5,56.0,1.0,2.0,0.6666666666666666,0.8333333333333333,1.375,
565,1,1,0,1,1,2,1,3,2,31.0,0.5,1.0,0.0,0.0,1.0,
1429,3,4,0,0,3,4,2,7,6,153.0,0.75,1.5,0.25,0.6666666666666666,2.0,
681,5,8,0,0,5,8,5,13,12,203.0,0.625,3.625,0.984375,1.1666666666666665,2.4375,
1517,2,2,0,0,2,2,2,4,3,21.0,1.0,1.5,0.25,0.5,1.0,
1223,1,1,0,1,1,2,1,3,2,9.0,0.5,1.0,0.0,0.0,1.0,
1481,1,1,0,0,1,1,1,2,1,0.0,1.0,0.0,0.0,0.0,0.0,
1116,1,0,0,1,1,1,1,2,1,0.0,1.0,0.0,0.0,0.0,0.0,
362,2,0,0,1,2,1,2,3,2,19.0,2.0,2.0,0.0,1.0,0.5,
1508,1,1,0,0,1,1,1,2,1,0.0,1.0,0.0,0.0,0.0,0.0,
358,2,3,0,1,2,4,2,6,5,96.0,0.5,1.25,0.1875,0.5,2.0,
542,1,0,0,1,1,1,1,2,1,0.0,1.0,0.0,0.0,0.0,0.0,
270,1,1,0,0,1,1,1,2,1,0.0,1.0,0.0,0.0,0.0,0.0,
855,1,1,0,0,1,1,1,2,1,0.0,1.0,0.0,0.0,0.0,0.0,
274,2,1,0,1,2,2,2,4,3,36.0,1.0,2.0,0.0,1.0,1.0,
1084,12,13,0,7,12,20,4,32,31,605.0,0.6,2.6,0.6399999999999999,2.1166666666666667,8.375,
1423,1,0,0,1,1,1,1,2,1,0.0,1.0,0.0,0.0,0.0,0.0,
387,2,2,0,0,2,2,2,4,3,107.0,1.0,1.5,0.25,0.5,1.0,
1279,1,0,0,1,1,1,1,2,1,0.0,1.0,0.0,0.0,0.0,0.0,
39,0,1,1,0,1,1,1,2,1,0.0,1.0,0.0,0.0,0.0,0.0,
882,1,1,0,2,1,3,1,4,3,96.0,0.3333333333333333,1.0,0.0,0.0,1.5,
828,4,5,0,0,4,5,3,9,8,246.0,0.8,2.0,0.4,0.8333333333333333,2.375,
1428,1,1,0,0,1,1,1,2,1,0.0,1.0,0.0,0.0,0.0,0.0,
1291,1,2,0,0,1,2,1,3,2,16.0,0.5,1.0,0.0,0.0,1.0,
299,1,1,0,0,1,1,1,2,1,0.0,1.0,0.0,0.0,0.0,0.0,
1245,3,1,0,0,3,1,3,4,3,55.0,3.0,3.0,0.0,1.5,0.375,
1651,1,1,0,0,1,1,1,2,1,0.0,1.0,0.0,0.0,0.0,0.0,
1137,2,1,0,0,2,1,2,3,2,31.0,2.0,2.0,0.0,1.0,0.5,
231,1,1,0,0,1,1,1,2,1,0.0,1.0,0.0,0.0,0.0,0.0,
849,11,6,0,2,11,8,8,19,18,299.0,1.375,5.75,1.4375,1.5785714285714283,0.9921875,
203,7,8,0,3,7,11,4,18,17,153.0,0.6363636363636364,2.4545454545454546,0.793388429752066,1.4333333333333333,4.75,
1540,4,7,0,1,4,8,4,12,11,302.0,0.5,2.375,0.984375,0.9166666666666666,3.5,
1128,1,0,0,2,1,2,1,3,2,14.0,0.5,1.0,0.0,0.0,1.0,
1167,1,1,0,0,1,1,1,2,1,0.0,1.0,0.0,0.0,0.0,0.0,
1559,1,2,0,0,1,2,1,3,2,14.0,0.5,1.0,0.0,0.0,1.0,
166,1,3,1,0,2,3,2,5,4,69.0,0.6666666666666666,1.3333333333333333,0.2222222222222222,0.5,1.5,
409,1,1,0,1,1,2,1,3,2,1.0,0.5,1.0,0.0,0.0,1.0,
433,2,4,0,2,2,6,2,8,7,350.0,0.3333333333333333,1.1666666666666667,0.13888888888888887,0.5,3.0,
528,1,2,0,0,1,2,1,3,2,2.0,0.5,1.0,0.0,0.0,1.0,
1263,1,2,0,1,1,3,1,4,3,129.0,0.3333333333333333,1.0,0.0,0.0,1.5,
1476,2,3,0,0,2,3,2,5,4,133.0,0.6666666666666666,1.3333333333333333,0.2222222222222222,0.5,1.5,
244,1,0,0,1,1,1,1,2,1,0.0,1.0,0.0,0.0,0.0,0.0,
555,1,1,0,0,1,1,1,2,1,0.0,1.0,0.0,0.0,0.0,0.0,
1240,1,2,0,0,1,2,1,3,2,38.0,0.5,1.0,0.0,0.0,1.0,
435,1,0,0,1,1,1,1,2,1,0.0,1.0,0.0,0.0,0.0,0.0,
1331,3,3,0,0,3,3,3,6,5,120.0,1.0,2.3333333333333335,0.22222222222222224,1.0,1.375,
286,2,2,0,0,2,2,2,4,3,153.0,1.0,1.5,0.25,0.5,1.0,
832,1,1,0,0,1,1,1,2,1,0.0,1.0,0.0,0.0,0.0,0.0,
305,2,1,0,1,2,2,2,4,3,52.0,1.0,1.5,0.25,0.5,1.0,
990,3,5,0,4,3,9,3,12,11,272.0,0.3333333333333333,1.3333333333333333,0.4444444444444444,0.8333333333333333,4.375,
192,0,0,1,1,1,1,1,2,1,0.0,1.0,0.0,0.0,0.0,0.0,
1350,15,16,0,0,15,16,7,31,30,459.0,0.9375,3.3125,2.83984375,1.7206349206349207,5.4609375,
1677,0,1,1,0,1,1,1,2,1,0.0,1.0,0.0,0.0,0.0,0.0,
1292,1,1,0,0,1,1,1,2,1,0.0,1.0,0.0,0.0,0.0,0.0,
1391,1,1,0,0,1,1,1,2,1,0.0,1.0,0.0,0.0,0.0,0.0,
586,3,2,0,0,3,2,3,5,4,81.0,1.5,2.5,0.25,1.0,0.875,
1305,1,1,0,0,1,1,1,2,1,0.0,1.0,0.0,0.0,0.0,0.0,
1469,4,7,0,2,4,9,4,13,12,374.0,0.4444444444444444,2.4444444444444446,2.0246913580246915,0.9166666666666666,3.5,
157,1,3,1,0,2,3,2,5,4,105.0,0.6666666666666666,1.3333333333333333,0.2222222222222222,0.5,1.5,
415,2,1,0,0,2,1,2,3,2,27.0,2.0,2.0,0.0,1.0,0.5,
1548,1,1,0,0,1,1,1,2,1,0.0,1.0,0.0,0.0,0.0,0.0,
624,2,3,0,0,2,3,2,5,4,281.0,0.6666666666666666,1.6666666666666667,0.2222222222222222,0.5,1.5,
1254,1,1,0,0,1,1,1,2,1,0.0,1.0,0.0,0.0,0.0,0.0,
563,1,1,1,1,2,2,2,4,3,6.0,1.0,2.0,0.0,1.0,1.0,
1130,1,1,0,0,1,1,1,2,1,0.0,1.0,0.0,0.0,0.0,0.0,
1367,1,2,0,0,1,2,1,3,2,41.0,0.5,1.0,0.0,0.0,1.0,
105,0,1,1,0,1,1,1,2,1,0.0,1.0,0.0,0.0,0.0,0.0,
959,2,1,0,0,2,1,2,3,2,30.0,2.0,2.0,0.0,1.0,0.5,
428,1,1,0,0,1,1,1,2,1,0.0,1.0,0.0,0.0,0.0,0.0,
1221,1,3,0,0,1,3,1,4,3,71.0,0.3333333333333333,1.0,0.0,0.0,1.5,
1577,1,0,0,1,1,1,1,2,1,0.0,1.0,0.0,0.0,0.0,0.0,
972,1,1,0,0,1,1,1,2,1,0.0,1.0,0.0,0.0,0.0,0.0,
200,1,1,1,0,2,1,2,3,2,16.0,2.0,2.0,0.0,1.0,0.5,
764,1,1,0,0,1,1,1,2,1,0.0,1.0,0.0,0.0,0.0,0.0,
1187,1,1,0,0,1,1,1,2,1,0.0,1.0,0.0,0.0,0.0,0.0,
852,6,2,0,3,6,5,6,11,10,163.0,1.2,3.4,2.6399999999999997,1.0666666666666667,1.59375,
740,1,1,0,0,1,1,1,2,1,0.0,1.0,0.0,0.0,0.0,0.0,
154,1,1,1,1,2,2,2,4,3,64.0,1.0,1.5,0.25,0.5,1.0,
728,1,0,0,1,1,1,1,2,1,0.0,1.0,0.0,0.0,0.0,0.0,
1255,1,2,0,0,1,2,1,3,2,29.0,0.5,1.0,0.0,0.0,1.0,
606,6,3,0,1,6,4,5,10,9,98.0,1.5,3.5,2.75,1.2333333333333332,1.1875,
1422,1,1,0,0,1,1,1,2,1,0.0,1.0,0.0,0.0,0.0,0.0,
332,0,2,1,0,1,2,1,3,2,42.0,0.5,1.0,0.0,0.0,1.0,
32,1,1,1,0,2,1,2,3,2,84.0,2.0,2.0,0.0,1.0,0.5,
174,7,6,1,2,8,8,6,16,15,209.0,1.0,4.5,1.5,1.6833333333333331,1.75,
323,1,1,0,0,1,1,1,2,1,0.0,1.0,0.0,0.0,0.0,0.0,
649,7,3,1,4,8,7,7,15,14,309.0,1.1428571428571428,4.142857142857143,2.979591836734694,1.3261904761904761,1.7421875,
1446,2,2,0,1,2,3,2,5,4,67.0,0.6666666666666666,1.3333333333333333,0.2222222222222222,0.5,1.5,
115,1,3,1,1,2,4,2,6,5,88.0,0.5,1.25,0.1875,0.5,2.0,
23,4,8,1,0,5,8,4,13,12,205.0,0.625,2.125,1.109375,0.9833333333333334,3.5,
944,3,7,0,0,3,7,3,10,9,327.0,0.42857142857142855,2.142857142857143,0.12244897959183675,1.0,3.375,
171,0,2,1,0,1,2,1,3,2,55.0,0.5,1.0,0.0,0.0,1.0,
51,2,2,1,1,3,3,3,6,5,138.0,1.0,2.3333333333333335,0.22222222222222224,1.0,1.375,
361,1,2,0,0,1,2,1,3,2,69.0,0.5,1.0,0.0,0.0,1.0,
448,1,1,0,0,1,1,1,2,1,0.0,1.0,0.0,0.0,0.0,0.0,
30,15,18,1,3,16,21,5,37,36,204.0,0.7619047619047619,2.9523809523809526,1.0929705215419498,2.2476190476190476,7.78125,
214,3,2,1,2,4,4,4,8,7,122.0,1.0,3.0,0.5,1.1666666666666665,1.5,
1396,1,1,0,1,1,2,1,3,2,22.0,0.5,1.0,0.0,0.0,1.0,
633,4,3,0,1,4,4,4,8,7,107.0,1.0,2.0,1.5,0.9166666666666666,1.75,
957,3,2,0,0,3,2,3,5,4,10.0,1.5,2.0,1.0,0.8333333333333333,0.875,
628,4,2,0,0,4,2,4,6,5,186.0,2.0,4.0,0.0,1.8333333333333333,0.5,
1136,2,2,0,0,2,2,2,4,3,79.0,1.0,1.5,0.25,0.5,1.0,
1589,1,3,0,0,1,3,1,4,3,93.0,0.3333333333333333,1.0,0.0,0.0,1.5,
653,4,0,0,2,4,2,4,6,5,79.0,2.0,3.5,0.25,1.3333333333333333,0.625,
1219,2,1,0,0,2,1,2,3,2,50.0,2.0,2.0,0.0,1.0,0.5,
196,0,1,1,0,1,1,1,2,1,0.0,1.0,0.0,0.0,0.0,0.0,
425,2,1,0,0,2,1,2,3,2,40.0,2.0,2.0,0.0,1.0,0.5,
