ObID,HRI,HRL,LRI,LRL,Internals,Leaves,Height,Vertices,Size,Duration,RatioIL,MeanBar,StdBar,Beta1,Beta2,
345,8,6,0,9,8,15,7,23,22,592.0,0.5333333333333333,4.666666666666667,2.222222222222222,1.4333333333333333,3.2109375,
1112,1,0,1,1,2,1,2,3,2,22.0,2.0,2.0,0.0,1.0,0.5,
569,4,2,0,2,4,4,3,8,7,207.0,1.0,2.0,0.5,0.8333333333333333,1.875,
306,1,2,0,0,1,2,1,3,2,12.0,0.5,1.0,0.0,0.0,1.0,
688,0,0,1,1,1,1,1,2,1,0.0,1.0,0.0,0.0,0.0,0.0,
1319,1,1,0,0,1,1,1,2,1,0.0,1.0,0.0,0.0,0.0,0.0,
903,2,0,0,2,2,2,2,4,3,8.0,1.0,1.5,0.25,0.5,1.0,
259,2,1,0,2,2,3,2,5,4,70.0,0.6666666666666666,1.3333333333333333,0.2222222222222222,0.5,1.5,
832,1,0,0,1,1,1,1,2,1,0.0,1.0,0.0,0.0,0.0,0.0,
121,0,0,1,1,1,1,1,2,1,0.0,1.0,0.0,0.0,0.0,0.0,
235,0,0,1,1,1,1,1,2,1,0.0,1.0,0.0,0.0,0.0,0.0,
716,2,0,0,1,2,1,2,3,2,7.0,2.0,2.0,0.0,1.0,0.5,
407,1,0,0,1,1,1,1,2,1,0.0,1.0,0.0,0.0,0.0,0.0,
945,1,0,0,3,1,3,1,4,3,75.0,0.3333333333333333,1.0,0.0,0.0,1.5,
1373,9,3,1,7,10,10,7,20,19,204.0,1.0,3.5,4.45,1.4357142857142857,3.3984375,
562,1,1,0,2,1,3,1,4,3,9.0,0.3333333333333333,1.0,0.0,0.0,1.5,
884,2,3,0,4,2,7,2,9,8,68.0,0.2857142857142857,1.5714285714285714,0.24489795918367346,0.5,3.5,
762,3,2,0,1,3,3,2,6,5,63.0,1.0,2.0,0.0,0.6666666666666666,1.5,
1317,1,0,0,1,1,1,1,2,1,0.0,1.0,0.0,0.0,0.0,0.0,
315,1,1,0,2,1,3,1,4,3,20.0,0.3333333333333333,1.0,0.0,0.0,1.5,
985,10,5,1,9,11,14,5,25,24,351.0,0.7857142857142857,3.0,2.142857142857143,1.400793650793651,4.96875,
359,1,1,0,0,1,1,1,2,1,0.0,1.0,0.0,0.0,0.0,0.0,
456,1,0,0,1,1,1,1,2,1,0.0,1.0,0.0,0.0,0.0,0.0,
1087,8,0,2,11,10,11,4,21,20,432.0,0.9090909090909091,2.5454545454545454,0.6115702479338843,1.75,4.625,
149,6,2,2,11,8,13,4,21,20,321.0,0.6153846153846154,3.3076923076923075,0.9822485207100595,1.6833333333333331,4.25,
404,1,0,0,2,1,2,1,3,2,144.0,0.5,1.0,0.0,0.0,1.0,
645,1,2,0,3,1,5,1,6,5,191.0,0.2,1.0,0.0,0.0,2.5,
864,4,4,0,5,4,9,4,13,12,212.0,0.4444444444444444,2.2222222222222223,0.6172839506172839,0.9166666666666665,4.125,
564,2,1,0,2,2,3,2,5,4,93.0,0.6666666666666666,1.6666666666666667,0.2222222222222222,0.5,1.5,
1337,1,0,0,1,1,1,1,2,1,0.0,1.0,0.0,0.0,0.0,0.0,
804,2,3,1,1,3,4,2,7,6,66.0,0.75,1.5,0.25,0.6666666666666666,2.0,
793,1,1,0,0,1,1,1,2,1,0.0,1.0,0.0,0.0,0.0,0.0,
1090,2,0,0,2,2,2,2,4,3,7.0,1.0,2.0,0.0,1.0,1.0,
1358,1,0,1,1,2,1,2,3,2,26.0,2.0,2.0,0.0,1.0,0.5,
7,4,2,1,8,5,10,3,15,14,85.0,0.5,2.0,0.6,1.0833333333333333,4.625,
660,7,3,1,8,8,11,5,19,18,190.0,0.7272727272727273,3.272727272727273,2.0165289256198347,1.4333333333333333,3.5625,
1101,4,1,2,2,6,3,5,9,8,432.0,2.0,3.3333333333333335,1.5555555555555556,1.2333333333333332,1.03125,
327,1,0,0,1,1,1,1,2,1,0.0,1.0,0.0,0.0,0.0,0.0,
147,5,1,2,4,7,5,6,12,11,153.0,1.4,4.2,3.3600000000000003,1.2333333333333334,1.1875,
468,1,0,0,1,1,1,1,2,1,0.0,1.0,0.0,0.0,0.0,0.0,
817,3,1,0,4,3,5,2,8,7,76.0,0.6,1.6,0.24,0.6666666666666666,2.5,
670,2,0,0,3,2,3,2,5,4,41.0,0.6666666666666666,1.3333333333333333,0.2222222222222222,0.5,1.5,
577,1,0,0,2,1,2,1,3,2,54.0,0.5,1.0,0.0,0.0,1.0,
39,5,4,1,3,6,7,5,13,12,76.0,0.8571428571428571,2.4285714285714284,1.6734693877551021,1.2333333333333332,2.90625,
859,7,5,2,7,9,12,5,21,20,356.0,0.75,3.25,1.0208333333333333,1.6333333333333333,4.1875,
1036,1,0,0,2,1,2,1,3,2,18.0,0.5,1.0,0.0,0.0,1.0,
108,0,0,1,1,1,1,1,2,1,0.0,1.0,0.0,0.0,0.0,0.0,
536,1,0,0,1,1,1,1,2,1,0.0,1.0,0.0,0.0,0.0,0.0,
417,2,0,0,2,2,2,2,4,3,11.0,1.0,2.0,0.0,1.0,1.0,
631,1,1,0,1,1,2,1,3,2,111.0,0.5,1.0,0.0,0.0,1.0,
212,6,5,1,9,7,14,4,21,20,170.0,0.5,2.357142857142857,0.9438775510204083,1.1833333333333333,5.875,
1215,2,1,0,1,2,2,2,4,3,199.0,1.0,1.5,0.25,0.5,1.0,
979,4,4,0,6,4,10,3,14,13,278.0,0.4,2.3,0.8099999999999999,0.8333333333333333,4.25,
435,7,3,1,6,8,9,6,17,16,239.0,0.8888888888888888,4.222222222222222,0.8395061728395063,1.269047619047619,2.15625,
1295,1,1,0,2,1,3,1,4,3,59.0,0.3333333333333333,1.0,0.0,0.0,1.5,
1022,1,0,0,1,1,1,1,2,1,0.0,1.0,0.0,0.0,0.0,0.0,
890,1,0,0,1,1,1,1,2,1,0.0,1.0,0.0,0.0,0.0,0.0,
236,0,1,1,0,1,1,1,2,1,0.0,1.0,0.0,0.0,0.0,0.0,
1297,1,0,0,1,1,1,1,2,1,0.0,1.0,0.0,0.0,0.0,0.0,
923,2,3,0,1,2,4,2,6,5,67.0,0.5,2.0,0.0,1.0,2.0,
1208,1,1,0,1,1,2,1,3,2,0.0,0.5,1.0,0.0,0.0,1.0,
505,2,0,1,1,3,1,3,4,3,31.0,3.0,3.0,0.0,1.5,0.375,
448,2,2,1,3,3,5,3,8,7,141.0,0.6,3.0,0.0,1.5,1.875,
1246,0,1,1,2,1,3,1,4,3,37.0,0.3333333333333333,1.0,0.0,0.0,1.5,
877,14,11,0,11,14,22,8,36,35,572.0,0.6363636363636364,4.7272727272727275,3.380165289256199,2.0726190476190474,4.7265625,
860,5,1,3,7,8,8,5,16,15,516.0,1.0,3.75,1.4375,1.7833333333333332,2.1875,
739,1,0,0,2,1,2,1,3,2,10.0,0.5,1.0,0.0,0.0,1.0,
24,12,4,3,14,15,18,5,33,32,422.0,0.8333333333333334,2.7777777777777777,0.9506172839506173,2.0198412698412698,7.1875,
1382,1,0,0,1,1,1,1,2,1,0.0,1.0,0.0,0.0,0.0,0.0,
961,3,1,1,1,4,2,4,6,5,57.0,2.0,3.0,1.0,1.1666666666666665,0.75,
893,2,1,0,0,2,1,2,3,2,25.0,2.0,2.0,0.0,1.0,0.5,
527,1,1,0,1,1,2,1,3,2,95.0,0.5,1.0,0.0,0.0,1.0,
957,1,0,0,1,1,1,1,2,1,0.0,1.0,0.0,0.0,0.0,0.0,
1221,2,1,0,0,2,1,2,3,2,2.0,2.0,2.0,0.0,1.0,0.5,
272,1,0,0,1,1,1,1,2,1,0.0,1.0,0.0,0.0,0.0,0.0,
438,1,0,0,1,1,1,1,2,1,0.0,1.0,0.0,0.0,0.0,0.0,
791,0,1,1,0,1,1,1,2,1,0.0,1.0,0.0,0.0,0.0,0.0,
1210,1,0,0,1,1,1,1,2,1,0.0,1.0,0.0,0.0,0.0,0.0,
1298,1,0,0,3,1,3,1,4,3,8.0,0.3333333333333333,1.0,0.0,0.0,1.5,
850,2,1,0,0,2,1,2,3,2,75.0,2.0,2.0,0.0,1.0,0.5,
111,1,0,1,3,2,3,2,5,4,43.0,0.6666666666666666,1.6666666666666667,0.2222222222222222,0.5,1.5,
203,2,0,1,3,3,3,3,6,5,174.0,1.0,2.6666666666666665,0.22222222222222224,1.0,1.25,
595,2,0,1,1,3,1,3,4,3,107.0,3.0,3.0,0.0,1.5,0.375,
1137,4,1,1,2,5,3,3,8,7,78.0,1.6666666666666667,2.3333333333333335,0.22222222222222224,1.0833333333333333,1.375,
34,6,3,1,7,7,10,6,17,16,178.0,0.7,3.6,1.8399999999999999,1.2666666666666666,3.03125,
897,2,2,0,2,2,4,2,6,5,17.0,0.5,1.5,0.25,0.5,2.0,
110,0,1,1,0,1,1,1,2,1,0.0,1.0,0.0,0.0,0.0,0.0,
207,0,0,1,1,1,1,1,2,1,0.0,1.0,0.0,0.0,0.0,0.0,
1122,4,2,1,4,5,6,4,11,10,149.0,0.8333333333333334,2.5,1.25,0.9833333333333334,2.5,
1241,0,0,1,1,1,1,1,2,1,0.0,1.0,0.0,0.0,0.0,0.0,
64,7,6,1,4,8,10,5,18,17,157.0,0.8,2.4,1.64,1.2357142857142858,4.15625,
1195,1,0,0,1,1,1,1,2,1,0.0,1.0,0.0,0.0,0.0,0.0,
730,4,2,1,6,5,8,4,13,12,133.0,0.625,2.25,0.6875,0.9833333333333334,3.625,
165,2,2,1,1,3,3,3,6,5,54.0,1.0,2.3333333333333335,0.22222222222222224,1.0,1.375,
1153,1,0,0,1,1,1,1,2,1,0.0,1.0,0.0,0.0,0.0,0.0,
1126,0,1,1,0,1,1,1,2,1,0.0,1.0,0.0,0.0,0.0,0.0,
1289,2,1,0,3,2,4,2,6,5,42.0,0.5,1.5,0.25,0.5,2.0,
735,2,0,0,1,2,1,2,3,2,2.0,2.0,2.0,0.0,1.0,0.5,
1258,2,1,1,5,3,6,3,9,8,144.0,0.5,1.8333333333333333,0.47222222222222215,0.8333333333333333,2.875,
1155,5,3,0,1,5,4,5,9,8,232.0,1.25,4.0,1.5,1.1666666666666665,1.0625,
1177,1,0,0,1,1,1,1,2,1,0.0,1.0,0.0,0.0,0.0,0.0,
710,1,0,0,1,1,1,1,2,1,0.0,1.0,0.0,0.0,0.0,0.0,
134,8,3,1,7,9,10,5,19,18,182.0,0.9,3.5,1.25,1.4690476190476192,3.21875,
1231,1,0,0,1,1,1,1,2,1,0.0,1.0,0.0,0.0,0.0,0.0,
190,7,4,1,9,8,13,5,21,20,327.0,0.6153846153846154,3.3076923076923075,1.7514792899408285,1.7333333333333332,4.1875,
494,6,1,0,3,6,4,4,10,9,76.0,1.5,2.75,0.6875,1.2333333333333332,1.625,
354,1,1,0,1,1,2,1,3,2,9.0,0.5,1.0,0.0,0.0,1.0,
954,1,0,0,1,1,1,1,2,1,0.0,1.0,0.0,0.0,0.0,0.0,
758,1,1,0,1,1,2,1,3,2,18.0,0.5,1.0,0.0,0.0,1.0,
1074,6,6,1,10,7,16,5,23,22,432.0,0.4375,2.8125,1.65234375,1.4833333333333332,5.9375,
1070,1,0,1,2,2,2,2,4,3,153.0,1.0,1.5,0.25,0.5,1.0,
1347,1,1,2,0,3,1,3,4,3,104.0,3.0,3.0,0.0,1.5,0.375,
479,1,0,0,1,1,1,1,2,1,0.0,1.0,0.0,0.0,0.0,0.0,
95,6,6,1,9,7,15,3,22,21,273.0,0.4666666666666667,2.466666666666667,0.24888888888888897,1.3499999999999999,6.625,
820,1,1,0,0,1,1,1,2,1,0.0,1.0,0.0,0.0,0.0,0.0,
264,1,0,0,1,1,1,1,2,1,0.0,1.0,0.0,0.0,0.0,0.0,
1115,1,2,0,0,1,2,1,3,2,24.0,0.5,1.0,0.0,0.0,1.0,
200,0,1,1,0,1,1,1,2,1,0.0,1.0,0.0,0.0,0.0,0.0,
922,3,1,0,0,3,1,3,4,3,56.0,3.0,3.0,0.0,1.5,0.375,
862,1,0,1,1,2,1,2,3,2,29.0,2.0,2.0,0.0,1.0,0.5,
19,3,6,1,9,4,15,3,19,18,202.0,0.26666666666666666,2.3333333333333335,0.35555555555555574,1.1666666666666665,6.75,
507,2,1,0,0,2,1,2,3,2,6.0,2.0,2.0,0.0,1.0,0.5,
493,4,2,0,6,4,8,2,12,11,338.0,0.5,1.625,0.234375,1.0,4.0,
132,0,1,1,0,1,1,1,2,1,0.0,1.0,0.0,0.0,0.0,0.0,
940,1,0,0,1,1,1,1,2,1,0.0,1.0,0.0,0.0,0.0,0.0,
1230,4,1,0,4,4,5,3,9,8,67.0,0.8,1.8,0.56,0.8333333333333333,2.375,
502,1,1,0,1,1,2,1,3,2,35.0,0.5,1.0,0.0,0.0,1.0,
1281,2,3,0,1,2,4,2,6,5,60.0,0.5,1.25,0.1875,0.5,2.0,
681,3,0,0,3,3,3,2,6,5,30.0,1.0,1.6666666666666667,0.2222222222222222,0.6666666666666666,1.5,
425,3,2,2,3,5,5,4,10,9,66.0,1.0,2.2,0.96,0.9833333333333334,2.25,
23,5,3,2,7,7,10,5,17,16,279.0,0.7,3.5,0.85,1.2333333333333332,3.15625,
316,1,0,1,1,2,1,2,3,2,29.0,2.0,2.0,0.0,1.0,0.5,
1188,0,0,1,1,1,1,1,2,1,0.0,1.0,0.0,0.0,0.0,0.0,
509,2,1,1,1,3,2,3,5,4,51.0,1.5,3.0,0.0,1.5,0.75,
6,2,1,1,6,3,7,2,10,9,92.0,0.42857142857142855,1.7142857142857142,0.20408163265306126,0.6666666666666666,3.5,
99,0,1,1,1,1,2,1,3,2,30.0,0.5,1.0,0.0,0.0,1.0,
74,9,11,2,4,11,15,6,26,25,114.0,0.7333333333333333,3.466666666666667,1.982222222222222,1.5785714285714283,5.03125,
815,1,1,0,1,1,2,1,3,2,34.0,0.5,1.0,0.0,0.0,1.0,
1185,1,0,0,1,1,1,1,2,1,0.0,1.0,0.0,0.0,0.0,0.0,
1077,2,1,0,1,2,2,2,4,3,105.0,1.0,1.5,0.25,0.5,1.0,
1287,2,2,0,0,2,2,2,4,3,183.0,1.0,1.5,0.25,0.5,1.0,
680,1,0,1,1,2,1,2,3,2,16.0,2.0,2.0,0.0,1.0,0.5,
194,2,1,1,4,3,5,3,8,7,159.0,0.6,2.6,0.64,0.8333333333333333,2.0,
1260,1,0,1,1,2,1,2,3,2,18.0,2.0,2.0,0.0,1.0,0.5,
936,2,0,1,1,3,1,3,4,3,79.0,3.0,3.0,0.0,1.5,0.375,
202,4,1,2,7,6,8,4,14,13,153.0,0.75,3.125,0.109375,1.4166666666666665,2.875,
495,1,1,1,2,2,3,2,5,4,51.0,0.6666666666666666,1.3333333333333333,0.2222222222222222,0.5,1.5,
125,2,1,1,4,3,5,3,8,7,117.0,0.6,1.6,0.64,0.8333333333333333,2.375,
91,0,2,1,0,1,2,1,3,2,0.0,0.5,1.0,0.0,0.0,1.0,
925,1,1,0,0,1,1,1,2,1,0.0,1.0,0.0,0.0,0.0,0.0,
387,1,1,0,1,1,2,1,3,2,26.0,0.5,1.0,0.0,0.0,1.0,
794,2,2,0,5,2,7,2,9,8,132.0,0.2857142857142857,1.4285714285714286,0.24489795918367346,0.5,3.5,
1154,1,2,2,1,3,3,2,6,5,99.0,1.0,2.0,0.0,0.6666666666666666,1.5,
521,2,0,0,3,2,3,2,5,4,72.0,0.6666666666666666,1.3333333333333333,0.2222222222222222,0.5,1.5,
1339,1,0,0,1,1,1,1,2,1,0.0,1.0,0.0,0.0,0.0,0.0,
428,1,1,0,0,1,1,1,2,1,0.0,1.0,0.0,0.0,0.0,0.0,
702,0,0,1,1,1,1,1,2,1,0.0,1.0,0.0,0.0,0.0,0.0,
818,2,1,0,1,2,2,2,4,3,29.0,1.0,1.5,0.25,0.5,1.0,
736,3,4,0,2,3,6,2,9,8,168.0,0.5,1.3333333333333333,0.22222222222222224,0.6666666666666666,3.0,
689,7,5,0,4,7,9,5,16,15,291.0,0.7777777777777778,3.0,2.888888888888889,1.2333333333333334,3.09375,
1019,1,1,0,1,1,2,1,3,2,22.0,0.5,1.0,0.0,0.0,1.0,
1332,1,0,0,1,1,1,1,2,1,0.0,1.0,0.0,0.0,0.0,0.0,
392,1,0,0,1,1,1,1,2,1,0.0,1.0,0.0,0.0,0.0,0.0,
638,1,1,0,0,1,1,1,2,1,0.0,1.0,0.0,0.0,0.0,0.0,
363,5,2,0,5,5,7,5,12,11,197.0,0.7142857142857143,3.0,1.7142857142857142,1.0333333333333332,2.53125,
137,0,0,1,1,1,1,1,2,1,0.0,1.0,0.0,0.0,0.0,0.0,
911,2,0,0,5,2,5,2,7,6,106.0,0.4,1.6,0.24,0.5,2.5,
771,1,1,0,1,1,2,1,3,2,5.0,0.5,1.0,0.0,0.0,1.0,
888,2,0,1,1,3,1,3,4,3,10.0,3.0,3.0,0.0,1.5,0.375,
1301,1,0,0,3,1,3,1,4,3,57.0,0.3333333333333333,1.0,0.0,0.0,1.5,
219,0,1,1,1,1,2,1,3,2,13.0,0.5,1.0,0.0,0.0,1.0,
1065,1,1,0,0,1,1,1,2,1,0.0,1.0,0.0,0.0,0.0,0.0,
684,2,1,0,1,2,2,2,4,3,15.0,1.0,1.5,0.25,0.5,1.0,
763,4,1,0,3,4,4,4,8,7,87.0,1.0,2.75,1.6875,0.9166666666666665,1.5,
1200,1,2,0,1,1,3,1,4,3,20.0,0.3333333333333333,1.0,0.0,0.0,1.5,
403,1,3,0,0,1,3,1,4,3,56.0,0.3333333333333333,1.0,0.0,0.0,1.5,
784,2,0,0,1,2,1,2,3,2,51.0,2.0,2.0,0.0,1.0,0.5,
1183,0,0,1,1,1,1,1,2,1,0.0,1.0,0.0,0.0,0.0,0.0,
662,2,0,0,2,2,2,2,4,3,83.0,1.0,1.5,0.25,0.5,1.0,
774,2,1,0,0,2,1,2,3,2,3.0,2.0,2.0,0.0,1.0,0.5,
45,5,5,2,5,7,10,4,17,16,144.0,0.7,1.9,0.6899999999999998,1.3833333333333333,4.75,
643,7,3,0,2,7,5,6,12,11,283.0,1.4,5.2,1.3599999999999999,1.2333333333333334,0.8125,
50,16,6,3,16,19,22,6,41,40,160.0,0.8636363636363636,3.3181818181818183,1.307851239669422,2.691666666666667,7.5625,
895,1,2,0,0,1,2,1,3,2,66.0,0.5,1.0,0.0,0.0,1.0,
263,0,0,1,1,1,1,1,2,1,0.0,1.0,0.0,0.0,0.0,0.0,
728,1,0,0,2,1,2,1,3,2,11.0,0.5,1.0,0.0,0.0,1.0,
611,2,1,0,7,2,8,2,10,9,175.0,0.25,1.875,0.109375,0.5,4.0,
786,3,1,1,6,4,7,3,11,10,111.0,0.5714285714285714,2.0,0.5714285714285714,0.8333333333333333,3.25,
1003,1,0,0,1,1,1,1,2,1,0.0,1.0,0.0,0.0,0.0,0.0,
1056,0,0,1,1,1,1,1,2,1,0.0,1.0,0.0,0.0,0.0,0.0,
1218,1,1,0,0,1,1,1,2,1,0.0,1.0,0.0,0.0,0.0,0.0,
414,0,0,1,1,1,1,1,2,1,0.0,1.0,0.0,0.0,0.0,0.0,
760,2,1,0,1,2,2,2,4,3,22.0,1.0,2.0,0.0,1.0,1.0,
1322,1,0,0,1,1,1,1,2,1,0.0,1.0,0.0,0.0,0.0,0.0,
228,1,2,1,0,2,2,2,4,3,40.0,1.0,1.5,0.25,0.5,1.0,
779,1,0,0,1,1,1,1,2,1,0.0,1.0,0.0,0.0,0.0,0.0,
1351,9,3,2,5,11,8,5,19,18,170.0,1.375,3.25,1.1875,1.9999999999999998,2.78125,
949,2,2,0,1,2,3,2,5,4,100.0,0.6666666666666666,1.6666666666666667,0.2222222222222222,0.5,1.5,
721,1,0,0,1,1,1,1,2,1,0.0,1.0,0.0,0.0,0.0,0.0,
227,1,0,1,1,2,1,2,3,2,99.0,2.0,2.0,0.0,1.0,0.5,
1199,1,1,0,0,1,1,1,2,1,0.0,1.0,0.0,0.0,0.0,0.0,
1359,1,0,1,1,2,1,2,3,2,89.0,2.0,2.0,0.0,1.0,0.5,
180,9,4,4,10,13,14,7,27,26,146.0,0.9285714285714286,4.714285714285714,1.346938775510204,1.8880952380952383,2.8046875,
1222,0,1,1,0,1,1,1,2,1,0.0,1.0,0.0,0.0,0.0,0.0,
170,4,6,1,6,5,12,5,17,16,283.0,0.4166666666666667,3.0833333333333335,1.9097222222222223,1.0333333333333332,4.21875,
513,1,0,0,1,1,1,1,2,1,0.0,1.0,0.0,0.0,0.0,0.0,
1152,1,1,0,0,1,1,1,2,1,0.0,1.0,0.0,0.0,0.0,0.0,
886,0,1,2,0,2,1,2,3,2,175.0,2.0,2.0,0.0,1.0,0.5,
543,5,3,2,4,7,7,4,14,13,151.0,1.0,3.0,1.1428571428571428,1.1833333333333333,2.5,
675,2,0,0,2,2,2,2,4,3,86.0,1.0,1.5,0.25,0.5,1.0,
789,2,1,0,1,2,2,2,4,3,26.0,1.0,1.5,0.25,0.5,1.0,
1178,3,2,0,4,3,6,2,9,8,107.0,0.5,1.3333333333333333,0.22222222222222224,0.6666666666666666,3.0,
1000,1,2,0,1,1,3,1,4,3,35.0,0.3333333333333333,1.0,0.0,0.0,1.5,
300,0,0,1,1,1,1,1,2,1,0.0,1.0,0.0,0.0,0.0,0.0,
1291,2,1,0,2,2,3,2,5,4,91.0,0.6666666666666666,1.6666666666666667,0.2222222222222222,0.5,1.5,
636,1,0,0,1,1,1,1,2,1,0.0,1.0,0.0,0.0,0.0,0.0,
510,1,1,0,3,1,4,1,5,4,69.0,0.25,1.0,0.0,0.0,2.0,
55,0,2,1,1,1,3,1,4,3,33.0,0.3333333333333333,1.0,0.0,0.0,1.5,
567,2,2,2,1,4,3,4,7,6,161.0,1.3333333333333333,3.3333333333333335,0.8888888888888888,1.1666666666666665,1.0,
912,1,2,0,0,1,2,1,3,2,70.0,0.5,1.0,0.0,0.0,1.0,
982,1,0,0,1,1,1,1,2,1,0.0,1.0,0.0,0.0,0.0,0.0,
756,0,0,2,1,2,1,2,3,2,7.0,2.0,2.0,0.0,1.0,0.5,
1220,1,1,0,1,1,2,1,3,2,48.0,0.5,1.0,0.0,0.0,1.0,
944,3,1,0,1,3,2,3,5,4,55.0,1.5,2.5,0.25,1.0,0.875,
432,2,2,0,2,2,4,2,6,5,79.0,0.5,1.75,0.1875,0.5,2.0,
1063,1,2,1,4,2,6,2,8,7,134.0,0.3333333333333333,1.1666666666666667,0.13888888888888887,0.5,3.0,
810,1,0,0,2,1,2,1,3,2,59.0,0.5,1.0,0.0,0.0,1.0,
223,0,1,1,0,1,1,1,2,1,0.0,1.0,0.0,0.0,0.0,0.0,
1017,1,3,0,1,1,4,1,5,4,21.0,0.25,1.0,0.0,0.0,2.0,
1083,3,1,0,1,3,2,3,5,4,67.0,1.5,2.0,1.0,0.8333333333333333,0.875,
371,1,2,2,2,3,4,3,7,6,326.0,0.75,1.75,0.6875,0.8333333333333333,1.875,
58,10,7,3,7,13,14,6,27,26,328.0,0.9285714285714286,4.285714285714286,1.4897959183673468,2.088095238095238,3.375,
1328,1,0,0,1,1,1,1,2,1,0.0,1.0,0.0,0.0,0.0,0.0,
1179,1,0,0,1,1,1,1,2,1,0.0,1.0,0.0,0.0,0.0,0.0,
657,1,0,0,1,1,1,1,2,1,0.0,1.0,0.0,0.0,0.0,0.0,
402,1,0,0,3,1,3,1,4,3,18.0,0.3333333333333333,1.0,0.0,0.0,1.5,
1207,3,1,0,3,3,4,3,7,6,217.0,0.75,2.0,0.5,0.8333333333333333,1.875,
1160,1,0,0,1,1,1,1,2,1,0.0,1.0,0.0,0.0,0.0,0.0,
1361,1,1,0,2,1,3,1,4,3,19.0,0.3333333333333333,1.0,0.0,0.0,1.5,
950,1,1,0,1,1,2,1,3,2,28.0,0.5,1.0,0.0,0.0,1.0,
871,1,1,0,0,1,1,1,2,1,0.0,1.0,0.0,0.0,0.0,0.0,
946,2,4,0,1,2,5,2,7,6,84.0,0.4,1.2,0.16,0.5,2.5,
262,0,0,1,1,1,1,1,2,1,0.0,1.0,0.0,0.0,0.0,0.0,
612,13,7,2,17,15,24,9,39,38,600.0,0.625,5.958333333333333,4.2899305555555545,1.8746031746031746,3.333984375,
426,3,1,0,5,3,6,2,9,8,126.0,0.5,1.5,0.25,0.6666666666666666,3.0,
133,10,6,2,13,12,19,7,31,30,175.0,0.631578947368421,2.8421052631578947,3.185595567867036,1.5234126984126986,7.0546875,
834,3,2,0,2,3,4,3,7,6,47.0,0.75,2.25,0.1875,1.0,1.875,
600,2,1,0,0,2,1,2,3,2,20.0,2.0,2.0,0.0,1.0,0.5,
36,11,8,2,8,13,16,6,29,28,155.0,0.8125,3.9375,1.93359375,1.6464285714285714,4.53125,
151,5,4,1,6,6,10,5,16,15,94.0,0.6,2.3,1.41,1.0333333333333332,4.40625,
959,6,2,1,2,7,4,6,11,10,333.0,1.75,4.25,3.1875,1.2333333333333334,1.0625,
690,0,1,1,0,1,1,1,2,1,0.0,1.0,0.0,0.0,0.0,0.0,
589,3,3,0,2,3,5,2,8,7,51.0,0.6,1.4,0.24,0.6666666666666666,2.5,
740,2,0,0,2,2,2,2,4,3,52.0,1.0,1.5,0.25,0.5,1.0,
1100,1,1,0,0,1,1,1,2,1,0.0,1.0,0.0,0.0,0.0,0.0,
1172,5,6,0,4,5,10,3,15,14,93.0,0.5,2.2,0.5599999999999999,1.0833333333333333,4.5,
338,24,19,4,27,28,46,12,74,73,1027.0,0.6086956521739131,6.1521739130434785,9.868147448015126,2.6949356199356203,8.22412109375,
541,0,1,1,0,1,1,1,2,1,0.0,1.0,0.0,0.0,0.0,0.0,
41,3,3,2,2,5,5,4,10,9,52.0,1.0,3.6,0.24,1.5,1.5,
956,0,1,1,0,1,1,1,2,1,0.0,1.0,0.0,0.0,0.0,0.0,
107,1,0,1,1,2,1,2,3,2,58.0,2.0,2.0,0.0,1.0,0.5,
1170,4,1,1,3,5,4,5,9,8,204.0,1.25,3.0,2.5,1.0333333333333332,1.40625,
693,1,0,0,1,1,1,1,2,1,0.0,1.0,0.0,0.0,0.0,0.0,
535,1,1,0,0,1,1,1,2,1,0.0,1.0,0.0,0.0,0.0,0.0,
1299,14,4,2,14,16,18,8,34,33,259.0,0.8888888888888888,3.4444444444444446,3.135802469135802,1.6223304473304472,6.1484375,
225,0,0,1,1,1,1,1,2,1,0.0,1.0,0.0,0.0,0.0,0.0,
517,1,1,0,1,1,2,1,3,2,38.0,0.5,1.0,0.0,0.0,1.0,
490,1,0,0,1,1,1,1,2,1,0.0,1.0,0.0,0.0,0.0,0.0,
549,0,1,1,0,1,1,1,2,1,0.0,1.0,0.0,0.0,0.0,0.0,
628,0,0,1,1,1,1,1,2,1,0.0,1.0,0.0,0.0,0.0,0.0,
164,1,2,1,5,2,7,2,9,8,161.0,0.2857142857142857,1.5714285714285714,0.24489795918367346,0.5,3.5,
571,5,2,0,5,5,7,3,12,11,132.0,0.7142857142857143,2.0,0.5714285714285714,1.0833333333333333,3.25,
447,1,0,0,2,1,2,1,3,2,7.0,0.5,1.0,0.0,0.0,1.0,
237,0,0,1,1,1,1,1,2,1,0.0,1.0,0.0,0.0,0.0,0.0,
1114,2,0,0,1,2,1,2,3,2,79.0,2.0,2.0,0.0,1.0,0.5,
343,3,3,1,3,4,6,3,10,9,78.0,0.6666666666666666,2.1666666666666665,0.47222222222222215,0.8333333333333333,2.75,
1033,0,0,1,1,1,1,1,2,1,0.0,1.0,0.0,0.0,0.0,0.0,
167,0,0,1,1,1,1,1,2,1,0.0,1.0,0.0,0.0,0.0,0.0,
458,1,0,0,1,1,1,1,2,1,0.0,1.0,0.0,0.0,0.0,0.0,
1128,2,4,0,1,2,5,2,7,6,216.0,0.4,1.8,0.16,0.5,2.5,
63,2,2,1,0,3,2,3,5,4,29.0,1.5,2.5,0.25,1.0,0.875,
1272,9,5,1,8,10,13,6,23,22,202.0,0.7692307692307693,3.6153846153846154,1.467455621301775,1.7666666666666668,3.90625,
215,3,1,1,4,4,5,3,9,8,82.0,0.8,2.6,0.24,1.1666666666666665,2.125,
825,1,0,2,1,3,1,3,4,3,39.0,3.0,3.0,0.0,1.5,0.375,
937,1,1,0,0,1,1,1,2,1,0.0,1.0,0.0,0.0,0.0,0.0,
1342,1,0,0,2,1,2,1,3,2,45.0,0.5,1.0,0.0,0.0,1.0,
1226,4,1,4,5,8,6,6,14,13,404.0,1.3333333333333333,3.8333333333333335,2.4722222222222228,1.4666666666666666,1.625,
1088,1,0,0,1,1,1,1,2,1,0.0,1.0,0.0,0.0,0.0,0.0,
1113,1,0,0,1,1,1,1,2,1,0.0,1.0,0.0,0.0,0.0,0.0,
1349,6,6,0,8,6,14,6,20,19,450.0,0.42857142857142855,3.857142857142857,1.2653061224489797,1.2333333333333334,3.90625,
870,1,1,0,1,1,2,1,3,2,132.0,0.5,1.0,0.0,0.0,1.0,
694,3,0,0,3,3,3,3,6,5,183.0,1.0,2.3333333333333335,0.8888888888888888,0.8333333333333333,1.25,
531,1,0,1,1,2,1,2,3,2,2.0,2.0,2.0,0.0,1.0,0.5,
158,0,2,2,0,2,2,2,4,3,4.0,1.0,1.5,0.25,0.5,1.0,
773,1,1,0,0,1,1,1,2,1,0.0,1.0,0.0,0.0,0.0,0.0,
1120,1,1,0,0,1,1,1,2,1,0.0,1.0,0.0,0.0,0.0,0.0,
843,5,5,0,3,5,8,3,13,12,219.0,0.625,2.0,0.25,1.0833333333333333,3.875,
978,1,0,0,1,1,1,1,2,1,0.0,1.0,0.0,0.0,0.0,0.0,
128,4,1,1,6,5,7,5,12,11,112.0,0.7142857142857143,3.142857142857143,0.9795918367346937,1.1666666666666665,2.53125,
119,9,4,2,8,11,12,5,23,22,155.0,0.9166666666666666,2.8333333333333335,1.472222222222222,1.711904761904762,4.6875,
965,1,1,0,1,1,2,1,3,2,18.0,0.5,1.0,0.0,0.0,1.0,
574,1,0,0,1,1,1,1,2,1,0.0,1.0,0.0,0.0,0.0,0.0,
1023,1,0,0,1,1,1,1,2,1,0.0,1.0,0.0,0.0,0.0,0.0,
609,2,1,0,4,2,5,2,7,6,87.0,0.4,1.2,0.16,0.5,2.5,
443,7,4,0,6,7,10,6,17,16,204.0,0.7,4.1,3.29,1.2333333333333334,2.625,
1327,1,0,0,1,1,1,1,2,1,0.0,1.0,0.0,0.0,0.0,0.0,
475,2,1,0,1,2,2,2,4,3,29.0,1.0,1.5,0.25,0.5,1.0,
1048,2,0,0,2,2,2,2,4,3,35.0,1.0,1.5,0.25,0.5,1.0,
470,3,1,0,3,3,4,3,7,6,76.0,0.75,1.75,0.6875,0.8333333333333333,1.875,
683,1,0,1,1,2,1,2,3,2,9.0,2.0,2.0,0.0,1.0,0.5,
474,2,0,0,2,2,2,2,4,3,58.0,1.0,1.5,0.25,0.5,1.0,
476,1,1,0,1,1,2,1,3,2,18.0,0.5,1.0,0.0,0.0,1.0,
1099,1,0,0,1,1,1,1,2,1,0.0,1.0,0.0,0.0,0.0,0.0,
1035,0,0,2,1,2,1,2,3,2,43.0,2.0,2.0,0.0,1.0,0.5,
60,1,1,1,9,2,10,2,12,11,258.0,0.2,1.8,0.16000000000000003,0.5,5.0,
234,7,5,2,16,9,21,5,30,29,470.0,0.42857142857142855,2.5714285714285716,1.673469387755102,1.5666666666666667,8.28125,
615,2,1,0,3,2,4,2,6,5,111.0,0.5,1.25,0.1875,0.5,2.0,
725,3,1,0,7,3,8,3,11,10,345.0,0.375,2.0,0.75,0.8333333333333333,3.625,
1254,1,0,1,1,2,1,2,3,2,1.0,2.0,2.0,0.0,1.0,0.5,
755,0,1,1,0,1,1,1,2,1,0.0,1.0,0.0,0.0,0.0,0.0,
1362,1,0,0,1,1,1,1,2,1,0.0,1.0,0.0,0.0,0.0,0.0,
1238,1,1,0,0,1,1,1,2,1,0.0,1.0,0.0,0.0,0.0,0.0,
1067,2,3,0,3,2,6,2,8,7,236.0,0.3333333333333333,1.6666666666666667,0.22222222222222224,0.5,3.0,
768,1,0,1,2,2,2,2,4,3,157.0,1.0,1.5,0.25,0.5,1.0,
733,0,0,1,1,1,1,1,2,1,0.0,1.0,0.0,0.0,0.0,0.0,
916,2,0,0,1,2,1,2,3,2,72.0,2.0,2.0,0.0,1.0,0.5,
583,1,0,0,1,1,1,1,2,1,0.0,1.0,0.0,0.0,0.0,0.0,
457,1,0,0,1,1,1,1,2,1,0.0,1.0,0.0,0.0,0.0,0.0,
302,2,0,0,1,2,1,2,3,2,26.0,2.0,2.0,0.0,1.0,0.5,
814,4,3,0,4,4,7,3,11,10,259.0,0.5714285714285714,1.7142857142857142,0.489795918367347,0.8333333333333333,3.375,
192,0,1,1,0,1,1,1,2,1,0.0,1.0,0.0,0.0,0.0,0.0,
1144,1,1,1,1,2,2,2,4,3,92.0,1.0,1.5,0.25,0.5,1.0,
865,4,1,0,3,4,4,3,8,7,56.0,1.0,2.0,0.5,0.8333333333333333,1.875,
92,11,1,3,7,14,8,5,22,21,164.0,1.75,3.875,1.109375,1.9380952380952379,2.21875,
777,2,0,0,1,2,1,2,3,2,6.0,2.0,2.0,0.0,1.0,0.5,
1268,3,0,0,2,3,2,3,5,4,170.0,1.5,3.0,0.0,1.5,0.75,
334,1,0,0,1,1,1,1,2,1,0.0,1.0,0.0,0.0,0.0,0.0,
542,2,1,0,0,2,1,2,3,2,79.0,2.0,2.0,0.0,1.0,0.5,
412,9,5,0,12,9,17,5,26,25,251.0,0.5294117647058824,3.588235294117647,1.7716262975778552,1.6,5.1875,
1263,4,1,0,1,4,2,4,6,5,131.0,2.0,2.5,2.25,0.9166666666666666,0.75,
811,1,0,0,1,1,1,1,2,1,0.0,1.0,0.0,0.0,0.0,0.0,
281,2,0,0,2,2,2,2,4,3,6.0,1.0,1.5,0.25,0.5,1.0,
188,7,3,3,7,10,10,5,20,19,133.0,1.0,3.1,1.29,1.8,3.53125,
138,2,0,1,4,3,4,3,7,6,125.0,0.75,2.75,0.1875,1.0,1.625,
668,1,0,0,1,1,1,1,2,1,0.0,1.0,0.0,0.0,0.0,0.0,
998,1,0,0,1,1,1,1,2,1,0.0,1.0,0.0,0.0,0.0,0.0,
1271,1,1,0,0,1,1,1,2,1,0.0,1.0,0.0,0.0,0.0,0.0,
552,1,0,0,1,1,1,1,2,1,0.0,1.0,0.0,0.0,0.0,0.0,
1239,4,3,0,3,4,6,3,10,9,98.0,0.6666666666666666,2.0,0.3333333333333333,0.8333333333333333,2.875,
431,2,1,0,3,2,4,2,6,5,70.0,0.5,2.0,0.0,1.0,2.0,
410,1,0,0,1,1,1,1,2,1,0.0,1.0,0.0,0.0,0.0,0.0,
637,1,0,0,1,1,1,1,2,1,0.0,1.0,0.0,0.0,0.0,0.0,
1084,2,0,0,2,2,2,2,4,3,13.0,1.0,2.0,0.0,1.0,1.0,
364,2,0,0,1,2,1,2,3,2,37.0,2.0,2.0,0.0,1.0,0.5,
379,2,0,0,2,2,2,2,4,3,38.0,1.0,2.0,0.0,1.0,1.0,
695,1,0,0,2,1,2,1,3,2,12.0,0.5,1.0,0.0,0.0,1.0,
154,2,3,1,5,3,8,3,11,10,111.0,0.375,2.375,0.484375,0.8333333333333333,3.5,
340,3,2,1,4,4,6,4,10,9,215.0,0.6666666666666666,1.8333333333333333,1.4722222222222223,0.9166666666666665,2.625,
321,1,1,0,2,1,3,1,4,3,42.0,0.3333333333333333,1.0,0.0,0.0,1.5,
1094,1,1,0,0,1,1,1,2,1,0.0,1.0,0.0,0.0,0.0,0.0,
191,3,2,1,3,4,5,4,9,8,47.0,0.8,3.2,0.15999999999999998,1.3333333333333333,1.75,
1209,2,1,1,4,3,5,2,8,7,79.0,0.6,1.6,0.24,0.6666666666666666,2.5,
639,1,1,0,0,1,1,1,2,1,0.0,1.0,0.0,0.0,0.0,0.0,
1353,3,0,0,1,3,1,3,4,3,47.0,3.0,3.0,0.0,1.5,0.375,
499,1,0,0,1,1,1,1,2,1,0.0,1.0,0.0,0.0,0.0,0.0,
986,11,9,0,10,11,19,6,30,29,383.0,0.5789473684210527,3.263157894736842,1.983379501385041,1.5547619047619048,6.75,
465,1,1,0,1,1,2,1,3,2,62.0,0.5,1.0,0.0,0.0,1.0,
1135,1,2,0,0,1,2,1,3,2,34.0,0.5,1.0,0.0,0.0,1.0,
708,2,2,1,1,3,3,2,6,5,162.0,1.0,1.6666666666666667,0.2222222222222222,0.6666666666666666,1.5,
105,5,4,1,4,6,8,4,14,13,283.0,0.75,3.25,0.6875,1.4166666666666665,2.75,
981,1,0,0,3,1,3,1,4,3,15.0,0.3333333333333333,1.0,0.0,0.0,1.5,
1096,1,2,0,0,1,2,1,3,2,31.0,0.5,1.0,0.0,0.0,1.0,
1283,1,0,0,1,1,1,1,2,1,0.0,1.0,0.0,0.0,0.0,0.0,
422,0,0,2,1,2,1,2,3,2,47.0,2.0,2.0,0.0,1.0,0.5,
1219,5,1,0,5,5,6,3,11,10,159.0,0.8333333333333334,2.0,0.6666666666666666,1.0833333333333333,2.75,
1104,9,2,0,4,9,6,5,15,14,110.0,1.5,3.1666666666666665,1.472222222222222,1.2357142857142858,2.15625,
117,0,0,1,2,1,2,1,3,2,0.0,0.5,1.0,0.0,0.0,1.0,
899,1,1,0,0,1,1,1,2,1,0.0,1.0,0.0,0.0,0.0,0.0,
288,1,1,0,1,1,2,1,3,2,24.0,0.5,1.0,0.0,0.0,1.0,
724,3,2,0,2,3,4,3,7,6,132.0,0.75,1.75,0.6875,0.8333333333333333,1.875,
269,1,0,0,2,1,2,1,3,2,0.0,0.5,1.0,0.0,0.0,1.0,
928,8,4,1,7,9,11,4,20,19,151.0,0.8181818181818182,2.6363636363636362,0.9586776859504134,1.5499999999999998,4.5,
256,0,0,1,1,1,1,1,2,1,0.0,1.0,0.0,0.0,0.0,0.0,
548,1,2,1,0,2,2,2,4,3,32.0,1.0,1.5,0.25,0.5,1.0,
934,1,3,0,2,1,5,1,6,5,144.0,0.2,1.0,0.0,0.0,2.5,
585,0,0,1,1,1,1,1,2,1,0.0,1.0,0.0,0.0,0.0,0.0,
872,0,1,1,0,1,1,1,2,1,0.0,1.0,0.0,0.0,0.0,0.0,
869,2,1,0,1,2,2,2,4,3,8.0,1.0,1.5,0.25,0.5,1.0,
1269,1,2,0,0,1,2,1,3,2,23.0,0.5,1.0,0.0,0.0,1.0,
245,0,1,1,0,1,1,1,2,1,0.0,1.0,0.0,0.0,0.0,0.0,
1027,2,0,0,1,2,1,2,3,2,22.0,2.0,2.0,0.0,1.0,0.5,
1018,1,1,0,1,1,2,1,3,2,31.0,0.5,1.0,0.0,0.0,1.0,
1223,1,1,0,1,1,2,1,3,2,0.0,0.5,1.0,0.0,0.0,1.0,
289,1,0,0,1,1,1,1,2,1,0.0,1.0,0.0,0.0,0.0,0.0,
691,1,1,0,1,1,2,1,3,2,17.0,0.5,1.0,0.0,0.0,1.0,
156,0,1,1,1,1,2,1,3,2,58.0,0.5,1.0,0.0,0.0,1.0,
653,2,0,0,1,2,1,2,3,2,27.0,2.0,2.0,0.0,1.0,0.5,
185,0,1,1,0,1,1,1,2,1,0.0,1.0,0.0,0.0,0.0,0.0,
1061,1,1,0,0,1,1,1,2,1,0.0,1.0,0.0,0.0,0.0,0.0,
30,2,2,1,2,3,4,3,7,6,96.0,0.75,2.5,0.75,0.8333333333333333,1.625,
575,1,0,0,2,1,2,1,3,2,46.0,0.5,1.0,0.0,0.0,1.0,
405,0,1,1,0,1,1,1,2,1,0.0,1.0,0.0,0.0,0.0,0.0,
741,1,1,1,1,2,2,2,4,3,40.0,1.0,1.5,0.25,0.5,1.0,
1002,2,2,0,1,2,3,2,5,4,62.0,0.6666666666666666,1.3333333333333333,0.2222222222222222,0.5,1.5,
1211,2,0,1,1,3,1,3,4,3,109.0,3.0,3.0,0.0,1.5,0.375,
984,3,0,0,1,3,1,3,4,3,57.0,3.0,3.0,0.0,1.5,0.375,
582,9,1,1,10,10,11,6,21,20,461.0,0.9090909090909091,4.0,2.0,1.2357142857142858,2.875,
1175,1,1,0,0,1,1,1,2,1,0.0,1.0,0.0,0.0,0.0,0.0,
520,5,2,0,4,5,6,4,11,10,213.0,0.8333333333333334,2.3333333333333335,1.2222222222222223,0.9833333333333334,2.5,
709,3,1,0,1,3,2,3,5,4,101.0,1.5,2.0,1.0,0.8333333333333333,0.875,
635,1,1,0,0,1,1,1,2,1,0.0,1.0,0.0,0.0,0.0,0.0,
626,0,0,1,1,1,1,1,2,1,0.0,1.0,0.0,0.0,0.0,0.0,
1142,1,0,0,1,1,1,1,2,1,0.0,1.0,0.0,0.0,0.0,0.0,
1095,1,0,0,1,1,1,1,2,1,0.0,1.0,0.0,0.0,0.0,0.0,
754,1,1,0,1,1,2,1,3,2,3.0,0.5,1.0,0.0,0.0,1.0,
910,1,0,0,3,1,3,1,4,3,23.0,0.3333333333333333,1.0,0.0,0.0,1.5,
372,1,0,0,2,1,2,1,3,2,7.0,0.5,1.0,0.0,0.0,1.0,
1097,1,0,0,1,1,1,1,2,1,0.0,1.0,0.0,0.0,0.0,0.0,
797,12,10,2,20,14,30,6,44,43,594.0,0.4666666666666667,2.7666666666666666,1.712222222222222,2.007142857142857,11.84375,
1006,1,1,0,0,1,1,1,2,1,0.0,1.0,0.0,0.0,0.0,0.0,
1133,1,0,0,1,1,1,1,2,1,0.0,1.0,0.0,0.0,0.0,0.0,
614,1,1,0,0,1,1,1,2,1,0.0,1.0,0.0,0.0,0.0,0.0,
1369,1,0,0,1,1,1,1,2,1,0.0,1.0,0.0,0.0,0.0,0.0,
656,7,5,2,11,9,16,4,25,24,289.0,0.5625,2.6875,0.96484375,1.5499999999999998,6.375,
876,1,0,0,1,1,1,1,2,1,0.0,1.0,0.0,0.0,0.0,0.0,
1350,1,0,0,1,1,1,1,2,1,0.0,1.0,0.0,0.0,0.0,0.0,
308,1,0,0,2,1,2,1,3,2,3.0,0.5,1.0,0.0,0.0,1.0,
497,1,0,0,1,1,1,1,2,1,0.0,1.0,0.0,0.0,0.0,0.0,
796,1,0,0,1,1,1,1,2,1,0.0,1.0,0.0,0.0,0.0,0.0,
917,1,1,0,0,1,1,1,2,1,0.0,1.0,0.0,0.0,0.0,0.0,
839,0,1,1,0,1,1,1,2,1,0.0,1.0,0.0,0.0,0.0,0.0,
553,0,0,1,1,1,1,1,2,1,0.0,1.0,0.0,0.0,0.0,0.0,
500,1,0,0,1,1,1,1,2,1,0.0,1.0,0.0,0.0,0.0,0.0,
1121,17,10,0,20,17,30,6,47,46,628.0,0.5666666666666667,3.3666666666666667,3.765555555555554,2.707142857142857,9.28125,
129,7,2,1,3,8,5,7,13,12,72.0,1.6,5.6,1.8399999999999999,1.65,0.7109375,
1233,1,0,0,1,1,1,1,2,1,0.0,1.0,0.0,0.0,0.0,0.0,
621,3,2,0,1,3,3,2,6,5,41.0,1.0,1.6666666666666667,0.2222222222222222,0.6666666666666666,1.5,
809,2,1,2,1,4,2,4,6,5,55.0,2.0,2.5,2.25,0.9166666666666665,0.75,
508,1,0,0,1,1,1,1,2,1,0.0,1.0,0.0,0.0,0.0,0.0,
5,12,9,1,13,13,22,6,35,34,170.0,0.5909090909090909,3.272727272727273,2.289256198347107,1.888095238095238,7.25,
486,1,1,1,0,2,1,2,3,2,9.0,2.0,2.0,0.0,1.0,0.5,
783,1,0,0,1,1,1,1,2,1,0.0,1.0,0.0,0.0,0.0,0.0,
799,2,2,0,3,2,5,2,7,6,46.0,0.4,2.0,0.0,1.0,2.5,
179,6,3,1,1,7,4,4,11,10,158.0,1.75,4.0,0.0,1.4333333333333331,1.0,
381,0,0,1,1,1,1,1,2,1,0.0,1.0,0.0,0.0,0.0,0.0,
596,1,0,0,2,1,2,1,3,2,11.0,0.5,1.0,0.0,0.0,1.0,
506,1,1,1,0,2,1,2,3,2,7.0,2.0,2.0,0.0,1.0,0.5,
20,11,7,1,16,12,23,6,35,34,240.0,0.5217391304347826,3.4782608695652173,2.249527410207939,1.9785714285714284,7.65625,
561,1,3,0,5,1,8,1,9,8,147.0,0.125,1.0,0.0,0.0,4.0,
594,1,0,0,2,1,2,1,3,2,6.0,0.5,1.0,0.0,0.0,1.0,
204,0,1,2,0,2,1,2,3,2,2.0,2.0,2.0,0.0,1.0,0.5,
955,2,0,0,2,2,2,2,4,3,44.0,1.0,2.0,0.0,1.0,1.0,
933,2,3,0,3,2,6,2,8,7,57.0,0.3333333333333333,1.1666666666666667,0.13888888888888887,0.5,3.0,
157,8,3,2,7,10,10,5,20,19,173.0,1.0,2.5,1.45,1.3785714285714286,4.15625,
919,2,0,0,1,2,1,2,3,2,41.0,2.0,2.0,0.0,1.0,0.5,
559,1,0,0,2,1,2,1,3,2,7.0,0.5,1.0,0.0,0.0,1.0,
866,1,0,0,1,1,1,1,2,1,0.0,1.0,0.0,0.0,0.0,0.0,
301,1,0,0,1,1,1,1,2,1,0.0,1.0,0.0,0.0,0.0,0.0,
309,1,0,0,1,1,1,1,2,1,0.0,1.0,0.0,0.0,0.0,0.0,
530,5,2,0,3,5,5,4,10,9,118.0,1.0,2.6,1.0400000000000003,0.9833333333333334,2.0,
1310,4,5,0,5,4,10,3,14,13,179.0,0.4,1.9,0.29000000000000004,0.8333333333333333,4.875,
277,1,0,0,2,1,2,1,3,2,33.0,0.5,1.0,0.0,0.0,1.0,
720,1,0,0,1,1,1,1,2,1,0.0,1.0,0.0,0.0,0.0,0.0,
176,3,4,1,0,4,4,3,8,7,101.0,1.0,2.5,0.75,1.1666666666666665,1.625,
734,1,1,0,0,1,1,1,2,1,0.0,1.0,0.0,0.0,0.0,0.0,
598,19,9,1,15,20,24,8,44,43,557.0,0.8333333333333334,4.708333333333333,6.039930555555556,2.3603174603174604,5.5,
1253,8,3,1,7,9,10,6,19,18,302.0,0.9,3.9,2.89,1.6333333333333333,2.8125,
994,1,2,0,1,1,3,1,4,3,70.0,0.3333333333333333,1.0,0.0,0.0,1.5,
1376,2,0,1,2,3,2,3,5,4,87.0,1.5,2.0,1.0,0.8333333333333333,0.875,
1331,1,1,0,0,1,1,1,2,1,0.0,1.0,0.0,0.0,0.0,0.0,
18,8,3,3,8,11,11,6,22,21,176.0,1.0,3.6363636363636362,2.0495867768595044,1.5547619047619048,3.3125,
976,0,0,1,1,1,1,1,2,1,0.0,1.0,0.0,0.0,0.0,0.0,
1109,2,0,0,1,2,1,2,3,2,26.0,2.0,2.0,0.0,1.0,0.5,
672,6,0,0,5,6,5,3,11,10,130.0,1.2,2.4,0.64,1.1,2.125,
311,1,1,0,0,1,1,1,2,1,0.0,1.0,0.0,0.0,0.0,0.0,
610,0,0,1,1,1,1,1,2,1,0.0,1.0,0.0,0.0,0.0,0.0,
453,3,3,0,1,3,4,3,7,6,44.0,0.75,2.25,0.6875,0.8333333333333333,1.75,
477,1,0,0,2,1,2,1,3,2,35.0,0.5,1.0,0.0,0.0,1.0,
4,0,0,1,1,1,1,1,2,1,0.0,1.0,0.0,0.0,0.0,0.0,
1008,1,1,0,1,1,2,1,3,2,17.0,0.5,1.0,0.0,0.0,1.0,
785,2,0,0,1,2,1,2,3,2,31.0,2.0,2.0,0.0,1.0,0.5,
273,0,0,1,1,1,1,1,2,1,0.0,1.0,0.0,0.0,0.0,0.0,
213,0,1,1,0,1,1,1,2,1,0.0,1.0,0.0,0.0,0.0,0.0,
1055,0,0,1,2,1,2,1,3,2,6.0,0.5,1.0,0.0,0.0,1.0,
322,1,0,0,1,1,1,1,2,1,0.0,1.0,0.0,0.0,0.0,0.0,
160,0,0,1,1,1,1,1,2,1,0.0,1.0,0.0,0.0,0.0,0.0,
82,0,1,1,2,1,3,1,4,3,6.0,0.3333333333333333,1.0,0.0,0.0,1.5,
992,4,1,0,3,4,4,4,8,7,123.0,1.0,2.5,1.25,0.9166666666666665,1.625,
592,1,0,0,1,1,1,1,2,1,0.0,1.0,0.0,0.0,0.0,0.0,
1029,1,0,0,1,1,1,1,2,1,0.0,1.0,0.0,0.0,0.0,0.0,
623,1,0,0,1,1,1,1,2,1,0.0,1.0,0.0,0.0,0.0,0.0,
274,0,0,1,1,1,1,1,2,1,0.0,1.0,0.0,0.0,0.0,0.0,
761,1,0,0,1,1,1,1,2,1,0.0,1.0,0.0,0.0,0.0,0.0,
618,1,1,1,0,2,1,2,3,2,110.0,2.0,2.0,0.0,1.0,0.5,
12,13,7,2,6,15,13,7,28,27,133.0,1.1538461538461537,3.6923076923076925,3.751479289940828,1.9936507936507937,4.109375,
181,9,6,2,16,11,22,4,33,32,225.0,0.5,2.8636363636363638,0.6632231404958677,1.9166666666666667,8.5,
26,1,1,1,2,2,3,2,5,4,64.0,0.6666666666666666,1.3333333333333333,0.2222222222222222,0.5,1.5,
1041,1,0,0,1,1,1,1,2,1,0.0,1.0,0.0,0.0,0.0,0.0,
419,1,0,0,1,1,1,1,2,1,0.0,1.0,0.0,0.0,0.0,0.0,
849,1,1,0,0,1,1,1,2,1,0.0,1.0,0.0,0.0,0.0,0.0,
241,0,0,1,5,1,5,1,6,5,114.0,0.2,1.0,0.0,0.0,2.5,
1016,8,6,1,14,9,20,5,29,28,213.0,0.45,3.05,1.6475000000000004,1.4357142857142857,7.09375,
827,7,6,2,6,9,12,6,21,20,512.0,0.75,3.25,2.0208333333333335,1.633333333333333,4.28125,
145,7,7,2,8,9,15,4,24,23,138.0,0.6,2.466666666666667,0.648888888888889,1.55,6.375,
1264,2,0,2,2,4,2,4,6,5,338.0,2.0,4.0,0.0,1.8333333333333333,0.5,
829,0,0,1,1,1,1,1,2,1,0.0,1.0,0.0,0.0,0.0,0.0,
1190,7,6,0,5,7,11,3,18,17,245.0,0.6363636363636364,2.4545454545454546,0.24793388429752064,1.3499999999999999,4.875,
909,1,0,0,1,1,1,1,2,1,0.0,1.0,0.0,0.0,0.0,0.0,
1325,4,1,0,3,4,4,4,8,7,119.0,1.0,2.5,1.25,0.9166666666666665,1.625,
1138,0,1,1,0,1,1,1,2,1,0.0,1.0,0.0,0.0,0.0,0.0,
1164,1,0,0,1,1,1,1,2,1,0.0,1.0,0.0,0.0,0.0,0.0,
1240,3,4,0,2,3,6,2,9,8,114.0,0.5,1.5,0.25,0.6666666666666666,3.0,
1123,2,1,0,2,2,3,2,5,4,94.0,0.6666666666666666,1.6666666666666667,0.2222222222222222,0.5,1.5,
1045,0,0,1,1,1,1,1,2,1,0.0,1.0,0.0,0.0,0.0,0.0,
276,0,0,1,2,1,2,1,3,2,138.0,0.5,1.0,0.0,0.0,1.0,
162,3,1,1,4,4,5,3,9,8,105.0,0.8,2.4,0.24,1.1666666666666665,2.25,
915,1,0,0,1,1,1,1,2,1,0.0,1.0,0.0,0.0,0.0,0.0,
1311,3,3,0,4,3,7,3,10,9,84.0,0.42857142857142855,2.2857142857142856,0.48979591836734704,0.8333333333333333,3.125,
352,2,0,0,3,2,3,2,5,4,116.0,0.6666666666666666,1.3333333333333333,0.2222222222222222,0.5,1.5,
28,5,5,2,8,7,13,4,20,19,159.0,0.5384615384615384,2.8461538461538463,1.0532544378698225,1.019047619047619,5.0,
130,2,4,2,1,4,5,3,9,8,46.0,0.8,2.2,0.15999999999999998,0.8333333333333333,2.375,
49,1,1,1,4,2,5,2,7,6,124.0,0.4,1.4,0.24,0.5,2.5,
891,1,1,0,2,1,3,1,4,3,149.0,0.3333333333333333,1.0,0.0,0.0,1.5,
420,2,1,1,1,3,2,3,5,4,58.0,1.5,2.0,1.0,0.8333333333333333,0.875,
975,1,2,0,2,1,4,1,5,4,47.0,0.25,1.0,0.0,0.0,2.0,
1262,2,0,0,1,2,1,2,3,2,13.0,2.0,2.0,0.0,1.0,0.5,
654,1,0,0,1,1,1,1,2,1,0.0,1.0,0.0,0.0,0.0,0.0,
836,0,1,1,0,1,1,1,2,1,0.0,1.0,0.0,0.0,0.0,0.0,
370,2,0,0,1,2,1,2,3,2,8.0,2.0,2.0,0.0,1.0,0.5,
1044,8,3,1,6,9,9,6,18,17,247.0,1.0,4.666666666666667,0.8888888888888887,1.6333333333333333,1.78125,
1014,1,0,0,1,1,1,1,2,1,0.0,1.0,0.0,0.0,0.0,0.0,
299,1,0,1,1,2,1,2,3,2,27.0,2.0,2.0,0.0,1.0,0.5,
525,1,0,0,1,1,1,1,2,1,0.0,1.0,0.0,0.0,0.0,0.0,
374,0,1,1,0,1,1,1,2,1,0.0,1.0,0.0,0.0,0.0,0.0,
360,1,1,0,1,1,2,1,3,2,11.0,0.5,1.0,0.0,0.0,1.0,
211,0,0,1,1,1,1,1,2,1,0.0,1.0,0.0,0.0,0.0,0.0,
685,1,1,0,0,1,1,1,2,1,0.0,1.0,0.0,0.0,0.0,0.0,
566,5,4,1,4,6,8,6,14,13,189.0,0.75,5.125,0.859375,1.6166666666666665,1.28125,
792,1,1,0,1,1,2,1,3,2,41.0,0.5,1.0,0.0,0.0,1.0,
1237,1,0,0,1,1,1,1,2,1,0.0,1.0,0.0,0.0,0.0,0.0,
1143,1,1,0,1,1,2,1,3,2,30.0,0.5,1.0,0.0,0.0,1.0,
914,2,2,0,2,2,4,2,6,5,187.0,0.5,1.75,0.1875,0.5,2.0,
700,1,1,0,1,1,2,1,3,2,3.0,0.5,1.0,0.0,0.0,1.0,
800,2,1,0,0,2,1,2,3,2,64.0,2.0,2.0,0.0,1.0,0.5,
1132,1,0,1,2,2,2,2,4,3,40.0,1.0,1.5,0.25,0.5,1.0,
617,1,1,1,1,2,2,2,4,3,72.0,1.0,2.0,0.0,1.0,1.0,
460,1,1,1,0,2,1,2,3,2,8.0,2.0,2.0,0.0,1.0,0.5,
72,0,0,1,1,1,1,1,2,1,0.0,1.0,0.0,0.0,0.0,0.0,
3,11,6,1,13,12,19,7,31,30,225.0,0.631578947368421,3.263157894736842,2.4044321329639886,1.5829365079365079,6.765625,
1080,0,0,2,1,2,1,2,3,2,15.0,2.0,2.0,0.0,1.0,0.5,
1082,1,0,0,2,1,2,1,3,2,17.0,0.5,1.0,0.0,0.0,1.0,
991,3,3,1,1,4,4,4,8,7,140.0,1.0,3.0,1.5,0.9166666666666665,1.375,
1098,1,0,0,1,1,1,1,2,1,0.0,1.0,0.0,0.0,0.0,0.0,
898,1,0,0,1,1,1,1,2,1,0.0,1.0,0.0,0.0,0.0,0.0,
996,2,0,0,1,2,1,2,3,2,3.0,2.0,2.0,0.0,1.0,0.5,
335,1,0,0,1,1,1,1,2,1,0.0,1.0,0.0,0.0,0.0,0.0,
692,3,2,0,4,3,6,2,9,8,106.0,0.5,1.5,0.25,0.6666666666666666,3.0,
96,3,3,3,3,6,6,4,12,11,155.0,1.0,3.1666666666666665,1.1388888888888888,1.4166666666666665,2.0,
84,11,10,2,10,13,20,6,33,32,119.0,0.65,3.55,3.5475000000000003,1.8464285714285713,6.15625,
1306,1,1,0,1,1,2,1,3,2,22.0,0.5,1.0,0.0,0.0,1.0,
376,3,3,0,6,3,9,2,12,11,205.0,0.3333333333333333,1.4444444444444444,0.2469135802469136,0.6666666666666666,4.5,
1202,0,1,1,0,1,1,1,2,1,0.0,1.0,0.0,0.0,0.0,0.0,
718,5,1,0,4,5,5,4,10,9,86.0,1.0,2.8,0.96,1.1666666666666665,1.875,
15,12,4,3,12,15,16,7,31,30,174.0,0.9375,4.125,2.734375,1.7634920634920637,4.3671875,
1251,5,2,1,2,6,4,6,10,9,158.0,1.5,3.25,5.1875,1.0666666666666667,1.25,
230,2,0,2,2,4,2,4,6,5,129.0,2.0,3.5,0.25,1.3333333333333333,0.625,
481,3,0,0,5,3,5,3,8,7,131.0,0.6,1.4,0.64,0.8333333333333333,2.375,
1159,3,6,1,4,4,10,3,14,13,206.0,0.4,2.3,0.41,0.8333333333333333,4.5,
250,0,0,1,1,1,1,1,2,1,0.0,1.0,0.0,0.0,0.0,0.0,
1217,6,4,0,9,6,13,5,19,18,322.0,0.46153846153846156,2.923076923076923,2.686390532544379,1.2333333333333334,4.625,
395,14,3,1,16,15,19,8,34,33,398.0,0.7894736842105263,5.578947368421052,3.6121883656509697,1.9202380952380953,3.125,
43,0,0,1,1,1,1,1,2,1,0.0,1.0,0.0,0.0,0.0,0.0,
330,0,0,1,1,1,1,1,2,1,0.0,1.0,0.0,0.0,0.0,0.0,
664,2,1,0,1,2,2,2,4,3,12.0,1.0,2.0,0.0,1.0,1.0,
1284,2,1,0,5,2,6,2,8,7,121.0,0.3333333333333333,1.6666666666666667,0.22222222222222224,0.5,3.0,
89,3,3,1,4,4,7,4,11,10,109.0,0.5714285714285714,2.7142857142857144,0.7755102040816327,0.9166666666666665,2.75,
61,2,0,1,3,3,3,3,6,5,158.0,1.0,2.0,0.6666666666666666,0.8333333333333333,1.375,
298,0,0,1,1,1,1,1,2,1,0.0,1.0,0.0,0.0,0.0,0.0,
573,1,1,0,0,1,1,1,2,1,0.0,1.0,0.0,0.0,0.0,0.0,
286,1,0,0,1,1,1,1,2,1,0.0,1.0,0.0,0.0,0.0,0.0,
442,1,0,0,1,1,1,1,2,1,0.0,1.0,0.0,0.0,0.0,0.0,
1256,2,0,0,3,2,3,2,5,4,35.0,0.6666666666666666,2.0,0.0,1.0,1.5,
1021,2,2,1,4,3,6,2,9,8,266.0,0.5,1.3333333333333333,0.2222222222222222,0.6666666666666666,3.0,
1107,1,0,0,1,1,1,1,2,1,0.0,1.0,0.0,0.0,0.0,0.0,
677,2,0,0,1,2,1,2,3,2,6.0,2.0,2.0,0.0,1.0,0.5,
926,1,1,0,4,1,5,1,6,5,76.0,0.2,1.0,0.0,0.0,2.5,
522,2,0,0,4,2,4,2,6,5,25.0,0.5,2.0,0.0,1.0,2.0,
498,1,0,0,2,1,2,1,3,2,95.0,0.5,1.0,0.0,0.0,1.0,
995,1,0,0,1,1,1,1,2,1,0.0,1.0,0.0,0.0,0.0,0.0,
1169,4,4,0,5,4,9,3,13,12,401.0,0.4444444444444444,2.111111111111111,0.54320987654321,1.1666666666666665,4.125,
33,0,1,1,1,1,2,1,3,2,4.0,0.5,1.0,0.0,0.0,1.0,
900,2,0,0,2,2,2,2,4,3,22.0,1.0,1.5,0.25,0.5,1.0,
1292,1,1,0,0,1,1,1,2,1,0.0,1.0,0.0,0.0,0.0,0.0,
1165,1,0,0,1,1,1,1,2,1,0.0,1.0,0.0,0.0,0.0,0.0,
655,4,1,1,5,5,6,4,11,10,226.0,0.8333333333333334,2.8333333333333335,1.1388888888888888,1.1666666666666665,2.25,
65,6,3,3,3,9,6,6,15,14,252.0,1.5,4.833333333333333,0.47222222222222215,1.1246031746031746,1.0625,
775,2,0,0,1,2,1,2,3,2,18.0,2.0,2.0,0.0,1.0,0.5,
139,1,0,1,3,2,3,2,5,4,148.0,0.6666666666666666,2.0,0.0,1.0,1.5,
1294,2,0,0,1,2,1,2,3,2,23.0,2.0,2.0,0.0,1.0,0.5,
970,3,2,0,1,3,3,3,6,5,91.0,1.0,2.6666666666666665,0.22222222222222224,1.0,1.25,
120,1,0,1,1,2,1,2,3,2,3.0,2.0,2.0,0.0,1.0,0.5,
214,1,0,1,1,2,1,2,3,2,35.0,2.0,2.0,0.0,1.0,0.5,
501,0,0,1,1,1,1,1,2,1,0.0,1.0,0.0,0.0,0.0,0.0,
565,5,3,0,3,5,6,4,11,10,62.0,0.8333333333333334,2.1666666666666665,0.8055555555555555,0.9833333333333332,2.75,
1213,3,1,1,3,4,4,3,8,7,161.0,1.0,2.0,1.0,1.1666666666666665,1.75,
920,1,0,0,2,1,2,1,3,2,54.0,0.5,1.0,0.0,0.0,1.0,
367,1,0,0,1,1,1,1,2,1,0.0,1.0,0.0,0.0,0.0,0.0,
807,1,1,0,0,1,1,1,2,1,0.0,1.0,0.0,0.0,0.0,0.0,
698,4,2,1,4,5,6,5,11,10,188.0,0.8333333333333334,3.3333333333333335,0.8888888888888888,1.1666666666666665,2.03125,
997,8,4,0,6,8,10,5,18,17,198.0,0.8,2.2,1.56,1.4000000000000001,4.40625,
971,1,1,0,0,1,1,1,2,1,0.0,1.0,0.0,0.0,0.0,0.0,
396,3,1,0,3,3,4,2,7,6,72.0,0.75,1.5,0.25,0.6666666666666666,2.0,
451,12,10,2,8,14,18,6,32,31,516.0,0.7777777777777778,3.111111111111111,3.209876543209877,1.813095238095238,6.34375,
59,4,6,1,5,5,11,3,16,15,192.0,0.45454545454545453,2.0,0.5454545454545454,1.0833333333333333,5.125,
247,0,1,2,2,2,3,2,5,4,111.0,0.6666666666666666,1.3333333333333333,0.2222222222222222,0.5,1.5,
270,2,1,0,1,2,2,2,4,3,45.0,1.0,2.0,0.0,1.0,1.0,
292,1,1,0,1,1,2,1,3,2,10.0,0.5,1.0,0.0,0.0,1.0,
1265,2,1,0,1,2,2,2,4,3,62.0,1.0,1.5,0.25,0.5,1.0,
1150,1,0,0,3,1,3,1,4,3,43.0,0.3333333333333333,1.0,0.0,0.0,1.5,
687,0,1,1,0,1,1,1,2,1,0.0,1.0,0.0,0.0,0.0,0.0,
1038,1,0,0,1,1,1,1,2,1,0.0,1.0,0.0,0.0,0.0,0.0,
444,1,0,0,1,1,1,1,2,1,0.0,1.0,0.0,0.0,0.0,0.0,
1357,2,0,0,2,2,2,2,4,3,40.0,1.0,2.0,0.0,1.0,1.0,
547,1,1,0,1,1,2,1,3,2,15.0,0.5,1.0,0.0,0.0,1.0,
97,4,3,2,5,6,8,6,14,13,318.0,0.75,4.25,1.9375,1.2333333333333332,1.96875,
199,0,1,1,0,1,1,1,2,1,0.0,1.0,0.0,0.0,0.0,0.0,
394,1,0,0,1,1,1,1,2,1,0.0,1.0,0.0,0.0,0.0,0.0,
246,0,0,1,1,1,1,1,2,1,0.0,1.0,0.0,0.0,0.0,0.0,
226,2,0,1,1,3,1,3,4,3,40.0,3.0,3.0,0.0,1.5,0.375,
459,1,1,1,1,2,2,2,4,3,107.0,1.0,1.5,0.25,0.5,1.0,
837,1,0,0,1,1,1,1,2,1,0.0,1.0,0.0,0.0,0.0,0.0,
790,1,0,0,1,1,1,1,2,1,0.0,1.0,0.0,0.0,0.0,0.0,
1004,2,1,0,0,2,1,2,3,2,24.0,2.0,2.0,0.0,1.0,0.5,
469,2,1,1,1,3,2,3,5,4,52.0,1.5,2.5,0.25,1.0,0.875,
483,2,1,0,2,2,3,2,5,4,83.0,0.6666666666666666,1.6666666666666667,0.2222222222222222,0.5,1.5,
201,2,1,1,1,3,2,3,5,4,45.0,1.5,2.5,0.25,1.0,0.875,
353,1,0,0,1,1,1,1,2,1,0.0,1.0,0.0,0.0,0.0,0.0,
989,1,1,0,1,1,2,1,3,2,12.0,0.5,1.0,0.0,0.0,1.0,
1171,1,1,2,2,3,3,3,6,5,73.0,1.0,1.6666666666666667,0.888888888888889,0.8333333333333333,1.375,
1381,1,1,0,0,1,1,1,2,1,0.0,1.0,0.0,0.0,0.0,0.0,
1308,19,9,0,16,19,25,13,44,43,510.0,0.76,6.96,19.718399999999995,1.7288322788322785,4.6832275390625,
1039,2,1,0,2,2,3,2,5,4,50.0,0.6666666666666666,1.6666666666666667,0.2222222222222222,0.5,1.5,
378,1,0,1,1,2,1,2,3,2,28.0,2.0,2.0,0.0,1.0,0.5,
1360,0,1,1,0,1,1,1,2,1,0.0,1.0,0.0,0.0,0.0,0.0,
947,2,1,1,2,3,3,3,6,5,173.0,1.0,1.6666666666666667,0.888888888888889,0.8333333333333333,1.375,
1326,1,1,0,1,1,2,1,3,2,20.0,0.5,1.0,0.0,0.0,1.0,
987,2,0,0,2,2,2,2,4,3,45.0,1.0,1.5,0.25,0.5,1.0,
1330,1,2,0,0,1,2,1,3,2,128.0,0.5,1.0,0.0,0.0,1.0,
358,1,0,0,1,1,1,1,2,1,0.0,1.0,0.0,0.0,0.0,0.0,
184,4,2,1,2,5,4,4,9,8,43.0,1.25,3.0,1.0,1.4999999999999998,1.5,
746,0,1,1,0,1,1,1,2,1,0.0,1.0,0.0,0.0,0.0,0.0,
853,2,1,0,3,2,4,2,6,5,55.0,0.5,1.5,0.25,0.5,2.0,
1338,0,0,1,1,1,1,1,2,1,0.0,1.0,0.0,0.0,0.0,0.0,
988,3,2,1,2,4,4,4,8,7,157.0,1.0,2.25,1.1875,0.9166666666666665,1.75,
707,2,0,0,2,2,2,2,4,3,22.0,1.0,2.0,0.0,1.0,1.0,
1058,1,1,0,2,1,3,1,4,3,41.0,0.3333333333333333,1.0,0.0,0.0,1.5,
686,2,0,0,2,2,2,2,4,3,64.0,1.0,1.5,0.25,0.5,1.0,
781,1,1,0,1,1,2,1,3,2,0.0,0.5,1.0,0.0,0.0,1.0,
803,1,0,0,1,1,1,1,2,1,0.0,1.0,0.0,0.0,0.0,0.0,
1321,2,2,0,1,2,3,2,5,4,175.0,0.6666666666666666,1.3333333333333333,0.2222222222222222,0.5,1.5,
808,1,0,0,1,1,1,1,2,1,0.0,1.0,0.0,0.0,0.0,0.0,
401,4,2,0,5,4,7,4,11,10,166.0,0.5714285714285714,2.7142857142857144,1.346938775510204,0.9166666666666665,2.625,
1057,1,1,0,0,1,1,1,2,1,0.0,1.0,0.0,0.0,0.0,0.0,
930,12,6,0,16,12,22,8,34,33,389.0,0.5454545454545454,4.5,4.431818181818182,1.7214285714285713,5.6328125,
632,0,0,1,1,1,1,1,2,1,0.0,1.0,0.0,0.0,0.0,0.0,
666,2,1,0,0,2,1,2,3,2,23.0,2.0,2.0,0.0,1.0,0.5,
1280,1,2,0,0,1,2,1,3,2,3.0,0.5,1.0,0.0,0.0,1.0,
377,2,4,0,2,2,6,2,8,7,127.0,0.3333333333333333,1.3333333333333333,0.22222222222222224,0.5,3.0,
349,1,1,0,1,1,2,1,3,2,43.0,0.5,1.0,0.0,0.0,1.0,
841,3,2,0,4,3,6,3,9,8,197.0,0.5,2.0,0.6666666666666666,0.8333333333333333,2.75,
906,3,1,0,0,3,1,3,4,3,43.0,3.0,3.0,0.0,1.5,0.375,
828,1,1,0,1,1,2,1,3,2,26.0,0.5,1.0,0.0,0.0,1.0,
590,0,1,1,0,1,1,1,2,1,0.0,1.0,0.0,0.0,0.0,0.0,
114,4,2,1,7,5,9,4,14,13,182.0,0.5555555555555556,2.4444444444444446,0.6913580246913579,1.1666666666666665,3.875,
1116,1,0,0,2,1,2,1,3,2,56.0,0.5,1.0,0.0,0.0,1.0,
1334,1,0,0,1,1,1,1,2,1,0.0,1.0,0.0,0.0,0.0,0.0,
801,1,0,0,2,1,2,1,3,2,7.0,0.5,1.0,0.0,0.0,1.0,
1276,0,1,1,0,1,1,1,2,1,0.0,1.0,0.0,0.0,0.0,0.0,
1273,0,0,1,1,1,1,1,2,1,0.0,1.0,0.0,0.0,0.0,0.0,
1108,0,1,1,0,1,1,1,2,1,0.0,1.0,0.0,0.0,0.0,0.0,
361,6,3,2,5,8,8,6,16,15,326.0,1.0,4.625,1.484375,1.6333333333333333,1.6875,
769,1,1,0,0,1,1,1,2,1,0.0,1.0,0.0,0.0,0.0,0.0,
1073,7,2,0,6,7,8,5,15,14,199.0,0.875,4.0,0.25,1.6666666666666665,2.03125,
391,1,1,0,0,1,1,1,2,1,0.0,1.0,0.0,0.0,0.0,0.0,
1257,0,0,1,1,1,1,1,2,1,0.0,1.0,0.0,0.0,0.0,0.0,
931,2,0,0,6,2,6,2,8,7,272.0,0.3333333333333333,1.3333333333333333,0.22222222222222224,0.5,3.0,
383,1,2,0,2,1,4,1,5,4,199.0,0.25,1.0,0.0,0.0,2.0,
1166,0,1,1,0,1,1,1,2,1,0.0,1.0,0.0,0.0,0.0,0.0,
514,1,0,0,1,1,1,1,2,1,0.0,1.0,0.0,0.0,0.0,0.0,
260,0,1,1,0,1,1,1,2,1,0.0,1.0,0.0,0.0,0.0,0.0,
745,1,1,0,0,1,1,1,2,1,0.0,1.0,0.0,0.0,0.0,0.0,
79,8,6,2,9,10,15,5,25,24,257.0,0.6666666666666666,4.133333333333334,1.048888888888889,1.6023809523809522,3.71875,
1089,1,0,0,1,1,1,1,2,1,0.0,1.0,0.0,0.0,0.0,0.0,
778,1,2,0,2,1,4,1,5,4,228.0,0.25,1.0,0.0,0.0,2.0,
0,0,0,1,2,1,2,1,3,2,20.0,0.5,1.0,0.0,0.0,1.0,
280,11,2,1,17,12,19,6,31,30,530.0,0.631578947368421,3.8421052631578947,2.6592797783933517,1.346825396825397,5.1875,
32,0,1,1,1,1,2,1,3,2,1.0,0.5,1.0,0.0,0.0,1.0,
14,2,4,1,1,3,5,3,8,7,66.0,0.6,2.0,0.4,0.8333333333333333,2.375,
753,1,0,0,1,1,1,1,2,1,0.0,1.0,0.0,0.0,0.0,0.0,
123,1,0,1,1,2,1,2,3,2,3.0,2.0,2.0,0.0,1.0,0.5,
904,1,0,0,1,1,1,1,2,1,0.0,1.0,0.0,0.0,0.0,0.0,
118,6,1,1,10,7,11,4,18,17,164.0,0.6363636363636364,2.4545454545454546,0.7933884297520662,1.4333333333333333,4.75,
1368,1,0,0,1,1,1,1,2,1,0.0,1.0,0.0,0.0,0.0,0.0,
450,9,3,0,10,9,13,5,22,21,168.0,0.6923076923076923,2.923076923076923,1.9171597633136093,1.4023809523809525,4.6875,
701,1,0,0,1,1,1,1,2,1,0.0,1.0,0.0,0.0,0.0,0.0,
855,1,0,0,1,1,1,1,2,1,0.0,1.0,0.0,0.0,0.0,0.0,
254,9,3,0,11,9,14,6,23,22,407.0,0.6428571428571429,3.9285714285714284,2.9234693877551026,1.3880952380952378,4.125,
1011,1,1,0,1,1,2,1,3,2,114.0,0.5,1.0,0.0,0.0,1.0,
787,4,4,0,2,4,6,2,10,9,221.0,0.6666666666666666,1.8333333333333333,0.13888888888888887,1.0,3.0,
624,1,0,0,2,1,2,1,3,2,54.0,0.5,1.0,0.0,0.0,1.0,
115,6,7,3,10,9,17,4,26,25,119.0,0.5294117647058824,2.7058823529411766,0.7958477508650521,1.833333333333333,6.875,
795,1,0,0,1,1,1,1,2,1,0.0,1.0,0.0,0.0,0.0,0.0,
1336,1,0,0,1,1,1,1,2,1,0.0,1.0,0.0,0.0,0.0,0.0,
186,5,3,1,5,6,8,4,14,13,188.0,0.75,2.25,1.1875,1.4166666666666665,3.375,
764,0,0,1,1,1,1,1,2,1,0.0,1.0,0.0,0.0,0.0,0.0,
578,3,3,0,3,3,6,2,9,8,167.0,0.5,1.8333333333333333,0.13888888888888887,0.6666666666666666,3.0,
319,1,1,0,0,1,1,1,2,1,0.0,1.0,0.0,0.0,0.0,0.0,
854,1,2,0,0,1,2,1,3,2,14.0,0.5,1.0,0.0,0.0,1.0,
731,1,1,0,1,1,2,1,3,2,75.0,0.5,1.0,0.0,0.0,1.0,
1161,3,1,0,4,3,5,3,8,7,200.0,0.6,2.0,0.8,0.8333333333333333,2.25,
816,1,1,0,0,1,1,1,2,1,0.0,1.0,0.0,0.0,0.0,0.0,
1212,1,1,0,1,1,2,1,3,2,21.0,0.5,1.0,0.0,0.0,1.0,
983,2,1,0,0,2,1,2,3,2,72.0,2.0,2.0,0.0,1.0,0.5,
29,6,4,1,4,7,8,6,15,14,136.0,0.875,3.625,3.484375,1.1023809523809522,2.3125,
304,1,0,0,1,1,1,1,2,1,0.0,1.0,0.0,0.0,0.0,0.0,
386,2,1,0,1,2,2,2,4,3,52.0,1.0,2.0,0.0,1.0,1.0,
603,2,1,1,0,3,1,3,4,3,343.0,3.0,3.0,0.0,1.5,0.375,
491,1,2,0,1,1,3,1,4,3,56.0,0.3333333333333333,1.0,0.0,0.0,1.5,
705,2,2,2,3,4,5,3,9,8,144.0,0.8,2.0,0.8,1.1666666666666665,2.25,
106,8,1,3,10,11,11,6,22,21,296.0,1.0,3.3636363636363638,1.322314049586777,1.5785714285714285,3.75,
918,0,0,1,2,1,2,1,3,2,4.0,0.5,1.0,0.0,0.0,1.0,
601,1,0,0,1,1,1,1,2,1,0.0,1.0,0.0,0.0,0.0,0.0,
1247,1,0,0,1,1,1,1,2,1,0.0,1.0,0.0,0.0,0.0,0.0,
516,0,0,1,1,1,1,1,2,1,0.0,1.0,0.0,0.0,0.0,0.0,
838,1,0,0,2,1,2,1,3,2,79.0,0.5,1.0,0.0,0.0,1.0,
518,0,0,1,1,1,1,1,2,1,0.0,1.0,0.0,0.0,0.0,0.0,
679,3,3,0,3,3,6,3,9,8,77.0,0.5,1.8333333333333333,0.47222222222222227,0.8333333333333333,2.875,
532,1,1,0,0,1,1,1,2,1,0.0,1.0,0.0,0.0,0.0,0.0,
1316,1,1,0,1,1,2,1,3,2,2.0,0.5,1.0,0.0,0.0,1.0,
533,2,0,0,4,2,4,2,6,5,62.0,0.5,1.25,0.1875,0.5,2.0,
297,1,0,0,1,1,1,1,2,1,0.0,1.0,0.0,0.0,0.0,0.0,
1009,1,1,0,0,1,1,1,2,1,0.0,1.0,0.0,0.0,0.0,0.0,
436,1,1,0,0,1,1,1,2,1,0.0,1.0,0.0,0.0,0.0,0.0,
222,3,1,1,4,4,5,4,9,8,153.0,0.8,3.2,0.5599999999999999,1.1666666666666665,1.75,
148,0,0,1,1,1,1,1,2,1,0.0,1.0,0.0,0.0,0.0,0.0,
271,1,1,0,1,1,2,1,3,2,7.0,0.5,1.0,0.0,0.0,1.0,
1275,0,0,1,1,1,1,1,2,1,0.0,1.0,0.0,0.0,0.0,0.0,
52,17,9,1,15,18,24,5,42,41,371.0,0.75,3.7916666666666665,0.4982638888888889,2.954761904761905,6.75,
209,0,0,1,1,1,1,1,2,1,0.0,1.0,0.0,0.0,0.0,0.0,
831,0,0,1,1,1,1,1,2,1,0.0,1.0,0.0,0.0,0.0,0.0,
1119,1,0,1,2,2,2,2,4,3,16.0,1.0,2.0,0.0,1.0,1.0,
591,2,1,0,0,2,1,2,3,2,41.0,2.0,2.0,0.0,1.0,0.5,
1028,0,1,1,0,1,1,1,2,1,0.0,1.0,0.0,0.0,0.0,0.0,
722,4,3,3,4,7,7,5,14,13,177.0,1.0,3.142857142857143,1.5510204081632655,1.2333333333333334,2.5625,
62,4,2,1,4,5,6,3,11,10,130.0,0.8333333333333334,1.8333333333333333,0.4722222222222223,1.0833333333333333,2.875,
94,6,8,2,10,8,18,6,26,25,256.0,0.4444444444444444,3.5,1.8055555555555556,1.4666666666666666,5.59375,
440,4,5,0,3,4,8,3,12,11,74.0,0.5,2.125,0.609375,0.8333333333333333,3.625,
98,2,3,1,2,3,5,3,8,7,118.0,0.6,2.4,0.64,0.8333333333333333,2.125,
87,0,0,1,1,1,1,1,2,1,0.0,1.0,0.0,0.0,0.0,0.0,
326,0,0,1,2,1,2,1,3,2,114.0,0.5,1.0,0.0,0.0,1.0,
368,4,0,0,4,4,4,3,8,7,129.0,1.0,2.0,0.5,0.8333333333333333,1.875,
399,1,0,0,1,1,1,1,2,1,0.0,1.0,0.0,0.0,0.0,0.0,
136,0,1,1,0,1,1,1,2,1,0.0,1.0,0.0,0.0,0.0,0.0,
384,8,1,2,7,10,8,7,18,17,326.0,1.25,4.75,4.4375,1.6928571428571428,1.703125,
1229,1,1,0,2,1,3,1,4,3,3.0,0.3333333333333333,1.0,0.0,0.0,1.5,
243,4,0,1,1,5,1,5,6,5,77.0,5.0,5.0,0.0,2.0833333333333335,0.15625,
78,5,1,1,8,6,9,3,15,14,408.0,0.6666666666666666,2.2222222222222223,0.17283950617283947,1.15,4.25,
90,1,1,1,0,2,1,2,3,2,15.0,2.0,2.0,0.0,1.0,0.5,
633,10,7,2,6,12,13,6,25,24,382.0,0.9230769230769231,2.923076923076923,3.3017751479289945,1.576984126984127,5.03125,
1081,1,1,0,0,1,1,1,2,1,0.0,1.0,0.0,0.0,0.0,0.0,
938,1,0,0,1,1,1,1,2,1,0.0,1.0,0.0,0.0,0.0,0.0,
557,1,0,0,1,1,1,1,2,1,0.0,1.0,0.0,0.0,0.0,0.0,
969,3,1,1,2,4,3,4,7,6,333.0,1.3333333333333333,2.3333333333333335,1.5555555555555554,0.9166666666666665,1.25,
826,2,1,0,1,2,2,2,4,3,77.0,1.0,1.5,0.25,0.5,1.0,
1093,2,0,0,1,2,1,2,3,2,26.0,2.0,2.0,0.0,1.0,0.5,
593,1,0,0,1,1,1,1,2,1,0.0,1.0,0.0,0.0,0.0,0.0,
881,0,0,1,1,1,1,1,2,1,0.0,1.0,0.0,0.0,0.0,0.0,
238,0,0,2,3,2,3,2,5,4,39.0,0.6666666666666666,1.3333333333333333,0.2222222222222222,0.5,1.5,
523,1,0,0,1,1,1,1,2,1,0.0,1.0,0.0,0.0,0.0,0.0,
554,5,3,0,6,5,9,4,14,13,158.0,0.5555555555555556,2.2222222222222223,1.0617283950617287,0.9833333333333334,4.0,
759,1,0,1,4,2,4,2,6,5,168.0,0.5,1.25,0.1875,0.5,2.0,
418,1,1,0,0,1,1,1,2,1,0.0,1.0,0.0,0.0,0.0,0.0,
1365,1,0,0,1,1,1,1,2,1,0.0,1.0,0.0,0.0,0.0,0.0,
1232,1,0,0,2,1,2,1,3,2,88.0,0.5,1.0,0.0,0.0,1.0,
747,1,0,0,1,1,1,1,2,1,0.0,1.0,0.0,0.0,0.0,0.0,
905,1,1,0,0,1,1,1,2,1,0.0,1.0,0.0,0.0,0.0,0.0,
1062,1,0,0,1,1,1,1,2,1,0.0,1.0,0.0,0.0,0.0,0.0,
434,3,3,0,1,3,4,2,7,6,69.0,0.75,2.0,0.0,0.6666666666666666,2.0,
150,0,2,1,0,1,2,1,3,2,97.0,0.5,1.0,0.0,0.0,1.0,
663,4,2,0,4,4,6,4,10,9,339.0,0.6666666666666666,2.1666666666666665,1.1388888888888888,0.9166666666666665,2.625,
669,1,0,0,1,1,1,1,2,1,0.0,1.0,0.0,0.0,0.0,0.0,
650,1,0,0,1,1,1,1,2,1,0.0,1.0,0.0,0.0,0.0,0.0,
253,0,0,1,1,1,1,1,2,1,0.0,1.0,0.0,0.0,0.0,0.0,
765,1,0,0,3,1,3,1,4,3,26.0,0.3333333333333333,1.0,0.0,0.0,1.5,
9,1,0,1,2,2,2,2,4,3,95.0,1.0,1.5,0.25,0.5,1.0,
586,1,1,0,0,1,1,1,2,1,0.0,1.0,0.0,0.0,0.0,0.0,
640,1,2,0,0,1,2,1,3,2,2.0,0.5,1.0,0.0,0.0,1.0,
671,1,3,0,0,1,3,1,4,3,82.0,0.3333333333333333,1.0,0.0,0.0,1.5,
1149,1,0,0,1,1,1,1,2,1,0.0,1.0,0.0,0.0,0.0,0.0,
1071,1,1,0,0,1,1,1,2,1,0.0,1.0,0.0,0.0,0.0,0.0,
42,5,1,3,8,8,9,5,17,16,247.0,0.8888888888888888,2.5555555555555554,2.0246913580246915,1.2357142857142858,3.6875,
480,1,0,0,1,1,1,1,2,1,0.0,1.0,0.0,0.0,0.0,0.0,
385,2,0,1,2,3,2,3,5,4,58.0,1.5,2.0,1.0,0.8333333333333333,0.875,
1192,1,0,0,3,1,3,1,4,3,76.0,0.3333333333333333,1.0,0.0,0.0,1.5,
813,3,1,0,2,3,3,2,6,5,82.0,1.0,2.0,0.0,0.6666666666666666,1.5,
1380,1,0,0,2,1,2,1,3,2,65.0,0.5,1.0,0.0,0.0,1.0,
519,1,3,0,2,1,5,1,6,5,39.0,0.2,1.0,0.0,0.0,2.5,
1261,1,1,0,2,1,3,1,4,3,44.0,0.3333333333333333,1.0,0.0,0.0,1.5,
455,11,7,0,8,11,15,6,26,25,243.0,0.7333333333333333,4.133333333333334,2.9155555555555557,1.5369047619047618,3.75,
323,1,1,0,2,1,3,1,4,3,103.0,0.3333333333333333,1.0,0.0,0.0,1.5,
750,1,0,0,1,1,1,1,2,1,0.0,1.0,0.0,0.0,0.0,0.0,
441,1,0,0,1,1,1,1,2,1,0.0,1.0,0.0,0.0,0.0,0.0,
948,1,0,0,1,1,1,1,2,1,0.0,1.0,0.0,0.0,0.0,0.0,
757,2,0,1,2,3,2,3,5,4,46.0,1.5,2.5,0.25,1.0,0.875,
53,7,4,1,5,8,9,4,17,16,245.0,0.8888888888888888,2.4444444444444446,1.1358024691358024,1.35,3.75,
293,0,0,1,1,1,1,1,2,1,0.0,1.0,0.0,0.0,0.0,0.0,
551,1,0,0,1,1,1,1,2,1,0.0,1.0,0.0,0.0,0.0,0.0,
77,17,5,3,33,20,38,7,58,57,460.0,0.5263157894736842,4.131578947368421,2.430055401662051,2.327380952380952,10.140625,
124,16,12,2,17,18,29,6,47,46,509.0,0.6206896551724138,3.413793103448276,1.1391200951248508,2.358730158730159,9.4375,
880,15,6,2,16,17,22,10,39,38,994.0,0.7727272727272727,5.7272727272727275,9.289256198347106,1.867207792207792,4.095703125,
427,2,0,0,5,2,5,2,7,6,83.0,0.4,1.8,0.16,0.5,2.5,
1031,1,0,0,1,1,1,1,2,1,0.0,1.0,0.0,0.0,0.0,0.0,
1086,0,0,1,1,1,1,1,2,1,0.0,1.0,0.0,0.0,0.0,0.0,
729,1,1,0,0,1,1,1,2,1,0.0,1.0,0.0,0.0,0.0,0.0,
303,1,0,0,1,1,1,1,2,1,0.0,1.0,0.0,0.0,0.0,0.0,
737,1,0,1,2,2,2,2,4,3,58.0,1.0,1.5,0.25,0.5,1.0,
1196,3,1,0,3,3,4,2,7,6,107.0,0.75,1.5,0.25,0.6666666666666666,2.0,
143,2,1,1,3,3,4,3,7,6,39.0,0.75,2.5,0.75,0.8333333333333333,1.625,
696,5,6,1,1,6,7,4,13,12,215.0,0.8571428571428571,2.5714285714285716,0.816326530612245,1.4166666666666665,2.875,
972,2,0,0,1,2,1,2,3,2,77.0,2.0,2.0,0.0,1.0,0.5,
1278,3,1,0,5,3,6,2,9,8,159.0,0.5,1.6666666666666667,0.22222222222222224,0.6666666666666666,3.0,
1076,1,0,0,1,1,1,1,2,1,0.0,1.0,0.0,0.0,0.0,0.0,
1242,1,1,0,0,1,1,1,2,1,0.0,1.0,0.0,0.0,0.0,0.0,
267,1,2,1,3,2,5,2,7,6,160.0,0.4,1.8,0.16,0.5,2.5,
967,2,1,0,1,2,2,2,4,3,70.0,1.0,2.0,0.0,1.0,1.0,
951,0,0,1,1,1,1,1,2,1,0.0,1.0,0.0,0.0,0.0,0.0,
889,1,0,0,2,1,2,1,3,2,5.0,0.5,1.0,0.0,0.0,1.0,
1249,3,1,0,1,3,2,3,5,4,132.0,1.5,2.5,0.25,1.0,0.875,
534,1,1,0,0,1,1,1,2,1,0.0,1.0,0.0,0.0,0.0,0.0,
848,1,4,0,3,1,7,1,8,7,123.0,0.14285714285714285,1.0,0.0,0.0,3.5,
1323,3,1,0,3,3,4,3,7,6,68.0,0.75,2.0,0.5,0.8333333333333333,1.875,
187,0,1,1,0,1,1,1,2,1,0.0,1.0,0.0,0.0,0.0,0.0,
1147,3,1,2,6,5,7,4,12,11,283.0,0.7142857142857143,1.5714285714285714,1.102040816326531,0.9833333333333334,3.25,
1363,2,0,0,3,2,3,2,5,4,78.0,0.6666666666666666,1.3333333333333333,0.2222222222222222,0.5,1.5,
980,5,4,0,5,5,9,4,14,13,127.0,0.5555555555555556,2.2222222222222223,0.617283950617284,0.9833333333333332,4.125,
1341,6,3,0,10,6,13,4,19,18,202.0,0.46153846153846156,2.230769230769231,0.6390532544378696,1.2333333333333334,5.875,
221,4,2,1,2,5,4,5,9,8,128.0,1.25,3.0,2.0,1.0333333333333332,1.40625,
220,2,2,0,0,2,2,2,4,3,51.0,1.0,1.5,0.25,0.5,1.0,
195,0,0,1,1,1,1,1,2,1,0.0,1.0,0.0,0.0,0.0,0.0,
1300,3,1,0,2,3,3,2,6,5,88.0,1.0,2.0,0.0,0.6666666666666666,1.5,
482,1,1,0,0,1,1,1,2,1,0.0,1.0,0.0,0.0,0.0,0.0,
824,1,1,0,0,1,1,1,2,1,0.0,1.0,0.0,0.0,0.0,0.0,
1167,7,2,0,7,7,9,4,16,15,269.0,0.7777777777777778,3.0,0.2222222222222222,1.4833333333333332,3.375,
999,1,0,0,1,1,1,1,2,1,0.0,1.0,0.0,0.0,0.0,0.0,
13,3,1,1,5,4,6,3,10,9,234.0,0.6666666666666666,2.3333333333333335,0.2222222222222222,0.8333333333333333,2.75,
1314,4,0,0,5,4,5,4,9,8,231.0,0.8,3.0,1.6,0.9166666666666665,1.75,
1069,2,1,0,0,2,1,2,3,2,8.0,2.0,2.0,0.0,1.0,0.5,
652,1,0,0,1,1,1,1,2,1,0.0,1.0,0.0,0.0,0.0,0.0,
627,1,0,0,1,1,1,1,2,1,0.0,1.0,0.0,0.0,0.0,0.0,
57,8,4,1,9,9,13,5,22,21,134.0,0.6923076923076923,2.8461538461538463,1.207100591715976,1.3547619047619046,4.90625,
166,8,5,1,10,9,15,6,24,23,171.0,0.6,3.1333333333333333,2.2488888888888883,1.4452380952380952,5.3125,
1315,1,0,0,1,1,1,1,2,1,0.0,1.0,0.0,0.0,0.0,0.0,
1151,1,0,1,1,2,1,2,3,2,310.0,2.0,2.0,0.0,1.0,0.5,
268,1,1,0,0,1,1,1,2,1,0.0,1.0,0.0,0.0,0.0,0.0,
317,1,1,0,0,1,1,1,2,1,0.0,1.0,0.0,0.0,0.0,0.0,
1,1,1,2,0,3,1,3,4,3,109.0,3.0,3.0,0.0,1.5,0.375,
40,13,4,1,18,14,22,5,36,35,309.0,0.6363636363636364,3.8636363636363638,1.3904958677685952,2.2547619047619047,6.1875,
1140,1,0,0,1,1,1,1,2,1,0.0,1.0,0.0,0.0,0.0,0.0,
257,3,1,0,3,3,4,3,7,6,237.0,0.75,2.25,0.6875,0.8333333333333333,1.75,
1293,1,1,0,0,1,1,1,2,1,0.0,1.0,0.0,0.0,0.0,0.0,
175,3,3,1,0,4,3,3,7,6,77.0,1.3333333333333333,2.3333333333333335,0.22222222222222224,0.8333333333333333,1.375,
113,5,3,1,3,6,6,5,12,11,104.0,1.0,3.0,2.0,1.0333333333333332,2.15625,
1279,2,2,0,1,2,3,2,5,4,79.0,0.6666666666666666,1.3333333333333333,0.2222222222222222,0.5,1.5,
715,10,2,1,7,11,9,7,20,19,375.0,1.2222222222222223,3.4444444444444446,3.5802469135802477,1.1635642135642137,2.8671875,
512,0,1,1,0,1,1,1,2,1,0.0,1.0,0.0,0.0,0.0,0.0,
581,0,0,1,1,1,1,1,2,1,0.0,1.0,0.0,0.0,0.0,0.0,
503,1,0,0,2,1,2,1,3,2,15.0,0.5,1.0,0.0,0.0,1.0,
511,1,0,1,2,2,2,2,4,3,115.0,1.0,2.0,0.0,1.0,1.0,
833,2,2,0,3,2,5,2,7,6,137.0,0.4,1.2,0.16,0.5,2.5,
1216,3,2,1,2,4,4,3,8,7,181.0,1.0,2.5,0.25,1.1666666666666665,1.75,
1130,8,4,1,4,9,8,5,17,16,195.0,1.125,2.5,2.0,1.2357142857142855,3.15625,
344,2,0,0,2,2,2,2,4,3,68.0,1.0,2.0,0.0,1.0,1.0,
1225,2,0,0,1,2,1,2,3,2,66.0,2.0,2.0,0.0,1.0,0.5,
80,4,1,2,3,6,4,6,10,9,167.0,1.5,4.25,2.1875,1.2333333333333332,1.0,
537,1,1,2,3,3,4,3,7,6,71.0,0.75,2.25,0.1875,1.0,1.875,
216,0,0,1,1,1,1,1,2,1,0.0,1.0,0.0,0.0,0.0,0.0,
1285,1,0,0,1,1,1,1,2,1,0.0,1.0,0.0,0.0,0.0,0.0,
1354,1,3,1,0,2,3,2,5,4,90.0,0.6666666666666666,1.3333333333333333,0.2222222222222222,0.5,1.5,
546,1,1,0,0,1,1,1,2,1,0.0,1.0,0.0,0.0,0.0,0.0,
584,3,0,0,1,3,1,3,4,3,31.0,3.0,3.0,0.0,1.5,0.375,
630,1,0,0,1,1,1,1,2,1,0.0,1.0,0.0,0.0,0.0,0.0,
1105,1,0,0,1,1,1,1,2,1,0.0,1.0,0.0,0.0,0.0,0.0,
356,0,0,2,1,2,1,2,3,2,137.0,2.0,2.0,0.0,1.0,0.5,
439,0,0,1,1,1,1,1,2,1,0.0,1.0,0.0,0.0,0.0,0.0,
717,1,1,0,0,1,1,1,2,1,0.0,1.0,0.0,0.0,0.0,0.0,
1286,0,1,1,0,1,1,1,2,1,0.0,1.0,0.0,0.0,0.0,0.0,
1348,2,2,0,0,2,2,2,4,3,63.0,1.0,2.0,0.0,1.0,1.0,
885,2,2,0,2,2,4,2,6,5,121.0,0.5,1.25,0.1875,0.5,2.0,
1181,1,0,0,1,1,1,1,2,1,0.0,1.0,0.0,0.0,0.0,0.0,
332,1,0,0,3,1,3,1,4,3,191.0,0.3333333333333333,1.0,0.0,0.0,1.5,
287,0,0,1,1,1,1,1,2,1,0.0,1.0,0.0,0.0,0.0,0.0,
846,1,1,1,1,2,2,2,4,3,3.0,1.0,1.5,0.25,0.5,1.0,
51,0,1,1,0,1,1,1,2,1,0.0,1.0,0.0,0.0,0.0,0.0,
339,2,1,0,1,2,2,2,4,3,54.0,1.0,2.0,0.0,1.0,1.0,
365,2,1,0,4,2,5,2,7,6,72.0,0.4,1.4,0.24,0.5,2.5,
68,3,3,1,3,4,6,3,10,9,127.0,0.6666666666666666,1.8333333333333333,0.8055555555555555,1.1666666666666665,2.75,
355,2,3,1,3,3,6,2,9,8,125.0,0.5,1.5,0.25,0.6666666666666666,3.0,
155,0,1,1,0,1,1,1,2,1,0.0,1.0,0.0,0.0,0.0,0.0,
563,2,3,0,0,2,3,2,5,4,37.0,0.6666666666666666,1.3333333333333333,0.2222222222222222,0.5,1.5,
625,2,3,0,0,2,3,2,5,4,50.0,0.6666666666666666,1.6666666666666667,0.2222222222222222,0.5,1.5,
642,1,0,0,1,1,1,1,2,1,0.0,1.0,0.0,0.0,0.0,0.0,
251,0,0,1,1,1,1,1,2,1,0.0,1.0,0.0,0.0,0.0,0.0,
743,2,0,0,2,2,2,2,4,3,36.0,1.0,1.5,0.25,0.5,1.0,
1010,1,1,0,0,1,1,1,2,1,0.0,1.0,0.0,0.0,0.0,0.0,
1305,1,1,0,0,1,1,1,2,1,0.0,1.0,0.0,0.0,0.0,0.0,
1025,1,1,0,0,1,1,1,2,1,0.0,1.0,0.0,0.0,0.0,0.0,
409,1,0,1,2,2,2,2,4,3,54.0,1.0,1.5,0.25,0.5,1.0,
732,0,0,1,1,1,1,1,2,1,0.0,1.0,0.0,0.0,0.0,0.0,
1377,16,9,1,15,17,24,8,41,40,462.0,0.7083333333333334,3.9583333333333335,5.5399305555555545,2.0670634920634923,6.875,
608,2,3,0,1,2,4,2,6,5,61.0,0.5,1.5,0.25,0.5,2.0,
331,1,1,1,0,2,1,2,3,2,39.0,2.0,2.0,0.0,1.0,0.5,
1366,1,1,0,5,1,6,1,7,6,152.0,0.16666666666666666,1.0,0.0,0.0,3.0,
974,0,0,1,1,1,1,1,2,1,0.0,1.0,0.0,0.0,0.0,0.0,
127,1,1,1,0,2,1,2,3,2,7.0,2.0,2.0,0.0,1.0,0.5,
524,2,1,0,0,2,1,2,3,2,43.0,2.0,2.0,0.0,1.0,0.5,
504,3,0,0,3,3,3,2,6,5,71.0,1.0,2.0,0.0,0.6666666666666666,1.5,
1198,5,6,0,4,5,10,4,15,14,433.0,0.5,2.5,1.05,0.9833333333333334,4.125,
539,1,0,0,1,1,1,1,2,1,0.0,1.0,0.0,0.0,0.0,0.0,
1203,1,1,0,0,1,1,1,2,1,0.0,1.0,0.0,0.0,0.0,0.0,
648,2,2,0,1,2,3,2,5,4,127.0,0.6666666666666666,1.6666666666666667,0.2222222222222222,0.5,1.5,
337,1,1,0,0,1,1,1,2,1,0.0,1.0,0.0,0.0,0.0,0.0,
966,1,0,1,1,2,1,2,3,2,6.0,2.0,2.0,0.0,1.0,0.5,
48,1,0,2,1,3,1,3,4,3,147.0,3.0,3.0,0.0,1.5,0.375,
85,10,5,2,16,12,21,9,33,32,195.0,0.5714285714285714,4.523809523809524,7.392290249433105,1.5273809523809523,6.017578125,
1068,2,2,0,0,2,2,2,4,3,22.0,1.0,1.5,0.25,0.5,1.0,
856,1,1,0,0,1,1,1,2,1,0.0,1.0,0.0,0.0,0.0,0.0,
641,1,2,0,6,1,8,1,9,8,253.0,0.125,1.0,0.0,0.0,4.0,
485,1,0,0,1,1,1,1,2,1,0.0,1.0,0.0,0.0,0.0,0.0,
1340,3,2,1,4,4,6,3,10,9,115.0,0.6666666666666666,1.6666666666666667,0.5555555555555557,0.8333333333333333,2.875,
314,1,1,0,0,1,1,1,2,1,0.0,1.0,0.0,0.0,0.0,0.0,
659,1,1,0,0,1,1,1,2,1,0.0,1.0,0.0,0.0,0.0,0.0,
887,2,2,0,0,2,2,2,4,3,53.0,1.0,1.5,0.25,0.5,1.0,
576,1,0,0,2,1,2,1,3,2,36.0,0.5,1.0,0.0,0.0,1.0,
580,1,1,0,0,1,1,1,2,1,0.0,1.0,0.0,0.0,0.0,0.0,
913,1,1,0,3,1,4,1,5,4,131.0,0.25,1.0,0.0,0.0,2.0,
76,4,6,1,6,5,12,4,17,16,269.0,0.4166666666666667,2.75,1.0208333333333333,0.9833333333333334,4.75,
1214,1,1,0,0,1,1,1,2,1,0.0,1.0,0.0,0.0,0.0,0.0,
646,1,0,0,1,1,1,1,2,1,0.0,1.0,0.0,0.0,0.0,0.0,
208,0,0,1,1,1,1,1,2,1,0.0,1.0,0.0,0.0,0.0,0.0,
152,7,9,1,5,8,14,4,22,21,131.0,0.5714285714285714,2.5714285714285716,0.673469387755102,1.3833333333333333,5.75,
437,1,0,0,1,1,1,1,2,1,0.0,1.0,0.0,0.0,0.0,0.0,
993,0,1,1,0,1,1,1,2,1,0.0,1.0,0.0,0.0,0.0,0.0,
1378,1,0,0,1,1,1,1,2,1,0.0,1.0,0.0,0.0,0.0,0.0,
496,1,0,0,1,1,1,1,2,1,0.0,1.0,0.0,0.0,0.0,0.0,
1320,2,2,1,1,3,3,2,6,5,233.0,1.0,1.6666666666666667,0.2222222222222222,0.6666666666666666,1.5,
153,19,10,3,25,22,35,7,57,56,430.0,0.6285714285714286,3.914285714285714,3.221224489795918,2.33982683982684,9.9296875,
169,9,7,2,7,11,14,8,25,24,471.0,0.7857142857142857,3.357142857142857,3.943877551020407,1.1814213564213565,4.7109375,
1040,1,0,0,2,1,2,1,3,2,14.0,0.5,1.0,0.0,0.0,1.0,
174,4,2,1,2,5,4,4,9,8,90.0,1.25,3.75,0.1875,1.4999999999999998,1.125,
835,1,0,0,1,1,1,1,2,1,0.0,1.0,0.0,0.0,0.0,0.0,
629,3,3,0,1,3,4,3,7,6,94.0,0.75,1.75,0.6875,0.8333333333333333,1.875,
924,1,1,0,0,1,1,1,2,1,0.0,1.0,0.0,0.0,0.0,0.0,
908,3,1,3,7,6,8,5,14,13,239.0,0.75,3.125,0.609375,1.2333333333333334,2.90625,
449,2,2,1,2,3,4,3,7,6,94.0,0.75,3.0,0.0,1.5,1.5,
463,1,0,0,1,1,1,1,2,1,0.0,1.0,0.0,0.0,0.0,0.0,
703,3,2,0,3,3,5,3,8,7,209.0,0.6,1.6,0.64,0.8333333333333333,2.375,
1282,3,1,1,3,4,4,4,8,7,119.0,1.0,2.75,1.1875,0.9166666666666665,1.5,
1005,0,1,1,0,1,1,1,2,1,0.0,1.0,0.0,0.0,0.0,0.0,
858,1,0,0,2,1,2,1,3,2,25.0,0.5,1.0,0.0,0.0,1.0,
1156,1,0,1,2,2,2,2,4,3,42.0,1.0,2.0,0.0,1.0,1.0,
1312,1,0,0,1,1,1,1,2,1,0.0,1.0,0.0,0.0,0.0,0.0,
570,1,1,0,0,1,1,1,2,1,0.0,1.0,0.0,0.0,0.0,0.0,
1266,2,0,0,1,2,1,2,3,2,10.0,2.0,2.0,0.0,1.0,0.5,
424,1,1,0,0,1,1,1,2,1,0.0,1.0,0.0,0.0,0.0,0.0,
821,1,2,0,4,1,6,1,7,6,105.0,0.16666666666666666,1.0,0.0,0.0,3.0,
429,1,0,0,1,1,1,1,2,1,0.0,1.0,0.0,0.0,0.0,0.0,
1197,2,1,0,1,2,2,2,4,3,52.0,1.0,2.0,0.0,1.0,1.0,
647,3,2,0,3,3,5,3,8,7,131.0,0.6,1.4,0.64,0.8333333333333333,2.375,
210,1,3,1,0,2,3,2,5,4,35.0,0.6666666666666666,2.0,0.0,1.0,1.5,
572,0,1,1,3,1,4,1,5,4,2.0,0.25,1.0,0.0,0.0,2.0,
1129,1,1,0,1,1,2,1,3,2,62.0,0.5,1.0,0.0,0.0,1.0,
69,5,5,1,6,6,11,4,17,16,145.0,0.5454545454545454,2.272727272727273,0.9256198347107439,1.2333333333333332,4.75,
408,1,1,0,0,1,1,1,2,1,0.0,1.0,0.0,0.0,0.0,0.0,
823,1,0,0,1,1,1,1,2,1,0.0,1.0,0.0,0.0,0.0,0.0,
1066,2,0,0,1,2,1,2,3,2,9.0,2.0,2.0,0.0,1.0,0.5,
265,1,0,0,2,1,2,1,3,2,47.0,0.5,1.0,0.0,0.0,1.0,
874,2,0,0,1,2,1,2,3,2,65.0,2.0,2.0,0.0,1.0,0.5,
550,1,1,0,0,1,1,1,2,1,0.0,1.0,0.0,0.0,0.0,0.0,
883,1,0,0,2,1,2,1,3,2,62.0,0.5,1.0,0.0,0.0,1.0,
93,1,0,1,2,2,2,2,4,3,64.0,1.0,1.5,0.25,0.5,1.0,
168,0,0,1,1,1,1,1,2,1,0.0,1.0,0.0,0.0,0.0,0.0,
183,8,3,6,14,14,17,5,31,30,301.0,0.8235294117647058,3.5294117647058822,1.0726643598615917,1.7619047619047616,5.375,
973,2,1,0,4,2,5,2,7,6,83.0,0.4,1.6,0.24,0.5,2.5,
602,1,4,1,1,2,5,2,7,6,61.0,0.4,1.2,0.16,0.5,2.5,
706,0,1,1,0,1,1,1,2,1,0.0,1.0,0.0,0.0,0.0,0.0,
727,3,2,1,2,4,4,4,8,7,129.0,1.0,3.0,0.5,1.1666666666666665,1.5,
1043,1,0,0,1,1,1,1,2,1,0.0,1.0,0.0,0.0,0.0,0.0,
21,0,2,1,1,1,3,1,4,3,55.0,0.3333333333333333,1.0,0.0,0.0,1.5,
802,1,1,0,0,1,1,1,2,1,0.0,1.0,0.0,0.0,0.0,0.0,
233,0,0,1,1,1,1,1,2,1,0.0,1.0,0.0,0.0,0.0,0.0,
464,2,0,1,2,3,2,2,5,4,47.0,1.5,2.0,0.0,0.6666666666666666,1.0,
1060,2,1,0,0,2,1,2,3,2,8.0,2.0,2.0,0.0,1.0,0.5,
644,3,3,0,3,3,6,2,9,8,149.0,0.5,1.3333333333333333,0.22222222222222224,0.6666666666666666,3.0,
1375,1,1,1,2,2,3,2,5,4,71.0,0.6666666666666666,1.3333333333333333,0.2222222222222222,0.5,1.5,
958,1,1,0,0,1,1,1,2,1,0.0,1.0,0.0,0.0,0.0,0.0,
605,1,1,1,1,2,2,2,4,3,47.0,1.0,1.5,0.25,0.5,1.0,
1053,1,1,0,2,1,3,1,4,3,10.0,0.3333333333333333,1.0,0.0,0.0,1.5,
941,0,0,1,1,1,1,1,2,1,0.0,1.0,0.0,0.0,0.0,0.0,
935,1,1,0,1,1,2,1,3,2,5.0,0.5,1.0,0.0,0.0,1.0,
812,2,0,0,4,2,4,2,6,5,34.0,0.5,1.5,0.25,0.5,2.0,
283,0,0,1,1,1,1,1,2,1,0.0,1.0,0.0,0.0,0.0,0.0,
943,1,2,0,3,1,5,1,6,5,125.0,0.2,1.0,0.0,0.0,2.5,
454,1,0,0,1,1,1,1,2,1,0.0,1.0,0.0,0.0,0.0,0.0,
131,10,6,1,4,11,10,5,21,20,157.0,1.1,3.5,1.05,1.7452380952380953,3.1875,
224,0,1,1,0,1,1,1,2,1,0.0,1.0,0.0,0.0,0.0,0.0,
248,4,1,0,3,4,4,3,8,7,63.0,1.0,1.75,0.6875,0.8333333333333333,1.875,
172,0,0,1,1,1,1,1,2,1,0.0,1.0,0.0,0.0,0.0,0.0,
579,0,0,1,1,1,1,1,2,1,0.0,1.0,0.0,0.0,0.0,0.0,
415,3,2,0,2,3,4,3,7,6,124.0,0.75,2.25,0.6875,0.8333333333333333,1.75,
116,1,0,1,1,2,1,2,3,2,8.0,2.0,2.0,0.0,1.0,0.5,
1007,1,0,0,1,1,1,1,2,1,0.0,1.0,0.0,0.0,0.0,0.0,
1103,1,2,0,0,1,2,1,3,2,37.0,0.5,1.0,0.0,0.0,1.0,
878,3,2,0,5,3,7,3,10,9,127.0,0.42857142857142855,1.4285714285714286,0.5306122448979591,0.8333333333333333,3.375,
927,1,0,0,2,1,2,1,3,2,44.0,0.5,1.0,0.0,0.0,1.0,
177,2,2,1,5,3,7,2,10,9,99.0,0.42857142857142855,1.5714285714285714,0.24489795918367346,0.6666666666666666,3.5,
1204,2,2,0,2,2,4,2,6,5,131.0,0.5,1.75,0.1875,0.5,2.0,
196,3,1,2,4,5,5,4,10,9,66.0,1.0,3.0,0.4,1.1666666666666665,1.875,
1313,1,1,0,0,1,1,1,2,1,0.0,1.0,0.0,0.0,0.0,0.0,
362,8,3,0,11,8,14,4,22,21,240.0,0.5714285714285714,2.2857142857142856,0.6326530612244896,1.6833333333333331,6.25,
1085,3,0,0,2,3,2,3,5,4,78.0,1.5,2.5,0.25,1.0,0.875,
206,5,2,2,5,7,7,4,14,13,166.0,1.0,2.2857142857142856,1.0612244897959184,1.1833333333333333,3.0,
1034,1,0,0,1,1,1,1,2,1,0.0,1.0,0.0,0.0,0.0,0.0,
1193,1,1,0,0,1,1,1,2,1,0.0,1.0,0.0,0.0,0.0,0.0,
1127,2,1,0,0,2,1,2,3,2,14.0,2.0,2.0,0.0,1.0,0.5,
1075,1,1,0,2,1,3,1,4,3,72.0,0.3333333333333333,1.0,0.0,0.0,1.5,
767,0,0,1,1,1,1,1,2,1,0.0,1.0,0.0,0.0,0.0,0.0,
963,1,1,0,1,1,2,1,3,2,0.0,0.5,1.0,0.0,0.0,1.0,
1333,1,0,0,1,1,1,1,2,1,0.0,1.0,0.0,0.0,0.0,0.0,
1324,3,1,0,1,3,2,2,5,4,30.0,1.5,2.0,0.0,0.6666666666666666,1.0,
749,5,4,0,4,5,8,4,13,12,205.0,0.625,2.5,1.25,1.1666666666666665,3.25,
421,1,1,0,1,1,2,1,3,2,12.0,0.5,1.0,0.0,0.0,1.0,
1125,2,2,0,1,2,3,2,5,4,26.0,0.6666666666666666,2.0,0.0,1.0,1.5,
711,1,0,0,2,1,2,1,3,2,76.0,0.5,1.0,0.0,0.0,1.0,
295,1,1,0,0,1,1,1,2,1,0.0,1.0,0.0,0.0,0.0,0.0,
651,1,2,0,2,1,4,1,5,4,70.0,0.25,1.0,0.0,0.0,2.0,
305,1,1,0,0,1,1,1,2,1,0.0,1.0,0.0,0.0,0.0,0.0,
568,2,0,0,1,2,1,2,3,2,4.0,2.0,2.0,0.0,1.0,0.5,
400,10,8,0,15,10,23,7,33,32,544.0,0.43478260869565216,4.043478260869565,2.563327032136106,1.4119047619047618,6.4453125,
462,1,0,0,1,1,1,1,2,1,0.0,1.0,0.0,0.0,0.0,0.0,
347,1,1,0,0,1,1,1,2,1,0.0,1.0,0.0,0.0,0.0,0.0,
529,1,0,0,1,1,1,1,2,1,0.0,1.0,0.0,0.0,0.0,0.0,
990,1,0,0,1,1,1,1,2,1,0.0,1.0,0.0,0.0,0.0,0.0,
556,1,1,0,0,1,1,1,2,1,0.0,1.0,0.0,0.0,0.0,0.0,
382,1,0,0,1,1,1,1,2,1,0.0,1.0,0.0,0.0,0.0,0.0,
1191,2,0,0,1,2,1,2,3,2,21.0,2.0,2.0,0.0,1.0,0.5,
1001,1,1,0,3,1,4,1,5,4,31.0,0.25,1.0,0.0,0.0,2.0,
1015,1,1,0,0,1,1,1,2,1,0.0,1.0,0.0,0.0,0.0,0.0,
968,2,1,0,3,2,4,2,6,5,73.0,0.5,1.75,0.1875,0.5,2.0,
748,6,2,0,5,6,7,5,13,12,309.0,0.8571428571428571,3.4285714285714284,1.3877551020408165,1.4166666666666665,2.3125,
1205,2,1,0,1,2,2,2,4,3,19.0,1.0,1.5,0.25,0.5,1.0,
189,2,0,1,1,3,1,3,4,3,82.0,3.0,3.0,0.0,1.5,0.375,
282,0,0,1,1,1,1,1,2,1,0.0,1.0,0.0,0.0,0.0,0.0,
325,0,0,1,1,1,1,1,2,1,0.0,1.0,0.0,0.0,0.0,0.0,
307,1,0,0,1,1,1,1,2,1,0.0,1.0,0.0,0.0,0.0,0.0,
346,1,1,0,1,1,2,1,3,2,3.0,0.5,1.0,0.0,0.0,1.0,
875,8,3,0,6,8,9,4,17,16,247.0,0.8888888888888888,2.5555555555555554,0.691358024691358,1.3833333333333333,3.75,
27,10,7,1,6,11,13,5,24,23,184.0,0.8461538461538461,3.1538461538461537,1.8224852071005917,1.359126984126984,4.46875,
266,0,0,1,1,1,1,1,2,1,0.0,1.0,0.0,0.0,0.0,0.0,
1371,6,0,1,3,7,3,6,10,9,304.0,2.3333333333333335,3.6666666666666665,2.8888888888888893,1.2333333333333334,0.96875,
1356,6,3,1,2,7,5,6,12,11,445.0,1.4,4.2,2.16,1.4833333333333334,1.28125,
390,1,1,0,2,1,3,1,4,3,124.0,0.3333333333333333,1.0,0.0,0.0,1.5,
193,0,1,1,0,1,1,1,2,1,0.0,1.0,0.0,0.0,0.0,0.0,
255,0,0,1,1,1,1,1,2,1,0.0,1.0,0.0,0.0,0.0,0.0,
1345,1,0,0,1,1,1,1,2,1,0.0,1.0,0.0,0.0,0.0,0.0,
1173,1,0,0,1,1,1,1,2,1,0.0,1.0,0.0,0.0,0.0,0.0,
433,1,0,0,3,1,3,1,4,3,66.0,0.3333333333333333,1.0,0.0,0.0,1.5,
819,8,5,0,3,8,8,6,16,15,252.0,1.0,3.375,1.734375,1.269047619047619,2.59375,
112,3,1,1,3,4,4,3,8,7,148.0,1.0,2.75,0.1875,1.1666666666666665,1.625,
252,0,0,1,1,1,1,1,2,1,0.0,1.0,0.0,0.0,0.0,0.0,
1032,3,1,0,2,3,3,3,6,5,29.0,1.0,1.6666666666666667,0.888888888888889,0.8333333333333333,1.375,
634,0,0,1,1,1,1,1,2,1,0.0,1.0,0.0,0.0,0.0,0.0,
324,2,0,0,1,2,1,2,3,2,1.0,2.0,2.0,0.0,1.0,0.5,
313,2,1,1,1,3,2,3,5,4,119.0,1.5,2.5,0.25,1.0,0.875,
1379,1,0,0,1,1,1,1,2,1,0.0,1.0,0.0,0.0,0.0,0.0,
1344,1,0,0,1,1,1,1,2,1,0.0,1.0,0.0,0.0,0.0,0.0,
1309,2,2,0,3,2,5,2,7,6,167.0,0.4,1.8,0.16000000000000006,0.5,2.5,
1072,1,0,0,1,1,1,1,2,1,0.0,1.0,0.0,0.0,0.0,0.0,
135,3,2,1,4,4,6,4,10,9,128.0,0.6666666666666666,2.5,1.25,0.9166666666666665,2.5,
373,1,0,0,1,1,1,1,2,1,0.0,1.0,0.0,0.0,0.0,0.0,
798,1,0,0,1,1,1,1,2,1,0.0,1.0,0.0,0.0,0.0,0.0,
140,2,4,1,1,3,5,3,8,7,98.0,0.6,2.2,0.5599999999999999,0.8333333333333333,2.25,
249,1,1,0,0,1,1,1,2,1,0.0,1.0,0.0,0.0,0.0,0.0,
766,3,0,0,1,3,1,3,4,3,27.0,3.0,3.0,0.0,1.5,0.375,
445,1,1,0,1,1,2,1,3,2,0.0,0.5,1.0,0.0,0.0,1.0,
1051,1,0,0,1,1,1,1,2,1,0.0,1.0,0.0,0.0,0.0,0.0,
560,2,1,0,3,2,4,2,6,5,37.0,0.5,1.75,0.1875,0.5,2.0,
587,1,0,0,2,1,2,1,3,2,65.0,0.5,1.0,0.0,0.0,1.0,
1252,4,0,0,6,4,6,2,10,9,101.0,0.6666666666666666,1.6666666666666667,0.2222222222222223,1.0,3.0,
389,1,2,0,0,1,2,1,3,2,0.0,0.5,1.0,0.0,0.0,1.0,
1141,1,0,0,1,1,1,1,2,1,0.0,1.0,0.0,0.0,0.0,0.0,
894,1,0,0,2,1,2,1,3,2,8.0,0.5,1.0,0.0,0.0,1.0,
37,3,3,1,1,4,4,3,8,7,74.0,1.0,2.0,0.5,0.8333333333333333,1.875,
1372,15,13,3,17,18,30,5,48,47,657.0,0.6,2.966666666666667,1.0322222222222224,2.6464285714285714,11.3125,
1047,1,0,0,2,1,2,1,3,2,56.0,0.5,1.0,0.0,0.0,1.0,
863,2,0,0,2,2,2,2,4,3,19.0,1.0,1.5,0.25,0.5,1.0,
380,2,1,0,2,2,3,2,5,4,124.0,0.6666666666666666,1.3333333333333333,0.2222222222222222,0.5,1.5,
103,5,3,1,6,6,9,4,15,14,99.0,0.6666666666666666,2.3333333333333335,1.7777777777777777,0.9833333333333333,3.625,
1303,3,0,0,2,3,2,3,5,4,123.0,1.5,2.5,0.25,1.0,0.875,
861,1,1,0,0,1,1,1,2,1,0.0,1.0,0.0,0.0,0.0,0.0,
1274,0,1,1,0,1,1,1,2,1,0.0,1.0,0.0,0.0,0.0,0.0,
1248,2,3,0,0,2,3,2,5,4,37.0,0.6666666666666666,1.3333333333333333,0.2222222222222222,0.5,1.5,
472,0,0,1,1,1,1,1,2,1,0.0,1.0,0.0,0.0,0.0,0.0,
258,0,0,1,1,1,1,1,2,1,0.0,1.0,0.0,0.0,0.0,0.0,
1186,1,1,0,1,1,2,1,3,2,25.0,0.5,1.0,0.0,0.0,1.0,
649,1,0,0,1,1,1,1,2,1,0.0,1.0,0.0,0.0,0.0,0.0,
1102,1,0,0,1,1,1,1,2,1,0.0,1.0,0.0,0.0,0.0,0.0,
620,0,0,1,1,1,1,1,2,1,0.0,1.0,0.0,0.0,0.0,0.0,
2,23,14,3,37,26,51,10,77,76,513.0,0.5098039215686274,4.215686274509804,5.580930411380239,2.644300144300144,14.35546875,
1024,33,23,2,40,35,63,11,98,97,624.0,0.5555555555555556,5.444444444444445,8.75485008818342,3.33483460983461,13.763671875,
1046,4,1,0,3,4,4,4,8,7,229.0,1.0,2.25,1.6875,0.9166666666666665,1.625,
1174,1,0,0,1,1,1,1,2,1,0.0,1.0,0.0,0.0,0.0,0.0,
1288,1,1,0,4,1,5,1,6,5,81.0,0.2,1.0,0.0,0.0,2.5,
406,1,0,0,1,1,1,1,2,1,0.0,1.0,0.0,0.0,0.0,0.0,
142,1,1,1,0,2,1,2,3,2,16.0,2.0,2.0,0.0,1.0,0.5,
66,6,7,3,8,9,15,5,24,23,161.0,0.6,3.7333333333333334,0.8622222222222224,1.4357142857142857,4.375,
704,2,2,0,1,2,3,2,5,4,187.0,0.6666666666666666,1.6666666666666667,0.2222222222222222,0.5,1.5,
1235,1,0,1,2,2,2,2,4,3,92.0,1.0,1.5,0.25,0.5,1.0,
852,0,0,1,1,1,1,1,2,1,0.0,1.0,0.0,0.0,0.0,0.0,
141,13,9,4,13,17,22,7,39,38,283.0,0.7727272727272727,3.727272727272727,3.0165289256198347,2.0630952380952383,6.8203125,
902,1,2,1,0,2,2,2,4,3,57.0,1.0,1.5,0.25,0.5,1.0,
296,4,0,0,5,4,5,4,9,8,182.0,0.8,2.6,1.04,0.9166666666666665,2.0,
1364,3,2,0,4,3,6,3,9,8,43.0,0.5,2.3333333333333335,0.2222222222222222,1.0,2.75,
738,1,0,0,1,1,1,1,2,1,0.0,1.0,0.0,0.0,0.0,0.0,
607,5,3,1,4,6,7,6,13,12,275.0,0.8571428571428571,4.714285714285714,3.346938775510204,1.0666666666666667,1.40625,
1136,1,1,0,0,1,1,1,2,1,0.0,1.0,0.0,0.0,0.0,0.0,
678,0,0,1,1,1,1,1,2,1,0.0,1.0,0.0,0.0,0.0,0.0,
1206,3,1,0,4,3,5,2,8,7,80.0,0.6,1.6,0.24,0.6666666666666666,2.5,
1352,2,1,1,1,3,2,3,5,4,135.0,1.5,2.5,0.25,1.0,0.875,
723,1,1,0,0,1,1,1,2,1,0.0,1.0,0.0,0.0,0.0,0.0,
1189,2,0,0,1,2,1,2,3,2,18.0,2.0,2.0,0.0,1.0,0.5,
163,1,1,1,3,2,4,2,6,5,151.0,0.5,2.0,0.0,1.0,2.0,
751,1,0,0,1,1,1,1,2,1,0.0,1.0,0.0,0.0,0.0,0.0,
713,1,1,0,4,1,5,1,6,5,112.0,0.2,1.0,0.0,0.0,2.5,
1037,2,3,0,1,2,4,2,6,5,67.0,0.5,1.25,0.1875,0.5,2.0,
1020,1,1,0,0,1,1,1,2,1,0.0,1.0,0.0,0.0,0.0,0.0,
1139,0,1,1,0,1,1,1,2,1,0.0,1.0,0.0,0.0,0.0,0.0,
1059,0,1,1,0,1,1,1,2,1,0.0,1.0,0.0,0.0,0.0,0.0,
1250,1,0,0,2,1,2,1,3,2,82.0,0.5,1.0,0.0,0.0,1.0,
682,1,0,0,1,1,1,1,2,1,0.0,1.0,0.0,0.0,0.0,0.0,
229,0,1,1,0,1,1,1,2,1,0.0,1.0,0.0,0.0,0.0,0.0,
540,8,5,1,10,9,15,5,24,23,461.0,0.6,3.0,1.3333333333333333,1.9333333333333331,5.40625,
1187,6,5,1,7,7,12,4,19,18,146.0,0.5833333333333334,2.75,1.3541666666666667,1.4333333333333333,4.5,
197,0,0,1,1,1,1,1,2,1,0.0,1.0,0.0,0.0,0.0,0.0,
901,1,2,0,1,1,3,1,4,3,54.0,0.3333333333333333,1.0,0.0,0.0,1.5,
1176,1,0,0,1,1,1,1,2,1,0.0,1.0,0.0,0.0,0.0,0.0,
845,2,0,2,1,4,1,4,5,4,74.0,4.0,4.0,0.0,1.8333333333333333,0.25,
1180,1,0,0,2,1,2,1,3,2,3.0,0.5,1.0,0.0,0.0,1.0,
844,3,2,0,2,3,4,3,7,6,128.0,0.75,2.5,0.25,1.0,1.75,
1302,1,0,0,2,1,2,1,3,2,86.0,0.5,1.0,0.0,0.0,1.0,
742,2,1,0,1,2,2,2,4,3,22.0,1.0,2.0,0.0,1.0,1.0,
558,0,0,1,1,1,1,1,2,1,0.0,1.0,0.0,0.0,0.0,0.0,
1370,1,0,0,1,1,1,1,2,1,0.0,1.0,0.0,0.0,0.0,0.0,
673,1,1,1,2,2,3,2,5,4,163.0,0.6666666666666666,2.0,0.0,1.0,1.5,
953,2,2,0,4,2,6,2,8,7,137.0,0.3333333333333333,1.3333333333333333,0.22222222222222224,0.5,3.0,
25,22,14,6,24,28,38,6,66,65,624.0,0.7368421052631579,3.5,1.4078947368421053,3.2603174603174607,12.09375,
284,1,0,0,1,1,1,1,2,1,0.0,1.0,0.0,0.0,0.0,0.0,
56,5,1,1,4,6,5,4,11,10,114.0,1.2,3.6,0.24,1.8333333333333333,1.5,
375,0,0,1,1,1,1,1,2,1,0.0,1.0,0.0,0.0,0.0,0.0,
896,1,0,0,1,1,1,1,2,1,0.0,1.0,0.0,0.0,0.0,0.0,
1184,3,2,0,1,3,3,2,6,5,58.0,1.0,2.0,0.0,0.6666666666666666,1.5,
597,2,0,0,1,2,1,2,3,2,13.0,2.0,2.0,0.0,1.0,0.5,
770,1,0,0,1,1,1,1,2,1,0.0,1.0,0.0,0.0,0.0,0.0,
102,6,5,2,7,8,12,4,20,19,206.0,0.6666666666666666,3.0,0.8333333333333334,1.6833333333333333,4.375,
393,1,0,0,1,1,1,1,2,1,0.0,1.0,0.0,0.0,0.0,0.0,
1042,1,0,0,1,1,1,1,2,1,0.0,1.0,0.0,0.0,0.0,0.0,
842,2,1,0,0,2,1,2,3,2,81.0,2.0,2.0,0.0,1.0,0.5,
526,0,0,1,1,1,1,1,2,1,0.0,1.0,0.0,0.0,0.0,0.0,
369,1,0,0,1,1,1,1,2,1,0.0,1.0,0.0,0.0,0.0,0.0,
159,2,1,1,3,3,4,3,7,6,192.0,0.75,2.5,0.25,1.0,1.75,
780,2,2,1,3,3,5,2,8,7,199.0,0.6,1.6,0.24,0.6666666666666666,2.5,
452,0,1,1,0,1,1,1,2,1,0.0,1.0,0.0,0.0,0.0,0.0,
719,2,1,1,2,3,3,3,6,5,22.0,1.0,1.6666666666666667,0.888888888888889,0.8333333333333333,1.375,
1290,1,0,0,2,1,2,1,3,2,20.0,0.5,1.0,0.0,0.0,1.0,
1318,1,0,0,2,1,2,1,3,2,10.0,0.5,1.0,0.0,0.0,1.0,
488,2,1,0,1,2,2,2,4,3,31.0,1.0,1.5,0.25,0.5,1.0,
782,1,1,0,0,1,1,1,2,1,0.0,1.0,0.0,0.0,0.0,0.0,
744,1,0,0,1,1,1,1,2,1,0.0,1.0,0.0,0.0,0.0,0.0,
1117,0,1,1,0,1,1,1,2,1,0.0,1.0,0.0,0.0,0.0,0.0,
205,0,1,1,3,1,4,1,5,4,135.0,0.25,1.0,0.0,0.0,2.0,
1182,0,1,1,0,1,1,1,2,1,0.0,1.0,0.0,0.0,0.0,0.0,
423,6,2,0,3,6,5,4,11,10,164.0,1.2,3.4,0.64,0.9833333333333334,1.625,
776,3,0,1,6,4,6,4,10,9,147.0,0.6666666666666666,1.8333333333333333,1.138888888888889,0.9166666666666665,2.75,
1267,1,1,1,0,2,1,2,3,2,48.0,2.0,2.0,0.0,1.0,0.5,
122,2,2,2,5,4,7,4,11,10,365.0,0.5714285714285714,3.0,0.5714285714285714,1.1666666666666665,2.625,
471,3,3,0,3,3,6,3,9,8,93.0,0.5,1.5,0.5833333333333334,0.8333333333333333,2.875,
473,0,0,1,1,1,1,1,2,1,0.0,1.0,0.0,0.0,0.0,0.0,
699,1,1,0,2,1,3,1,4,3,44.0,0.3333333333333333,1.0,0.0,0.0,1.5,
198,3,2,1,2,4,4,3,8,7,78.0,1.0,2.5,0.25,1.1666666666666665,1.75,
942,1,1,0,4,1,5,1,6,5,54.0,0.2,1.0,0.0,0.0,2.5,
278,0,0,1,1,1,1,1,2,1,0.0,1.0,0.0,0.0,0.0,0.0,
840,1,1,0,0,1,1,1,2,1,0.0,1.0,0.0,0.0,0.0,0.0,
22,0,0,1,1,1,1,1,2,1,0.0,1.0,0.0,0.0,0.0,0.0,
805,11,5,1,17,12,22,8,34,33,399.0,0.5454545454545454,3.8181818181818183,2.0578512396694215,1.1814213564213565,6.3125,
613,1,1,0,1,1,2,1,3,2,19.0,0.5,1.0,0.0,0.0,1.0,
1329,3,1,0,4,3,5,2,8,7,213.0,0.6,1.6,0.24,0.6666666666666666,2.5,
788,2,2,0,2,2,4,2,6,5,102.0,0.5,1.25,0.1875,0.5,2.0,
1146,1,0,0,1,1,1,1,2,1,0.0,1.0,0.0,0.0,0.0,0.0,
1307,3,1,0,2,3,3,3,6,5,83.0,1.0,2.3333333333333335,0.22222222222222224,1.0,1.375,
261,0,0,1,1,1,1,1,2,1,0.0,1.0,0.0,0.0,0.0,0.0,
622,2,1,0,4,2,5,2,7,6,205.0,0.4,1.4,0.24,0.5,2.5,
1052,1,1,0,0,1,1,1,2,1,0.0,1.0,0.0,0.0,0.0,0.0,
38,8,6,1,7,9,13,5,22,21,173.0,0.6923076923076923,3.230769230769231,0.6390532544378699,1.4357142857142857,4.53125,
977,2,0,0,2,2,2,2,4,3,165.0,1.0,2.0,0.0,1.0,1.0,
171,0,1,1,1,1,2,1,3,2,61.0,0.5,1.0,0.0,0.0,1.0,
1049,6,4,0,7,6,11,4,17,16,432.0,0.5454545454545454,1.7272727272727273,0.7438016528925618,1.1833333333333333,5.25,
244,3,0,0,1,3,1,3,4,3,69.0,3.0,3.0,0.0,1.5,0.375,
674,13,10,3,12,16,22,7,38,37,449.0,0.7272727272727273,4.545454545454546,3.611570247933884,2.067063492063492,5.3828125,
11,6,7,5,10,11,17,6,28,27,140.0,0.6470588235294118,3.5294117647058822,0.9550173010380623,1.7452380952380953,5.21875,
357,6,3,0,9,6,12,3,18,17,299.0,0.5,1.75,0.6875,1.15,5.625,
1030,1,1,1,1,2,2,2,4,3,69.0,1.0,1.5,0.25,0.5,1.0,
484,1,0,1,3,2,3,2,5,4,89.0,0.6666666666666666,2.0,0.0,1.0,1.5,
1201,1,1,0,2,1,3,1,4,3,20.0,0.3333333333333333,1.0,0.0,0.0,1.5,
231,0,0,1,1,1,1,1,2,1,0.0,1.0,0.0,0.0,0.0,0.0,
446,0,1,1,0,1,1,1,2,1,0.0,1.0,0.0,0.0,0.0,0.0,
310,1,0,0,5,1,5,1,6,5,117.0,0.2,1.0,0.0,0.0,2.5,
397,1,0,0,1,1,1,1,2,1,0.0,1.0,0.0,0.0,0.0,0.0,
81,0,0,1,1,1,1,1,2,1,0.0,1.0,0.0,0.0,0.0,0.0,
1234,2,1,0,4,2,5,2,7,6,60.0,0.4,1.6,0.24,0.5,2.5,
341,2,1,0,3,2,4,2,6,5,165.0,0.5,2.0,0.0,1.0,2.0,
1162,1,1,0,1,1,2,1,3,2,87.0,0.5,1.0,0.0,0.0,1.0,
667,14,11,3,12,17,23,5,40,39,331.0,0.7391304347826086,3.4347826086956523,0.7674858223062384,2.198412698412698,7.46875,
921,2,3,0,1,2,4,2,6,5,172.0,0.5,1.5,0.25,0.5,2.0,
126,13,6,1,14,14,20,8,34,33,147.0,0.7,3.6,3.8400000000000007,1.6452380952380954,6.8359375,
71,4,3,3,10,7,13,4,20,19,297.0,0.5384615384615384,2.923076923076923,0.6863905325443789,1.4333333333333331,4.875,
1277,1,0,0,1,1,1,1,2,1,0.0,1.0,0.0,0.0,0.0,0.0,
146,0,0,1,1,1,1,1,2,1,0.0,1.0,0.0,0.0,0.0,0.0,
217,10,10,1,17,11,27,7,38,37,512.0,0.4074074074074074,4.333333333333333,2.4444444444444446,1.8261904761904764,6.4921875,
16,4,4,2,6,6,10,4,16,15,224.0,0.6,2.9,0.49000000000000005,1.1833333333333333,3.875,
478,3,0,1,1,4,1,4,5,4,192.0,4.0,4.0,0.0,1.8333333333333333,0.25,
336,0,0,1,1,1,1,1,2,1,0.0,1.0,0.0,0.0,0.0,0.0,
1026,1,1,0,1,1,2,1,3,2,5.0,0.5,1.0,0.0,0.0,1.0,
489,0,0,1,1,1,1,1,2,1,0.0,1.0,0.0,0.0,0.0,0.0,
173,4,3,1,5,5,8,5,13,12,137.0,0.625,3.375,1.484375,1.0333333333333332,2.53125,
1374,3,0,0,3,3,3,3,6,5,83.0,1.0,1.6666666666666667,0.888888888888889,0.8333333333333333,1.375,
830,0,0,1,1,1,1,1,2,1,0.0,1.0,0.0,0.0,0.0,0.0,
661,1,0,0,2,1,2,1,3,2,80.0,0.5,1.0,0.0,0.0,1.0,
1064,1,0,0,1,1,1,1,2,1,0.0,1.0,0.0,0.0,0.0,0.0,
101,11,8,1,15,12,23,8,35,34,298.0,0.5217391304347826,5.6521739130434785,3.18336483931947,1.7214285714285713,3.515625,
939,2,2,0,1,2,3,2,5,4,166.0,0.6666666666666666,1.6666666666666667,0.2222222222222222,0.5,1.5,
752,1,0,0,1,1,1,1,2,1,0.0,1.0,0.0,0.0,0.0,0.0,
388,3,0,0,3,3,3,3,6,5,70.0,1.0,2.0,0.6666666666666666,0.8333333333333333,1.375,
882,1,2,1,0,2,2,2,4,3,109.0,1.0,1.5,0.25,0.5,1.0,
329,0,0,1,2,1,2,1,3,2,75.0,0.5,1.0,0.0,0.0,1.0,
348,1,2,0,2,1,4,1,5,4,49.0,0.25,1.0,0.0,0.0,2.0,
697,0,0,1,1,1,1,1,2,1,0.0,1.0,0.0,0.0,0.0,0.0,
83,3,4,1,2,4,6,2,10,9,92.0,0.6666666666666666,1.8333333333333333,0.13888888888888887,1.0,3.0,
1118,3,1,0,1,3,2,3,5,4,16.0,1.5,2.5,0.25,1.0,0.875,
487,1,0,0,1,1,1,1,2,1,0.0,1.0,0.0,0.0,0.0,0.0,
88,1,0,1,2,2,2,2,4,3,4.0,1.0,1.5,0.25,0.5,1.0,
1367,1,0,0,1,1,1,1,2,1,0.0,1.0,0.0,0.0,0.0,0.0,
952,2,1,0,0,2,1,2,3,2,10.0,2.0,2.0,0.0,1.0,0.5,
1335,1,1,0,1,1,2,1,3,2,17.0,0.5,1.0,0.0,0.0,1.0,
109,1,0,1,2,2,2,2,4,3,35.0,1.0,1.5,0.25,0.5,1.0,
1054,1,2,0,1,1,3,1,4,3,79.0,0.3333333333333333,1.0,0.0,0.0,1.5,
8,11,5,1,14,12,19,6,31,30,261.0,0.631578947368421,3.473684210526316,1.4072022160664819,1.9119047619047618,6.21875,
413,1,1,0,1,1,2,1,3,2,19.0,0.5,1.0,0.0,0.0,1.0,
606,0,0,1,1,1,1,1,2,1,0.0,1.0,0.0,0.0,0.0,0.0,
467,2,0,0,1,2,1,2,3,2,60.0,2.0,2.0,0.0,1.0,0.5,
1194,2,1,0,2,2,3,2,5,4,100.0,0.6666666666666666,1.3333333333333333,0.2222222222222222,0.5,1.5,
1163,20,16,3,15,23,31,13,54,53,642.0,0.7419354838709677,6.225806451612903,13.594172736732565,1.9329698079698077,5.7745361328125,
104,1,0,1,2,2,2,2,4,3,76.0,1.0,2.0,0.0,1.0,1.0,
285,0,0,1,1,1,1,1,2,1,0.0,1.0,0.0,0.0,0.0,0.0,
411,1,1,0,0,1,1,1,2,1,0.0,1.0,0.0,0.0,0.0,0.0,
857,5,1,0,0,5,1,5,6,5,242.0,5.0,5.0,0.0,2.083333333333333,0.15625,
1224,1,0,0,1,1,1,1,2,1,0.0,1.0,0.0,0.0,0.0,0.0,
342,1,0,0,1,1,1,1,2,1,0.0,1.0,0.0,0.0,0.0,0.0,
232,0,0,1,1,1,1,1,2,1,0.0,1.0,0.0,0.0,0.0,0.0,
1296,1,0,0,1,1,1,1,2,1,0.0,1.0,0.0,0.0,0.0,0.0,
1270,1,1,1,1,2,2,2,4,3,114.0,1.0,2.0,0.0,1.0,1.0,
492,1,3,1,2,2,5,2,7,6,170.0,0.4,1.2,0.16,0.5,2.5,
806,2,2,1,0,3,2,3,5,4,125.0,1.5,2.5,0.25,1.0,0.875,
1079,1,2,0,2,1,4,1,5,4,66.0,0.25,1.0,0.0,0.0,2.0,
1050,1,0,0,1,1,1,1,2,1,0.0,1.0,0.0,0.0,0.0,0.0,
528,1,0,0,1,1,1,1,2,1,0.0,1.0,0.0,0.0,0.0,0.0,
772,1,0,1,1,2,1,2,3,2,9.0,2.0,2.0,0.0,1.0,0.5,
1013,0,1,1,0,1,1,1,2,1,0.0,1.0,0.0,0.0,0.0,0.0,
604,1,0,0,1,1,1,1,2,1,0.0,1.0,0.0,0.0,0.0,0.0,
1346,2,0,0,2,2,2,2,4,3,12.0,1.0,2.0,0.0,1.0,1.0,
1110,3,2,0,3,3,5,3,8,7,143.0,0.6,2.0,0.4,0.8333333333333333,2.375,
1106,5,3,0,7,5,10,4,15,14,172.0,0.5,2.6,1.44,1.1666666666666665,3.875,
599,1,1,0,0,1,1,1,2,1,0.0,1.0,0.0,0.0,0.0,0.0,
1158,2,0,0,4,2,4,2,6,5,91.0,0.5,1.75,0.1875,0.5,2.0,
879,1,1,0,0,1,1,1,2,1,0.0,1.0,0.0,0.0,0.0,0.0,
44,1,3,1,0,2,3,2,5,4,34.0,0.6666666666666666,1.3333333333333333,0.2222222222222222,0.5,1.5,
17,0,1,1,3,1,4,1,5,4,80.0,0.25,1.0,0.0,0.0,2.0,
54,8,12,2,6,10,18,3,28,27,207.0,0.5555555555555556,1.9444444444444444,0.8302469135802467,2.05,8.125,
932,1,1,0,0,1,1,1,2,1,0.0,1.0,0.0,0.0,0.0,0.0,
10,5,6,3,3,8,9,6,17,16,398.0,0.8888888888888888,3.5555555555555554,3.1358024691358026,1.4333333333333331,2.84375,
178,0,1,1,0,1,1,1,2,1,0.0,1.0,0.0,0.0,0.0,0.0,
1236,1,1,0,1,1,2,1,3,2,3.0,0.5,1.0,0.0,0.0,1.0,
312,1,0,0,1,1,1,1,2,1,0.0,1.0,0.0,0.0,0.0,0.0,
868,7,3,0,9,7,12,7,19,18,377.0,0.5833333333333334,5.75,2.0208333333333335,1.2333333333333332,1.59375,
1228,1,0,0,1,1,1,1,2,1,0.0,1.0,0.0,0.0,0.0,0.0,
1255,5,2,2,9,7,11,7,18,17,398.0,0.6363636363636364,5.0,1.8181818181818181,1.2333333333333332,1.9921875,
70,26,10,2,29,28,39,9,67,66,357.0,0.717948717948718,5.0256410256410255,5.768573307034844,3.147366522366523,8.794921875,
86,10,5,2,5,12,10,6,22,21,217.0,1.2,4.5,2.05,1.6797619047619046,2.28125,
712,1,0,0,1,1,1,1,2,1,0.0,1.0,0.0,0.0,0.0,0.0,
1304,2,1,0,0,2,1,2,3,2,17.0,2.0,2.0,0.0,1.0,0.5,
240,0,0,1,1,1,1,1,2,1,0.0,1.0,0.0,0.0,0.0,0.0,
466,4,2,0,2,4,4,3,8,7,100.0,1.0,2.75,0.1875,1.1666666666666665,1.625,
1091,1,1,0,0,1,1,1,2,1,0.0,1.0,0.0,0.0,0.0,0.0,
218,6,3,1,5,7,8,5,15,14,271.0,0.875,3.25,1.4375,1.2333333333333334,2.8125,
75,28,14,4,26,32,40,6,72,71,283.0,0.8,3.75,1.9875,4.223809523809523,11.625,
907,0,1,1,0,1,1,1,2,1,0.0,1.0,0.0,0.0,0.0,0.0,
67,9,6,2,16,11,22,5,33,32,232.0,0.5,3.5,0.5227272727272727,2.433333333333333,6.90625,
1157,9,4,3,8,12,12,6,24,23,195.0,1.0,3.4166666666666665,1.2430555555555556,1.6857142857142857,4.0,
538,1,0,1,3,2,3,2,5,4,64.0,0.6666666666666666,1.3333333333333333,0.2222222222222222,0.5,1.5,
676,0,0,1,1,1,1,1,2,1,0.0,1.0,0.0,0.0,0.0,0.0,
1243,0,1,1,0,1,1,1,2,1,0.0,1.0,0.0,0.0,0.0,0.0,
658,1,1,1,1,2,2,2,4,3,305.0,1.0,1.5,0.25,0.5,1.0,
960,1,0,0,1,1,1,1,2,1,0.0,1.0,0.0,0.0,0.0,0.0,
822,1,1,0,2,1,3,1,4,3,80.0,0.3333333333333333,1.0,0.0,0.0,1.5,
239,0,0,1,2,1,2,1,3,2,13.0,0.5,1.0,0.0,0.0,1.0,
867,3,0,0,2,3,2,3,5,4,31.0,1.5,2.0,1.0,0.8333333333333333,0.875,
1131,1,1,0,0,1,1,1,2,1,0.0,1.0,0.0,0.0,0.0,0.0,
1355,1,0,0,1,1,1,1,2,1,0.0,1.0,0.0,0.0,0.0,0.0,
1259,1,1,0,0,1,1,1,2,1,0.0,1.0,0.0,0.0,0.0,0.0,
847,1,1,0,1,1,2,1,3,2,41.0,0.5,1.0,0.0,0.0,1.0,
398,1,1,0,1,1,2,1,3,2,2.0,0.5,1.0,0.0,0.0,1.0,
351,1,1,0,0,1,1,1,2,1,0.0,1.0,0.0,0.0,0.0,0.0,
619,3,2,0,3,3,5,2,8,7,122.0,0.6,1.8,0.16,0.6666666666666666,2.5,
726,3,1,0,2,3,3,3,6,5,40.0,1.0,1.6666666666666667,0.888888888888889,0.8333333333333333,1.375,
100,6,6,1,4,7,10,5,17,16,124.0,0.7,3.2,2.96,1.4333333333333333,3.25,
144,16,9,3,26,19,35,6,54,53,198.0,0.5428571428571428,3.5142857142857142,1.6783673469387754,2.7511904761904757,11.0,
47,0,1,1,0,1,1,1,2,1,0.0,1.0,0.0,0.0,0.0,0.0,
242,0,1,1,0,1,1,1,2,1,0.0,1.0,0.0,0.0,0.0,0.0,
964,2,4,2,2,4,6,3,10,9,153.0,0.6666666666666666,2.5,0.25,1.1666666666666665,2.625,
350,2,0,0,1,2,1,2,3,2,19.0,2.0,2.0,0.0,1.0,0.5,
962,0,1,1,0,1,1,1,2,1,0.0,1.0,0.0,0.0,0.0,0.0,
318,1,1,0,0,1,1,1,2,1,0.0,1.0,0.0,0.0,0.0,0.0,
1111,1,0,0,1,1,1,1,2,1,0.0,1.0,0.0,0.0,0.0,0.0,
182,6,4,2,6,8,10,5,18,17,175.0,0.8,2.6,1.24,1.633333333333333,4.03125,
1078,3,3,0,5,3,8,3,11,10,194.0,0.375,1.5,0.5,0.8333333333333333,3.875,
73,5,3,1,3,6,6,5,12,11,223.0,1.0,3.3333333333333335,0.8888888888888888,1.2333333333333334,2.03125,
665,2,0,0,2,2,2,2,4,3,136.0,1.0,2.0,0.0,1.0,1.0,
161,0,0,1,1,1,1,1,2,1,0.0,1.0,0.0,0.0,0.0,0.0,
616,1,1,0,0,1,1,1,2,1,0.0,1.0,0.0,0.0,0.0,0.0,
290,0,0,1,1,1,1,1,2,1,0.0,1.0,0.0,0.0,0.0,0.0,
279,1,0,3,1,4,1,4,5,4,306.0,4.0,4.0,0.0,1.8333333333333333,0.25,
1244,1,1,0,0,1,1,1,2,1,0.0,1.0,0.0,0.0,0.0,0.0,
1245,2,2,0,2,2,4,2,6,5,27.0,0.5,1.25,0.1875,0.5,2.0,
1168,2,1,0,1,2,2,2,4,3,50.0,1.0,1.5,0.25,0.5,1.0,
46,7,8,3,12,10,20,5,30,29,262.0,0.5,2.7,1.7100000000000002,1.6023809523809525,7.5625,
545,19,13,2,29,21,42,7,63,62,521.0,0.5,3.9285714285714284,2.6853741496598635,2.062049062049062,11.546875,
275,0,0,1,1,1,1,1,2,1,0.0,1.0,0.0,0.0,0.0,0.0,
1145,1,2,0,0,1,2,1,3,2,9.0,0.5,1.0,0.0,0.0,1.0,
1012,3,3,0,2,3,5,3,8,7,187.0,0.6,2.2,0.96,0.8333333333333333,2.125,
294,0,0,1,1,1,1,1,2,1,0.0,1.0,0.0,0.0,0.0,0.0,
714,0,1,1,0,1,1,1,2,1,0.0,1.0,0.0,0.0,0.0,0.0,
366,1,0,0,1,1,1,1,2,1,0.0,1.0,0.0,0.0,0.0,0.0,
515,1,1,0,0,1,1,1,2,1,0.0,1.0,0.0,0.0,0.0,0.0,
851,2,1,0,1,2,2,2,4,3,37.0,1.0,2.0,0.0,1.0,1.0,
555,4,2,2,5,6,7,5,13,12,240.0,0.8571428571428571,3.2857142857142856,0.7755102040816327,1.4166666666666665,2.40625,
1343,1,0,0,1,1,1,1,2,1,0.0,1.0,0.0,0.0,0.0,0.0,
892,1,1,0,0,1,1,1,2,1,0.0,1.0,0.0,0.0,0.0,0.0,
588,4,3,0,5,4,8,3,12,11,207.0,0.5,1.625,0.484375,0.8333333333333333,3.875,
35,0,1,1,0,1,1,1,2,1,0.0,1.0,0.0,0.0,0.0,0.0,
873,6,3,0,7,6,10,5,16,15,274.0,0.6,3.3,1.01,1.2833333333333332,3.28125,
461,1,0,0,1,1,1,1,2,1,0.0,1.0,0.0,0.0,0.0,0.0,
430,1,0,0,1,1,1,1,2,1,0.0,1.0,0.0,0.0,0.0,0.0,
328,1,1,0,1,1,2,1,3,2,44.0,0.5,1.0,0.0,0.0,1.0,
291,1,1,0,1,1,2,1,3,2,105.0,0.5,1.0,0.0,0.0,1.0,
1134,1,0,0,2,1,2,1,3,2,31.0,0.5,1.0,0.0,0.0,1.0,
1148,1,0,0,1,1,1,1,2,1,0.0,1.0,0.0,0.0,0.0,0.0,
929,1,1,0,2,1,3,1,4,3,53.0,0.3333333333333333,1.0,0.0,0.0,1.5,
1124,1,0,0,2,1,2,1,3,2,41.0,0.5,1.0,0.0,0.0,1.0,
544,4,2,0,2,4,4,2,8,7,91.0,1.0,1.75,0.1875,1.0,2.0,
416,1,0,0,1,1,1,1,2,1,0.0,1.0,0.0,0.0,0.0,0.0,
320,1,0,0,3,1,3,1,4,3,70.0,0.3333333333333333,1.0,0.0,0.0,1.5,
1227,1,3,0,1,1,4,1,5,4,71.0,0.25,1.0,0.0,0.0,2.0,
1092,1,0,0,3,1,3,1,4,3,11.0,0.3333333333333333,1.0,0.0,0.0,1.5,
333,2,0,0,1,2,1,2,3,2,30.0,2.0,2.0,0.0,1.0,0.5,
31,0,0,2,4,2,4,2,6,5,78.0,0.5,1.5,0.25,0.5,2.0,
