ObID,HRI,HRL,LRI,LRL,Internals,Leaves,Height,Vertices,Size,Duration,RatioIL,MeanBar,StdBar,Beta1,Beta2,
572,2,3,0,3,2,6,2,8,7,98.0,0.3333333333333333,1.1666666666666667,0.13888888888888887,0.5,3.0,
517,11,7,1,9,12,16,6,28,27,392.0,0.75,3.375,2.359375,1.9214285714285713,5.21875,
77,9,2,2,9,11,11,6,22,21,217.0,1.0,3.6363636363636362,3.322314049586777,1.8357142857142856,3.28125,
231,5,4,0,3,5,7,5,12,11,332.0,0.7142857142857143,3.857142857142857,0.9795918367346939,1.1666666666666665,1.9375,
28,13,12,1,11,14,23,7,37,36,434.0,0.6086956521739131,3.260869565217391,1.8449905482041595,1.836904761904762,8.1171875,
420,0,1,1,0,1,1,1,2,1,0.0,1.0,0.0,0.0,0.0,0.0,
35,1,0,0,1,1,1,1,2,1,0.0,1.0,0.0,0.0,0.0,0.0,
195,1,1,0,0,1,1,1,2,1,0.0,1.0,0.0,0.0,0.0,0.0,
34,15,8,1,14,16,22,8,38,37,224.0,0.7272727272727273,4.181818181818182,2.330578512396694,1.7651875901875904,5.5859375,
381,1,0,0,1,1,1,1,2,1,0.0,1.0,0.0,0.0,0.0,0.0,
256,2,2,0,0,2,2,2,4,3,43.0,1.0,1.5,0.25,0.5,1.0,
120,6,2,0,5,6,7,5,13,12,191.0,0.8571428571428571,3.142857142857143,2.6938775510204076,1.0333333333333332,2.46875,
58,2,0,0,4,2,4,2,6,5,86.0,0.5,1.25,0.1875,0.5,2.0,
558,1,1,0,1,1,2,1,3,2,25.0,0.5,1.0,0.0,0.0,1.0,
314,4,0,1,4,5,4,5,9,8,199.0,1.25,2.5,2.75,1.0333333333333332,1.53125,
568,4,2,0,3,4,5,2,9,8,75.0,0.8,1.6,0.24,1.0,2.5,
518,1,1,1,0,2,1,2,3,2,19.0,2.0,2.0,0.0,1.0,0.5,
144,0,1,1,0,1,1,1,2,1,0.0,1.0,0.0,0.0,0.0,0.0,
299,3,2,0,1,3,3,3,6,5,183.0,1.0,2.3333333333333335,0.8888888888888888,0.8333333333333333,1.25,
359,1,2,1,2,2,4,2,6,5,210.0,0.5,1.25,0.1875,0.5,2.0,
373,0,0,1,1,1,1,1,2,1,0.0,1.0,0.0,0.0,0.0,0.0,
239,0,0,1,1,1,1,1,2,1,0.0,1.0,0.0,0.0,0.0,0.0,
85,0,0,1,1,1,1,1,2,1,0.0,1.0,0.0,0.0,0.0,0.0,
6,1,2,0,2,1,4,1,5,4,52.0,0.25,1.0,0.0,0.0,2.0,
307,4,2,0,3,4,5,3,9,8,84.0,0.8,2.0,0.8,1.1666666666666665,2.25,
542,2,1,0,0,2,1,2,3,2,30.0,2.0,2.0,0.0,1.0,0.5,
551,4,1,0,1,4,2,4,6,5,174.0,2.0,2.5,2.25,0.9166666666666665,0.75,
584,8,2,1,7,9,9,7,18,17,406.0,1.0,3.5555555555555554,4.469135802469136,1.1484126984126983,2.8359375,
236,1,1,0,1,1,2,1,3,2,30.0,0.5,1.0,0.0,0.0,1.0,
382,1,1,0,0,1,1,1,2,1,0.0,1.0,0.0,0.0,0.0,0.0,
432,4,2,1,2,5,4,5,9,8,92.0,1.25,4.0,0.5,1.4166666666666665,1.03125,
358,1,1,0,0,1,1,1,2,1,0.0,1.0,0.0,0.0,0.0,0.0,
5,1,1,0,1,1,2,1,3,2,45.0,0.5,1.0,0.0,0.0,1.0,
404,3,2,0,3,3,5,3,8,7,231.0,0.6,1.8,0.56,0.8333333333333333,2.375,
315,1,1,0,1,1,2,1,3,2,2.0,0.5,1.0,0.0,0.0,1.0,
213,2,1,1,2,3,3,3,6,5,52.0,1.0,2.0,0.6666666666666666,0.8333333333333333,1.375,
506,2,1,0,0,2,1,2,3,2,26.0,2.0,2.0,0.0,1.0,0.5,
357,1,0,0,1,1,1,1,2,1,0.0,1.0,0.0,0.0,0.0,0.0,
344,2,3,0,4,2,7,2,9,8,222.0,0.2857142857142857,1.1428571428571428,0.12244897959183676,0.5,3.5,
114,1,1,1,1,2,2,2,4,3,43.0,1.0,2.0,0.0,1.0,1.0,
632,1,0,0,1,1,1,1,2,1,0.0,1.0,0.0,0.0,0.0,0.0,
118,2,0,0,2,2,2,2,4,3,31.0,1.0,1.5,0.25,0.5,1.0,
66,1,0,0,1,1,1,1,2,1,0.0,1.0,0.0,0.0,0.0,0.0,
146,0,0,1,1,1,1,1,2,1,0.0,1.0,0.0,0.0,0.0,0.0,
405,1,0,0,1,1,1,1,2,1,0.0,1.0,0.0,0.0,0.0,0.0,
94,1,0,0,2,1,2,1,3,2,26.0,0.5,1.0,0.0,0.0,1.0,
351,0,1,1,0,1,1,1,2,1,0.0,1.0,0.0,0.0,0.0,0.0,
33,1,1,0,1,1,2,1,3,2,131.0,0.5,1.0,0.0,0.0,1.0,
306,0,0,1,1,1,1,1,2,1,0.0,1.0,0.0,0.0,0.0,0.0,
596,4,5,0,5,4,10,3,14,13,203.0,0.4,1.5,0.45,0.8333333333333333,4.875,
412,2,1,0,2,2,3,2,5,4,67.0,0.6666666666666666,1.6666666666666667,0.2222222222222222,0.5,1.5,
386,1,2,0,1,1,3,1,4,3,85.0,0.3333333333333333,1.0,0.0,0.0,1.5,
383,2,2,0,2,2,4,2,6,5,57.0,0.5,1.5,0.25,0.5,2.0,
207,2,0,1,4,3,4,3,7,6,182.0,0.75,2.25,0.1875,1.0,1.875,
201,0,0,1,1,1,1,1,2,1,0.0,1.0,0.0,0.0,0.0,0.0,
194,0,1,1,0,1,1,1,2,1,0.0,1.0,0.0,0.0,0.0,0.0,
186,1,0,0,1,1,1,1,2,1,0.0,1.0,0.0,0.0,0.0,0.0,
116,1,0,0,1,1,1,1,2,1,0.0,1.0,0.0,0.0,0.0,0.0,
323,1,0,0,1,1,1,1,2,1,0.0,1.0,0.0,0.0,0.0,0.0,
448,2,1,0,1,2,2,2,4,3,46.0,1.0,2.0,0.0,1.0,1.0,
560,1,0,1,1,2,1,2,3,2,62.0,2.0,2.0,0.0,1.0,0.5,
430,2,1,0,1,2,2,2,4,3,19.0,1.0,2.0,0.0,1.0,1.0,
435,0,0,1,1,1,1,1,2,1,0.0,1.0,0.0,0.0,0.0,0.0,
18,1,0,0,3,1,3,1,4,3,84.0,0.3333333333333333,1.0,0.0,0.0,1.5,
339,0,0,1,1,1,1,1,2,1,0.0,1.0,0.0,0.0,0.0,0.0,
636,1,1,1,1,2,2,2,4,3,59.0,1.0,2.0,0.0,1.0,1.0,
639,4,2,0,5,4,7,3,11,10,222.0,0.5714285714285714,2.4285714285714284,0.5306122448979592,1.1666666666666665,3.0,
162,1,1,0,0,1,1,1,2,1,0.0,1.0,0.0,0.0,0.0,0.0,
549,2,1,0,0,2,1,2,3,2,23.0,2.0,2.0,0.0,1.0,0.5,
346,0,0,1,1,1,1,1,2,1,0.0,1.0,0.0,0.0,0.0,0.0,
153,0,2,1,1,1,3,1,4,3,120.0,0.3333333333333333,1.0,0.0,0.0,1.5,
480,1,4,0,2,1,6,1,7,6,189.0,0.16666666666666666,1.0,0.0,0.0,3.0,
483,1,1,0,0,1,1,1,2,1,0.0,1.0,0.0,0.0,0.0,0.0,
193,8,3,1,7,9,10,5,19,18,287.0,0.9,3.4,1.6400000000000001,1.3785714285714286,3.21875,
275,1,0,0,1,1,1,1,2,1,0.0,1.0,0.0,0.0,0.0,0.0,
431,0,1,1,0,1,1,1,2,1,0.0,1.0,0.0,0.0,0.0,0.0,
488,1,0,0,2,1,2,1,3,2,7.0,0.5,1.0,0.0,0.0,1.0,
127,1,1,0,0,1,1,1,2,1,0.0,1.0,0.0,0.0,0.0,0.0,
104,1,2,0,0,1,2,1,3,2,46.0,0.5,1.0,0.0,0.0,1.0,
44,12,3,0,17,12,20,6,32,31,408.0,0.6,3.35,1.5275,1.9785714285714286,6.5,
599,3,1,0,2,3,3,3,6,5,56.0,1.0,2.0,0.6666666666666666,0.8333333333333333,1.375,
11,2,1,1,3,3,4,3,7,6,64.0,0.75,2.0,1.0,0.8333333333333333,1.75,
140,1,0,1,1,2,1,2,3,2,18.0,2.0,2.0,0.0,1.0,0.5,
51,7,4,1,9,8,13,5,21,20,377.0,0.6153846153846154,2.0,1.0769230769230769,1.3666666666666667,6.03125,
552,1,1,0,1,1,2,1,3,2,12.0,0.5,1.0,0.0,0.0,1.0,
522,10,6,2,18,12,24,4,36,35,475.0,0.5,2.5416666666666665,0.6649305555555555,1.919047619047619,10.0,
454,1,1,0,0,1,1,1,2,1,0.0,1.0,0.0,0.0,0.0,0.0,
332,1,1,0,0,1,1,1,2,1,0.0,1.0,0.0,0.0,0.0,0.0,
507,31,16,3,36,34,52,9,86,85,508.0,0.6538461538461539,5.923076923076923,4.071005917159762,3.218070818070818,7.0625,
29,6,0,0,5,6,5,5,11,10,176.0,1.2,4.4,0.24000000000000005,1.4166666666666665,1.0625,
185,1,0,0,1,1,1,1,2,1,0.0,1.0,0.0,0.0,0.0,0.0,
245,3,1,2,1,5,2,5,7,6,222.0,2.5,3.5,2.25,1.1666666666666665,0.65625,
214,4,5,0,2,4,7,4,11,10,227.0,0.5714285714285714,1.7142857142857142,1.3469387755102038,0.9166666666666665,3.125,
311,11,4,1,12,12,16,8,28,27,278.0,0.75,4.375,4.109375,1.6797619047619043,4.1953125,
343,1,1,0,1,1,2,1,3,2,5.0,0.5,1.0,0.0,0.0,1.0,
178,1,0,0,3,1,3,1,4,3,45.0,0.3333333333333333,1.0,0.0,0.0,1.5,
197,1,0,0,2,1,2,1,3,2,10.0,0.5,1.0,0.0,0.0,1.0,
385,2,1,0,3,2,4,2,6,5,70.0,0.5,1.5,0.25,0.5,2.0,
130,6,2,0,6,6,8,4,14,13,191.0,0.75,2.625,0.734375,1.4166666666666665,3.25,
635,2,2,1,2,3,4,3,7,6,50.0,0.75,1.75,0.6875,0.8333333333333333,1.875,
642,4,3,0,0,4,3,3,7,6,107.0,1.3333333333333333,2.6666666666666665,0.22222222222222224,0.8333333333333333,1.25,
209,0,1,1,0,1,1,1,2,1,0.0,1.0,0.0,0.0,0.0,0.0,
59,2,1,0,2,2,3,2,5,4,27.0,0.6666666666666666,1.3333333333333333,0.2222222222222222,0.5,1.5,
37,5,2,0,6,5,8,4,13,12,136.0,0.625,2.875,0.859375,1.1666666666666665,3.0,
270,0,1,1,0,1,1,1,2,1,0.0,1.0,0.0,0.0,0.0,0.0,
539,3,0,0,1,3,1,3,4,3,126.0,3.0,3.0,0.0,1.5,0.375,
333,1,0,0,1,1,1,1,2,1,0.0,1.0,0.0,0.0,0.0,0.0,
328,4,1,0,5,4,6,4,10,9,134.0,0.6666666666666666,3.0,0.3333333333333333,1.1666666666666665,2.25,
103,1,0,0,1,1,1,1,2,1,0.0,1.0,0.0,0.0,0.0,0.0,
217,1,1,0,0,1,1,1,2,1,0.0,1.0,0.0,0.0,0.0,0.0,
88,1,0,0,2,1,2,1,3,2,4.0,0.5,1.0,0.0,0.0,1.0,
150,2,0,0,1,2,1,2,3,2,33.0,2.0,2.0,0.0,1.0,0.5,
223,3,3,0,6,3,9,2,12,11,106.0,0.3333333333333333,1.7777777777777777,0.1728395061728395,0.6666666666666666,4.5,
132,1,2,1,0,2,2,2,4,3,50.0,1.0,1.5,0.25,0.5,1.0,
224,1,0,0,1,1,1,1,2,1,0.0,1.0,0.0,0.0,0.0,0.0,
160,5,3,0,5,5,8,4,13,12,132.0,0.625,2.125,1.359375,0.9833333333333334,3.5,
335,8,5,2,7,10,12,9,22,21,468.0,0.8333333333333334,4.166666666666667,8.972222222222223,1.2912698412698413,3.74609375,
31,0,1,1,1,1,2,1,3,2,59.0,0.5,1.0,0.0,0.0,1.0,
353,1,0,0,2,1,2,1,3,2,28.0,0.5,1.0,0.0,0.0,1.0,
439,1,0,0,1,1,1,1,2,1,0.0,1.0,0.0,0.0,0.0,0.0,
459,1,0,0,1,1,1,1,2,1,0.0,1.0,0.0,0.0,0.0,0.0,
96,2,1,1,2,3,3,3,6,5,98.0,1.0,2.0,0.6666666666666666,0.8333333333333333,1.375,
446,1,0,0,1,1,1,1,2,1,0.0,1.0,0.0,0.0,0.0,0.0,
341,1,0,0,1,1,1,1,2,1,0.0,1.0,0.0,0.0,0.0,0.0,
167,4,2,2,5,6,7,5,13,12,276.0,0.8571428571428571,2.7142857142857144,1.9183673469387759,1.2333333333333332,2.65625,
401,0,1,1,0,1,1,1,2,1,0.0,1.0,0.0,0.0,0.0,0.0,
302,1,1,0,2,1,3,1,4,3,40.0,0.3333333333333333,1.0,0.0,0.0,1.5,
280,6,4,0,4,6,8,4,14,13,333.0,0.75,3.25,0.1875,1.2333333333333332,2.75,
471,3,2,0,5,3,7,3,10,9,83.0,0.42857142857142855,1.5714285714285714,0.5306122448979592,0.8333333333333333,3.375,
325,1,0,0,1,1,1,1,2,1,0.0,1.0,0.0,0.0,0.0,0.0,
49,1,1,0,0,1,1,1,2,1,0.0,1.0,0.0,0.0,0.0,0.0,
630,0,1,1,0,1,1,1,2,1,0.0,1.0,0.0,0.0,0.0,0.0,
309,1,0,1,1,2,1,2,3,2,28.0,2.0,2.0,0.0,1.0,0.5,
527,1,1,0,1,1,2,1,3,2,58.0,0.5,1.0,0.0,0.0,1.0,
571,1,0,0,1,1,1,1,2,1,0.0,1.0,0.0,0.0,0.0,0.0,
477,1,1,0,0,1,1,1,2,1,0.0,1.0,0.0,0.0,0.0,0.0,
171,1,1,0,4,1,5,1,6,5,39.0,0.2,1.0,0.0,0.0,2.5,
598,2,1,0,0,2,1,2,3,2,47.0,2.0,2.0,0.0,1.0,0.5,
8,2,0,0,2,2,2,2,4,3,3.0,1.0,2.0,0.0,1.0,1.0,
530,1,1,0,0,1,1,1,2,1,0.0,1.0,0.0,0.0,0.0,0.0,
125,1,1,0,1,1,2,1,3,2,19.0,0.5,1.0,0.0,0.0,1.0,
370,5,5,1,4,6,9,5,15,14,204.0,0.6666666666666666,3.5555555555555554,1.358024691358025,1.2833333333333332,2.65625,
465,1,0,0,1,1,1,1,2,1,0.0,1.0,0.0,0.0,0.0,0.0,
450,1,1,0,2,1,3,1,4,3,11.0,0.3333333333333333,1.0,0.0,0.0,1.5,
199,2,0,0,3,2,3,2,5,4,95.0,0.6666666666666666,1.3333333333333333,0.2222222222222222,0.5,1.5,
222,6,5,0,7,6,12,5,18,17,284.0,0.5,4.083333333333333,0.07638888888888891,1.4166666666666665,2.90625,
54,1,1,0,0,1,1,1,2,1,0.0,1.0,0.0,0.0,0.0,0.0,
496,1,1,0,0,1,1,1,2,1,0.0,1.0,0.0,0.0,0.0,0.0,
251,1,0,0,1,1,1,1,2,1,0.0,1.0,0.0,0.0,0.0,0.0,
516,3,1,0,1,3,2,3,5,4,37.0,1.5,2.5,0.25,1.0,0.875,
463,1,0,0,1,1,1,1,2,1,0.0,1.0,0.0,0.0,0.0,0.0,
79,2,4,0,2,2,6,2,8,7,150.0,0.3333333333333333,1.5,0.25,0.5,3.0,
23,1,0,0,1,1,1,1,2,1,0.0,1.0,0.0,0.0,0.0,0.0,
83,1,0,0,1,1,1,1,2,1,0.0,1.0,0.0,0.0,0.0,0.0,
220,7,3,2,6,9,9,5,18,17,228.0,1.0,2.6666666666666665,1.3333333333333335,1.4023809523809525,3.65625,
210,0,0,1,1,1,1,1,2,1,0.0,1.0,0.0,0.0,0.0,0.0,
570,1,0,0,1,1,1,1,2,1,0.0,1.0,0.0,0.0,0.0,0.0,
340,11,2,0,3,11,5,10,16,15,230.0,2.2,5.8,6.5600000000000005,1.434126984126984,0.853515625,
466,1,0,0,3,1,3,1,4,3,19.0,0.3333333333333333,1.0,0.0,0.0,1.5,
369,1,1,0,0,1,1,1,2,1,0.0,1.0,0.0,0.0,0.0,0.0,
481,3,2,1,6,4,8,4,12,11,579.0,0.5,3.125,0.609375,1.1666666666666665,2.875,
208,1,0,1,2,2,2,2,4,3,163.0,1.0,1.5,0.25,0.5,1.0,
490,7,6,0,11,7,17,4,24,23,227.0,0.4117647058823529,2.5294117647058822,1.1903114186851211,1.019047619047619,6.875,
89,0,1,1,0,1,1,1,2,1,0.0,1.0,0.0,0.0,0.0,0.0,
601,5,3,1,3,6,6,4,12,11,289.0,1.0,2.6666666666666665,0.888888888888889,1.1833333333333333,2.5,
443,1,1,0,0,1,1,1,2,1,0.0,1.0,0.0,0.0,0.0,0.0,
565,3,1,0,1,3,2,3,5,4,64.0,1.5,2.0,1.0,0.8333333333333333,0.875,
429,13,7,0,10,13,17,8,30,29,356.0,0.7647058823529411,5.117647058823529,1.8685121107266431,1.888095238095238,2.953125,
508,1,0,0,1,1,1,1,2,1,0.0,1.0,0.0,0.0,0.0,0.0,
229,1,0,0,1,1,1,1,2,1,0.0,1.0,0.0,0.0,0.0,0.0,
416,4,0,0,4,4,4,3,8,7,166.0,1.0,2.25,0.6875,1.1666666666666665,1.75,
139,1,0,0,2,1,2,1,3,2,20.0,0.5,1.0,0.0,0.0,1.0,
563,2,1,0,1,2,2,2,4,3,9.0,1.0,2.0,0.0,1.0,1.0,
379,1,1,0,1,1,2,1,3,2,8.0,0.5,1.0,0.0,0.0,1.0,
550,3,0,0,4,3,4,3,7,6,105.0,0.75,3.0,0.0,1.5,1.5,
595,1,1,0,0,1,1,1,2,1,0.0,1.0,0.0,0.0,0.0,0.0,
326,3,2,0,2,3,4,3,7,6,60.0,0.75,2.75,0.1875,1.0,1.625,
602,1,0,0,1,1,1,1,2,1,0.0,1.0,0.0,0.0,0.0,0.0,
591,2,0,2,2,4,2,4,6,5,139.0,2.0,2.5,2.25,0.9166666666666666,0.75,
20,1,1,0,0,1,1,1,2,1,0.0,1.0,0.0,0.0,0.0,0.0,
212,3,1,2,3,5,4,5,9,8,235.0,1.25,3.25,1.1875,1.1666666666666665,1.40625,
523,3,2,0,2,3,4,3,7,6,308.0,0.75,2.5,0.25,1.0,1.75,
397,1,0,0,2,1,2,1,3,2,50.0,0.5,1.0,0.0,0.0,1.0,
444,5,1,0,5,5,6,5,11,10,281.0,0.8333333333333334,3.6666666666666665,0.888888888888889,1.1666666666666665,1.78125,
122,2,0,0,3,2,3,2,5,4,150.0,0.6666666666666666,2.0,0.0,1.0,1.5,
47,2,0,0,4,2,4,2,6,5,88.0,0.5,1.25,0.1875,0.5,2.0,
612,2,1,0,2,2,3,2,5,4,143.0,0.6666666666666666,1.3333333333333333,0.2222222222222222,0.5,1.5,
562,1,0,0,1,1,1,1,2,1,0.0,1.0,0.0,0.0,0.0,0.0,
396,2,1,0,0,2,1,2,3,2,24.0,2.0,2.0,0.0,1.0,0.5,
45,4,1,0,2,4,3,4,7,6,127.0,1.3333333333333333,3.6666666666666665,0.22222222222222224,1.3333333333333333,0.875,
360,0,0,1,1,1,1,1,2,1,0.0,1.0,0.0,0.0,0.0,0.0,
631,1,0,0,1,1,1,1,2,1,0.0,1.0,0.0,0.0,0.0,0.0,
645,2,0,0,1,2,1,2,3,2,12.0,2.0,2.0,0.0,1.0,0.5,
247,2,1,0,1,2,2,2,4,3,14.0,1.0,1.5,0.25,0.5,1.0,
110,1,0,1,1,2,1,2,3,2,169.0,2.0,2.0,0.0,1.0,0.5,
585,2,1,0,0,2,1,2,3,2,2.0,2.0,2.0,0.0,1.0,0.5,
438,5,6,0,5,5,11,4,16,15,264.0,0.45454545454545453,2.909090909090909,0.26446280991735543,1.1666666666666665,4.25,
362,1,1,0,0,1,1,1,2,1,0.0,1.0,0.0,0.0,0.0,0.0,
134,0,0,1,1,1,1,1,2,1,0.0,1.0,0.0,0.0,0.0,0.0,
74,0,0,1,1,1,1,1,2,1,0.0,1.0,0.0,0.0,0.0,0.0,
626,0,0,1,2,1,2,1,3,2,134.0,0.5,1.0,0.0,0.0,1.0,
512,5,2,0,6,5,8,5,13,12,395.0,0.625,2.75,1.6875,1.0333333333333332,3.15625,
482,1,0,0,1,1,1,1,2,1,0.0,1.0,0.0,0.0,0.0,0.0,
578,3,3,0,5,3,8,2,11,10,204.0,0.375,1.625,0.234375,0.6666666666666666,4.0,
613,1,0,0,1,1,1,1,2,1,0.0,1.0,0.0,0.0,0.0,0.0,
190,0,0,1,1,1,1,1,2,1,0.0,1.0,0.0,0.0,0.0,0.0,
99,0,0,1,1,1,1,1,2,1,0.0,1.0,0.0,0.0,0.0,0.0,
32,1,0,0,1,1,1,1,2,1,0.0,1.0,0.0,0.0,0.0,0.0,
534,1,0,0,1,1,1,1,2,1,0.0,1.0,0.0,0.0,0.0,0.0,
156,7,1,1,8,8,9,4,17,16,169.0,0.8888888888888888,3.3333333333333335,0.8888888888888891,1.3499999999999999,2.875,
376,1,2,1,1,2,3,2,5,4,69.0,0.6666666666666666,1.3333333333333333,0.2222222222222222,0.5,1.5,
615,1,1,0,2,1,3,1,4,3,54.0,0.3333333333333333,1.0,0.0,0.0,1.5,
384,4,5,1,6,5,11,4,16,15,241.0,0.45454545454545453,2.727272727272727,0.38016528925619836,1.1666666666666665,4.5,
367,6,5,3,6,9,11,4,20,19,327.0,0.8181818181818182,3.1818181818181817,0.33057851239669417,1.5166666666666668,3.875,
540,2,0,0,1,2,1,2,3,2,6.0,2.0,2.0,0.0,1.0,0.5,
427,1,0,0,1,1,1,1,2,1,0.0,1.0,0.0,0.0,0.0,0.0,
13,1,1,0,0,1,1,1,2,1,0.0,1.0,0.0,0.0,0.0,0.0,
17,2,2,0,2,2,4,2,6,5,48.0,0.5,1.5,0.25,0.5,2.0,
363,4,1,1,2,5,3,5,8,7,171.0,1.6666666666666667,5.0,0.0,2.083333333333333,0.46875,
355,4,5,2,6,6,11,4,17,16,211.0,0.5454545454545454,2.727272727272727,0.5619834710743802,1.2333333333333332,4.5,
106,0,0,1,1,1,1,1,2,1,0.0,1.0,0.0,0.0,0.0,0.0,
205,1,0,0,1,1,1,1,2,1,0.0,1.0,0.0,0.0,0.0,0.0,
21,4,4,0,6,4,10,3,14,13,310.0,0.4,1.7,0.61,0.8333333333333333,4.75,
334,16,8,1,19,17,27,6,44,43,348.0,0.6296296296296297,3.925925925925926,1.4019204389574764,2.46547619047619,7.3125,
380,1,0,0,2,1,2,1,3,2,13.0,0.5,1.0,0.0,0.0,1.0,
73,4,2,0,3,4,5,4,9,8,89.0,0.8,2.4,1.0400000000000003,0.9166666666666666,2.125,
111,1,1,0,0,1,1,1,2,1,0.0,1.0,0.0,0.0,0.0,0.0,
554,2,0,0,1,2,1,2,3,2,58.0,2.0,2.0,0.0,1.0,0.5,
577,3,4,2,0,5,4,3,9,8,457.0,1.25,2.5,0.75,0.9,1.625,
410,1,1,0,0,1,1,1,2,1,0.0,1.0,0.0,0.0,0.0,0.0,
147,9,6,0,7,9,13,5,22,21,487.0,0.6923076923076923,3.076923076923077,1.301775147928994,1.5999999999999999,4.6875,
227,1,1,0,1,1,2,1,3,2,2.0,0.5,1.0,0.0,0.0,1.0,
607,2,2,1,3,3,5,2,8,7,120.0,0.6,1.4,0.24,0.6666666666666666,2.5,
40,1,1,0,0,1,1,1,2,1,0.0,1.0,0.0,0.0,0.0,0.0,
105,1,2,1,0,2,2,2,4,3,29.0,1.0,1.5,0.25,0.5,1.0,
597,29,12,1,27,30,39,7,69,68,599.0,0.7692307692307693,4.358974358974359,4.383957922419461,3.3761904761904766,10.0,
301,5,6,1,10,6,16,5,22,21,491.0,0.375,3.0,1.5,1.2833333333333332,5.6875,
262,1,1,0,0,1,1,1,2,1,0.0,1.0,0.0,0.0,0.0,0.0,
68,2,0,0,3,2,3,2,5,4,95.0,0.6666666666666666,1.6666666666666667,0.2222222222222222,0.5,1.5,
180,1,1,0,0,1,1,1,2,1,0.0,1.0,0.0,0.0,0.0,0.0,
531,1,1,0,2,1,3,1,4,3,4.0,0.3333333333333333,1.0,0.0,0.0,1.5,
555,1,0,0,2,1,2,1,3,2,25.0,0.5,1.0,0.0,0.0,1.0,
368,0,1,1,0,1,1,1,2,1,0.0,1.0,0.0,0.0,0.0,0.0,
101,1,1,0,0,1,1,1,2,1,0.0,1.0,0.0,0.0,0.0,0.0,
175,1,0,0,2,1,2,1,3,2,10.0,0.5,1.0,0.0,0.0,1.0,
638,4,3,0,1,4,4,4,8,7,97.0,1.0,1.75,1.6875,0.9166666666666665,1.75,
226,1,0,0,1,1,1,1,2,1,0.0,1.0,0.0,0.0,0.0,0.0,
457,2,0,0,1,2,1,2,3,2,15.0,2.0,2.0,0.0,1.0,0.5,
345,3,0,1,4,4,4,4,8,7,229.0,1.0,2.25,1.6875,0.9166666666666665,1.625,
244,15,10,0,16,15,26,7,41,40,424.0,0.5769230769230769,3.6153846153846154,2.1597633136094667,1.7813492063492065,7.9609375,
164,1,0,0,1,1,1,1,2,1,0.0,1.0,0.0,0.0,0.0,0.0,
215,1,4,0,0,1,4,1,5,4,45.0,0.25,1.0,0.0,0.0,2.0,
169,2,0,0,2,2,2,2,4,3,52.0,1.0,1.5,0.25,0.5,1.0,
494,3,2,0,2,3,4,3,7,6,39.0,0.75,2.0,0.5,0.8333333333333333,1.875,
318,3,2,0,1,3,3,3,6,5,98.0,1.0,2.3333333333333335,0.8888888888888888,0.8333333333333333,1.25,
263,1,0,0,1,1,1,1,2,1,0.0,1.0,0.0,0.0,0.0,0.0,
543,1,0,0,1,1,1,1,2,1,0.0,1.0,0.0,0.0,0.0,0.0,
289,30,15,5,36,35,51,11,86,85,647.0,0.6862745098039216,7.196078431372549,6.941945405613225,3.3621073371073376,5.6494140625,
298,1,1,0,0,1,1,1,2,1,0.0,1.0,0.0,0.0,0.0,0.0,
425,1,1,0,0,1,1,1,2,1,0.0,1.0,0.0,0.0,0.0,0.0,
273,1,1,1,1,2,2,2,4,3,66.0,1.0,2.0,0.0,1.0,1.0,
544,1,1,0,0,1,1,1,2,1,0.0,1.0,0.0,0.0,0.0,0.0,
620,6,0,1,4,7,4,5,11,10,163.0,1.75,3.75,0.6875,1.4833333333333334,1.15625,
400,0,0,1,1,1,1,1,2,1,0.0,1.0,0.0,0.0,0.0,0.0,
69,5,2,0,3,5,5,3,10,9,71.0,1.0,2.2,0.15999999999999998,1.0833333333333333,2.375,
184,1,1,0,1,1,2,1,3,2,47.0,0.5,1.0,0.0,0.0,1.0,
528,2,2,1,1,3,3,2,6,5,74.0,1.0,1.6666666666666667,0.2222222222222222,0.6666666666666666,1.5,
499,1,1,0,0,1,1,1,2,1,0.0,1.0,0.0,0.0,0.0,0.0,
553,1,1,1,1,2,2,2,4,3,48.0,1.0,2.0,0.0,1.0,1.0,
536,1,1,0,1,1,2,1,3,2,62.0,0.5,1.0,0.0,0.0,1.0,
321,8,10,0,11,8,21,6,29,28,292.0,0.38095238095238093,3.380952380952381,1.3786848072562357,1.3023809523809522,6.96875,
14,1,1,0,0,1,1,1,2,1,0.0,1.0,0.0,0.0,0.0,0.0,
545,24,12,0,17,24,29,14,53,52,970.0,0.8275862068965517,8.068965517241379,10.409036860879906,1.9548645798645798,2.67529296875,
393,3,5,1,2,4,7,3,11,10,194.0,0.5714285714285714,2.4285714285714284,0.24489795918367344,1.1666666666666665,3.125,
313,1,1,0,1,1,2,1,3,2,1.0,0.5,1.0,0.0,0.0,1.0,
489,1,0,1,2,2,2,2,4,3,86.0,1.0,1.5,0.25,0.5,1.0,
166,13,5,2,11,15,16,8,31,30,484.0,0.9375,4.875,2.734375,1.6425324675324675,3.2734375,
137,3,4,0,3,3,7,3,10,9,258.0,0.42857142857142855,2.857142857142857,0.12244897959183676,1.0,2.75,
27,1,1,0,2,1,3,1,4,3,12.0,0.3333333333333333,1.0,0.0,0.0,1.5,
470,1,2,1,3,2,5,2,7,6,131.0,0.4,1.2,0.16,0.5,2.5,
39,3,1,1,5,4,6,4,10,9,91.0,0.6666666666666666,2.0,1.3333333333333333,0.9166666666666665,2.625,
161,1,0,1,1,2,1,2,3,2,1.0,2.0,2.0,0.0,1.0,0.5,
269,1,2,0,0,1,2,1,3,2,48.0,0.5,1.0,0.0,0.0,1.0,
271,2,1,1,0,3,1,3,4,3,25.0,3.0,3.0,0.0,1.5,0.375,
248,2,2,0,0,2,2,2,4,3,19.0,1.0,1.5,0.25,0.5,1.0,
238,1,0,0,4,1,4,1,5,4,94.0,0.25,1.0,0.0,0.0,2.0,
237,4,6,1,4,5,10,3,15,14,266.0,0.5,2.3,0.41,1.0833333333333333,4.5,
131,4,0,1,4,5,4,4,9,8,113.0,1.25,3.25,0.6875,1.1666666666666665,1.375,
624,1,0,0,1,1,1,1,2,1,0.0,1.0,0.0,0.0,0.0,0.0,
316,1,0,1,1,2,1,2,3,2,34.0,2.0,2.0,0.0,1.0,0.5,
440,0,1,1,0,1,1,1,2,1,0.0,1.0,0.0,0.0,0.0,0.0,
372,5,2,1,10,6,12,4,18,17,293.0,0.5,3.0833333333333335,0.909722222222222,1.4166666666666665,4.25,
46,4,2,0,3,4,5,4,9,8,70.0,0.8,2.4,1.04,0.9166666666666665,2.125,
219,0,1,1,0,1,1,1,2,1,0.0,1.0,0.0,0.0,0.0,0.0,
453,1,1,0,0,1,1,1,2,1,0.0,1.0,0.0,0.0,0.0,0.0,
38,4,2,2,4,6,6,6,12,11,331.0,1.0,3.1666666666666665,3.138888888888889,1.0666666666666667,1.96875,
232,1,1,0,0,1,1,1,2,1,0.0,1.0,0.0,0.0,0.0,0.0,
575,1,0,0,1,1,1,1,2,1,0.0,1.0,0.0,0.0,0.0,0.0,
594,0,0,1,1,1,1,1,2,1,0.0,1.0,0.0,0.0,0.0,0.0,
485,1,1,1,0,2,1,2,3,2,2.0,2.0,2.0,0.0,1.0,0.5,
501,1,2,0,1,1,3,1,4,3,138.0,0.3333333333333333,1.0,0.0,0.0,1.5,
287,1,1,0,0,1,1,1,2,1,0.0,1.0,0.0,0.0,0.0,0.0,
93,1,2,0,2,1,4,1,5,4,13.0,0.25,1.0,0.0,0.0,2.0,
283,1,1,0,1,1,2,1,3,2,24.0,0.5,1.0,0.0,0.0,1.0,
2,1,1,1,0,2,1,2,3,2,51.0,2.0,2.0,0.0,1.0,0.5,
277,23,9,5,21,28,30,13,58,57,533.0,0.9333333333333333,7.566666666666666,8.712222222222225,2.3701492951492953,2.799072265625,
461,1,0,0,2,1,2,1,3,2,17.0,0.5,1.0,0.0,0.0,1.0,
145,5,0,1,7,6,7,5,13,12,229.0,0.8571428571428571,2.5714285714285716,1.959183673469388,1.2333333333333334,2.78125,
294,1,2,0,1,1,3,1,4,3,45.0,0.3333333333333333,1.0,0.0,0.0,1.5,
133,3,3,0,2,3,5,2,8,7,201.0,0.6,1.6,0.24,0.6666666666666666,2.5,
177,2,0,0,1,2,1,2,3,2,12.0,2.0,2.0,0.0,1.0,0.5,
617,1,0,0,1,1,1,1,2,1,0.0,1.0,0.0,0.0,0.0,0.0,
112,1,0,0,2,1,2,1,3,2,33.0,0.5,1.0,0.0,0.0,1.0,
573,1,1,1,0,2,1,2,3,2,8.0,2.0,2.0,0.0,1.0,0.5,
53,3,3,0,4,3,7,2,10,9,99.0,0.42857142857142855,1.7142857142857142,0.20408163265306126,0.6666666666666666,3.5,
200,1,0,0,1,1,1,1,2,1,0.0,1.0,0.0,0.0,0.0,0.0,
559,1,0,0,1,1,1,1,2,1,0.0,1.0,0.0,0.0,0.0,0.0,
588,1,0,0,1,1,1,1,2,1,0.0,1.0,0.0,0.0,0.0,0.0,
12,1,0,0,1,1,1,1,2,1,0.0,1.0,0.0,0.0,0.0,0.0,
100,6,4,0,1,6,5,4,11,10,106.0,1.2,2.6,0.64,1.2333333333333332,2.125,
228,1,0,0,1,1,1,1,2,1,0.0,1.0,0.0,0.0,0.0,0.0,
402,3,3,0,1,3,4,3,7,6,147.0,0.75,2.5,0.25,1.0,1.75,
319,1,1,0,0,1,1,1,2,1,0.0,1.0,0.0,0.0,0.0,0.0,
399,0,1,1,0,1,1,1,2,1,0.0,1.0,0.0,0.0,0.0,0.0,
4,1,2,0,0,1,2,1,3,2,24.0,0.5,1.0,0.0,0.0,1.0,
547,3,0,0,1,3,1,3,4,3,25.0,3.0,3.0,0.0,1.5,0.375,
0,9,4,0,9,9,13,7,22,21,205.0,0.6923076923076923,3.5384615384615383,3.325443786982248,1.4595238095238094,4.109375,
240,1,0,0,1,1,1,1,2,1,0.0,1.0,0.0,0.0,0.0,0.0,
268,1,0,1,2,2,2,2,4,3,73.0,1.0,2.0,0.0,1.0,1.0,
285,1,1,1,0,2,1,2,3,2,26.0,2.0,2.0,0.0,1.0,0.5,
16,1,0,0,1,1,1,1,2,1,0.0,1.0,0.0,0.0,0.0,0.0,
92,8,4,3,12,11,16,9,27,26,548.0,0.6875,4.0625,5.18359375,1.4301587301587302,4.533203125,
537,1,1,0,0,1,1,1,2,1,0.0,1.0,0.0,0.0,0.0,0.0,
71,0,0,1,1,1,1,1,2,1,0.0,1.0,0.0,0.0,0.0,0.0,
348,1,0,0,1,1,1,1,2,1,0.0,1.0,0.0,0.0,0.0,0.0,
63,3,0,0,5,3,5,2,8,7,69.0,0.6,1.8,0.16,0.6666666666666666,2.5,
216,3,1,0,4,3,5,3,8,7,83.0,0.6,2.2,0.5599999999999999,0.8333333333333333,2.25,
455,1,0,0,1,1,1,1,2,1,0.0,1.0,0.0,0.0,0.0,0.0,
154,2,1,0,0,2,1,2,3,2,28.0,2.0,2.0,0.0,1.0,0.5,
41,1,0,0,1,1,1,1,2,1,0.0,1.0,0.0,0.0,0.0,0.0,
644,5,2,1,12,6,14,5,20,19,388.0,0.42857142857142855,1.6428571428571428,1.3724489795918366,1.0333333333333332,6.40625,
640,4,0,1,5,5,5,3,10,9,125.0,1.0,2.0,0.8,0.8999999999999999,2.25,
366,1,2,0,2,1,4,1,5,4,50.0,0.25,1.0,0.0,0.0,2.0,
592,1,1,0,0,1,1,1,2,1,0.0,1.0,0.0,0.0,0.0,0.0,
246,1,0,0,1,1,1,1,2,1,0.0,1.0,0.0,0.0,0.0,0.0,
460,1,0,0,1,1,1,1,2,1,0.0,1.0,0.0,0.0,0.0,0.0,
3,1,1,0,0,1,1,1,2,1,0.0,1.0,0.0,0.0,0.0,0.0,
424,39,28,1,48,40,76,13,116,115,836.0,0.5263157894736842,6.328947368421052,8.483898891966764,3.109236025412497,11.554443359375,
84,1,1,0,0,1,1,1,2,1,0.0,1.0,0.0,0.0,0.0,0.0,
67,1,0,0,1,1,1,1,2,1,0.0,1.0,0.0,0.0,0.0,0.0,
42,3,0,0,2,3,2,3,5,4,44.0,1.5,2.5,0.25,1.0,0.875,
102,1,1,1,2,2,3,2,5,4,76.0,0.6666666666666666,1.3333333333333333,0.2222222222222222,0.5,1.5,
82,5,3,0,5,5,8,3,13,12,136.0,0.625,2.25,0.4375,1.0833333333333333,3.625,
608,1,1,0,0,1,1,1,2,1,0.0,1.0,0.0,0.0,0.0,0.0,
279,1,0,0,1,1,1,1,2,1,0.0,1.0,0.0,0.0,0.0,0.0,
312,1,1,0,1,1,2,1,3,2,52.0,0.5,1.0,0.0,0.0,1.0,
64,1,0,1,3,2,3,2,5,4,83.0,0.6666666666666666,1.3333333333333333,0.2222222222222222,0.5,1.5,
265,1,0,0,3,1,3,1,4,3,22.0,0.3333333333333333,1.0,0.0,0.0,1.5,
388,5,6,0,3,5,9,3,14,13,280.0,0.5555555555555556,2.111111111111111,0.3209876543209877,1.0833333333333333,4.25,
165,0,1,1,0,1,1,1,2,1,0.0,1.0,0.0,0.0,0.0,0.0,
525,1,1,0,1,1,2,1,3,2,37.0,0.5,1.0,0.0,0.0,1.0,
113,1,0,1,1,2,1,2,3,2,89.0,2.0,2.0,0.0,1.0,0.5,
317,1,0,0,1,1,1,1,2,1,0.0,1.0,0.0,0.0,0.0,0.0,
267,3,3,0,7,3,10,3,13,12,217.0,0.3,1.7,0.41,0.8333333333333333,4.875,
589,1,1,0,0,1,1,1,2,1,0.0,1.0,0.0,0.0,0.0,0.0,
56,3,0,0,1,3,1,3,4,3,42.0,3.0,3.0,0.0,1.5,0.375,
182,4,4,0,5,4,9,3,13,12,180.0,0.4444444444444444,1.8888888888888888,0.3209876543209877,0.8333333333333333,4.375,
579,12,8,0,11,12,19,6,31,30,392.0,0.631578947368421,3.5789473684210527,2.349030470914127,2.0357142857142856,6.125,
434,2,3,1,3,3,6,3,9,8,51.0,0.5,1.8333333333333333,0.47222222222222215,0.8333333333333333,2.875,
90,1,1,0,0,1,1,1,2,1,0.0,1.0,0.0,0.0,0.0,0.0,
374,2,1,0,4,2,5,2,7,6,137.0,0.4,1.2,0.16000000000000006,0.5,2.5,
347,1,2,1,2,2,4,2,6,5,74.0,0.5,1.25,0.1875,0.5,2.0,
25,15,9,1,14,16,23,6,39,38,382.0,0.6956521739130435,3.4347826086956523,1.550094517958412,2.3642857142857143,7.5,
442,1,0,0,1,1,1,1,2,1,0.0,1.0,0.0,0.0,0.0,0.0,
255,0,0,2,1,2,1,2,3,2,39.0,2.0,2.0,0.0,1.0,0.5,
447,1,1,0,0,1,1,1,2,1,0.0,1.0,0.0,0.0,0.0,0.0,
188,1,1,0,1,1,2,1,3,2,1.0,0.5,1.0,0.0,0.0,1.0,
415,1,1,0,0,1,1,1,2,1,0.0,1.0,0.0,0.0,0.0,0.0,
556,1,1,0,0,1,1,1,2,1,0.0,1.0,0.0,0.0,0.0,0.0,
282,2,2,1,4,3,6,3,9,8,90.0,0.5,2.0,1.0,0.8333333333333333,2.625,
623,1,0,0,2,1,2,1,3,2,3.0,0.5,1.0,0.0,0.0,1.0,
266,3,1,0,5,3,6,3,9,8,239.0,0.5,2.6666666666666665,0.2222222222222222,1.0,2.5,
61,0,0,1,1,1,1,1,2,1,0.0,1.0,0.0,0.0,0.0,0.0,
124,2,2,0,5,2,7,2,9,8,185.0,0.2857142857142857,1.2857142857142858,0.20408163265306123,0.5,3.5,
478,3,2,0,3,3,5,3,8,7,181.0,0.6,1.6,0.64,0.8333333333333333,2.375,
403,2,0,1,3,3,3,3,6,5,98.0,1.0,2.0,0.6666666666666666,0.8333333333333333,1.375,
505,1,0,0,1,1,1,1,2,1,0.0,1.0,0.0,0.0,0.0,0.0,
52,1,0,0,1,1,1,1,2,1,0.0,1.0,0.0,0.0,0.0,0.0,
422,1,0,0,1,1,1,1,2,1,0.0,1.0,0.0,0.0,0.0,0.0,
243,6,2,1,6,7,8,6,15,14,257.0,0.875,4.125,1.609375,1.4333333333333333,2.0625,
10,1,0,0,2,1,2,1,3,2,8.0,0.5,1.0,0.0,0.0,1.0,
462,1,0,0,1,1,1,1,2,1,0.0,1.0,0.0,0.0,0.0,0.0,
288,1,0,0,1,1,1,1,2,1,0.0,1.0,0.0,0.0,0.0,0.0,
627,0,0,1,2,1,2,1,3,2,0.0,0.5,1.0,0.0,0.0,1.0,
633,1,0,0,1,1,1,1,2,1,0.0,1.0,0.0,0.0,0.0,0.0,
515,1,3,0,1,1,4,1,5,4,62.0,0.25,1.0,0.0,0.0,2.0,
487,1,1,1,1,2,2,2,4,3,46.0,1.0,1.5,0.25,0.5,1.0,
211,3,1,0,3,3,4,3,7,6,120.0,0.75,1.5,0.75,0.8333333333333333,1.875,
590,1,1,0,0,1,1,1,2,1,0.0,1.0,0.0,0.0,0.0,0.0,
647,1,1,0,0,1,1,1,2,1,0.0,1.0,0.0,0.0,0.0,0.0,
628,0,1,1,0,1,1,1,2,1,0.0,1.0,0.0,0.0,0.0,0.0,
541,0,0,1,1,1,1,1,2,1,0.0,1.0,0.0,0.0,0.0,0.0,
349,1,1,0,3,1,4,1,5,4,64.0,0.25,1.0,0.0,0.0,2.0,
126,1,0,0,1,1,1,1,2,1,0.0,1.0,0.0,0.0,0.0,0.0,
625,2,1,0,6,2,7,2,9,8,253.0,0.2857142857142857,1.2857142857142858,0.20408163265306126,0.5,3.5,
258,0,0,1,1,1,1,1,2,1,0.0,1.0,0.0,0.0,0.0,0.0,
484,6,3,0,6,6,9,3,15,14,182.0,0.6666666666666666,2.5555555555555554,0.4691358024691357,1.1,3.75,
456,2,1,0,1,2,2,2,4,3,56.0,1.0,1.5,0.25,0.5,1.0,
504,1,0,0,1,1,1,1,2,1,0.0,1.0,0.0,0.0,0.0,0.0,
72,1,0,0,1,1,1,1,2,1,0.0,1.0,0.0,0.0,0.0,0.0,
467,1,0,0,1,1,1,1,2,1,0.0,1.0,0.0,0.0,0.0,0.0,
121,0,1,1,0,1,1,1,2,1,0.0,1.0,0.0,0.0,0.0,0.0,
486,1,1,0,2,1,3,1,4,3,41.0,0.3333333333333333,1.0,0.0,0.0,1.5,
187,2,1,0,5,2,6,2,8,7,147.0,0.3333333333333333,1.1666666666666667,0.13888888888888887,0.5,3.0,
278,1,0,0,1,1,1,1,2,1,0.0,1.0,0.0,0.0,0.0,0.0,
387,2,3,0,3,2,6,2,8,7,125.0,0.3333333333333333,1.5,0.25,0.5,3.0,
587,2,3,0,1,2,4,2,6,5,154.0,0.5,1.25,0.1875,0.5,2.0,
98,3,1,0,1,3,2,3,5,4,63.0,1.5,3.0,0.0,1.5,0.75,
324,5,2,2,5,7,7,3,14,13,257.0,1.0,2.5714285714285716,0.24489795918367344,1.35,3.0,
142,3,0,0,3,3,3,3,6,5,74.0,1.0,2.6666666666666665,0.22222222222222224,1.0,1.25,
378,1,1,0,0,1,1,1,2,1,0.0,1.0,0.0,0.0,0.0,0.0,
191,1,1,0,2,1,3,1,4,3,64.0,0.3333333333333333,1.0,0.0,0.0,1.5,
172,2,0,0,2,2,2,2,4,3,4.0,1.0,1.5,0.25,0.5,1.0,
377,0,0,1,1,1,1,1,2,1,0.0,1.0,0.0,0.0,0.0,0.0,
107,1,0,0,1,1,1,1,2,1,0.0,1.0,0.0,0.0,0.0,0.0,
408,3,3,2,3,5,6,4,11,10,230.0,0.8333333333333334,2.5,0.9166666666666666,1.1666666666666665,2.5,
409,1,4,0,2,1,6,1,7,6,90.0,0.16666666666666666,1.0,0.0,0.0,3.0,
235,4,3,0,6,4,9,3,13,12,351.0,0.4444444444444444,2.2222222222222223,0.8395061728395062,0.8333333333333333,3.875,
57,8,5,0,5,8,10,6,18,17,323.0,0.8,3.5,2.45,1.4666666666666666,3.15625,
15,1,0,0,1,1,1,1,2,1,0.0,1.0,0.0,0.0,0.0,0.0,
192,6,4,2,6,8,10,5,18,17,346.0,0.8,2.5,2.25,1.4,3.90625,
472,1,0,0,1,1,1,1,2,1,0.0,1.0,0.0,0.0,0.0,0.0,
407,1,3,0,3,1,6,1,7,6,196.0,0.16666666666666666,1.0,0.0,0.0,3.0,
183,4,1,0,6,4,7,2,11,10,223.0,0.5714285714285714,2.0,0.0,1.0,3.5,
252,1,1,0,0,1,1,1,2,1,0.0,1.0,0.0,0.0,0.0,0.0,
87,0,0,1,1,1,1,1,2,1,0.0,1.0,0.0,0.0,0.0,0.0,
365,1,0,0,1,1,1,1,2,1,0.0,1.0,0.0,0.0,0.0,0.0,
95,9,6,0,13,9,19,4,28,27,301.0,0.47368421052631576,2.210526315789474,0.7977839335180057,1.55,8.375,
230,1,1,0,1,1,2,1,3,2,21.0,0.5,1.0,0.0,0.0,1.0,
304,0,0,1,1,1,1,1,2,1,0.0,1.0,0.0,0.0,0.0,0.0,
221,0,0,1,1,1,1,1,2,1,0.0,1.0,0.0,0.0,0.0,0.0,
468,1,1,0,2,1,3,1,4,3,11.0,0.3333333333333333,1.0,0.0,0.0,1.5,
629,3,2,0,3,3,5,2,8,7,203.0,0.6,2.0,0.0,0.6666666666666666,2.5,
426,2,0,0,2,2,2,2,4,3,5.0,1.0,1.5,0.25,0.5,1.0,
76,3,1,1,5,4,6,3,10,9,211.0,0.6666666666666666,1.8333333333333333,0.8055555555555557,0.8333333333333333,2.75,
303,0,0,1,1,1,1,1,2,1,0.0,1.0,0.0,0.0,0.0,0.0,
206,1,1,0,0,1,1,1,2,1,0.0,1.0,0.0,0.0,0.0,0.0,
634,0,1,1,0,1,1,1,2,1,0.0,1.0,0.0,0.0,0.0,0.0,
55,4,0,0,2,4,2,4,6,5,66.0,2.0,3.0,1.0,1.1666666666666665,0.75,
151,1,0,0,1,1,1,1,2,1,0.0,1.0,0.0,0.0,0.0,0.0,
253,5,2,0,4,5,6,3,11,10,223.0,0.8333333333333334,2.0,0.3333333333333333,1.0833333333333333,2.875,
259,2,1,0,1,2,2,2,4,3,89.0,1.0,1.5,0.25,0.5,1.0,
97,1,0,0,1,1,1,1,2,1,0.0,1.0,0.0,0.0,0.0,0.0,
136,1,1,0,2,1,3,1,4,3,66.0,0.3333333333333333,1.0,0.0,0.0,1.5,
350,1,0,0,1,1,1,1,2,1,0.0,1.0,0.0,0.0,0.0,0.0,
234,3,3,0,3,3,6,3,9,8,214.0,0.5,2.1666666666666665,0.47222222222222215,0.8333333333333333,2.75,
143,1,3,0,1,1,4,1,5,4,161.0,0.25,1.0,0.0,0.0,2.0,
305,1,0,0,3,1,3,1,4,3,71.0,0.3333333333333333,1.0,0.0,0.0,1.5,
609,0,0,1,1,1,1,1,2,1,0.0,1.0,0.0,0.0,0.0,0.0,
395,3,4,0,2,3,6,3,9,8,129.0,0.5,1.5,0.5833333333333334,0.8333333333333333,2.875,
115,2,0,0,1,2,1,2,3,2,22.0,2.0,2.0,0.0,1.0,0.5,
603,3,0,0,2,3,2,2,5,4,28.0,1.5,2.0,0.0,0.6666666666666666,1.0,
398,1,1,0,0,1,1,1,2,1,0.0,1.0,0.0,0.0,0.0,0.0,
202,5,3,0,2,5,5,4,10,9,279.0,1.0,3.0,1.2,1.1666666666666665,1.75,
176,1,0,0,1,1,1,1,2,1,0.0,1.0,0.0,0.0,0.0,0.0,
445,0,0,1,1,1,1,1,2,1,0.0,1.0,0.0,0.0,0.0,0.0,
292,1,0,0,1,1,1,1,2,1,0.0,1.0,0.0,0.0,0.0,0.0,
336,1,3,0,2,1,5,1,6,5,108.0,0.2,1.0,0.0,0.0,2.5,
576,0,1,1,0,1,1,1,2,1,0.0,1.0,0.0,0.0,0.0,0.0,
308,5,3,1,3,6,6,6,12,11,232.0,1.0,3.8333333333333335,2.472222222222222,1.2333333333333334,1.78125,
108,3,1,0,0,3,1,3,4,3,31.0,3.0,3.0,0.0,1.5,0.375,
290,1,1,0,2,1,3,1,4,3,89.0,0.3333333333333333,1.0,0.0,0.0,1.5,
648,1,1,0,1,1,2,1,3,2,16.0,0.5,1.0,0.0,0.0,1.0,
375,3,1,0,0,3,1,3,4,3,64.0,3.0,3.0,0.0,1.5,0.375,
389,1,1,0,0,1,1,1,2,1,0.0,1.0,0.0,0.0,0.0,0.0,
526,1,0,0,1,1,1,1,2,1,0.0,1.0,0.0,0.0,0.0,0.0,
520,0,0,1,1,1,1,1,2,1,0.0,1.0,0.0,0.0,0.0,0.0,
491,2,1,0,1,2,2,2,4,3,10.0,1.0,1.5,0.25,0.5,1.0,
423,0,1,1,0,1,1,1,2,1,0.0,1.0,0.0,0.0,0.0,0.0,
43,1,0,0,2,1,2,1,3,2,12.0,0.5,1.0,0.0,0.0,1.0,
281,4,2,0,0,4,2,4,6,5,100.0,2.0,2.5,2.25,0.9166666666666666,0.75,
117,1,0,0,2,1,2,1,3,2,49.0,0.5,1.0,0.0,0.0,1.0,
149,1,0,0,1,1,1,1,2,1,0.0,1.0,0.0,0.0,0.0,0.0,
646,3,2,0,2,3,4,2,7,6,72.0,0.75,1.75,0.1875,0.6666666666666666,2.0,
141,6,2,0,3,6,5,4,11,10,123.0,1.2,2.4,1.04,0.9833333333333332,2.125,
36,1,1,0,0,1,1,1,2,1,0.0,1.0,0.0,0.0,0.0,0.0,
637,4,4,1,3,5,7,4,12,11,146.0,0.7142857142857143,2.0,1.1428571428571428,0.9833333333333332,3.125,
264,2,1,0,4,2,5,2,7,6,167.0,0.4,1.4,0.24,0.5,2.5,
337,1,1,0,2,1,3,1,4,3,98.0,0.3333333333333333,1.0,0.0,0.0,1.5,
611,1,1,1,1,2,2,2,4,3,203.0,1.0,1.5,0.25,0.5,1.0,
452,1,1,2,3,3,4,3,7,6,145.0,0.75,2.25,0.1875,1.0,1.875,
170,6,5,1,3,7,8,5,15,14,354.0,0.875,3.5,1.75,1.4333333333333333,2.46875,
419,1,0,0,1,1,1,1,2,1,0.0,1.0,0.0,0.0,0.0,0.0,
181,1,2,0,0,1,2,1,3,2,4.0,0.5,1.0,0.0,0.0,1.0,
390,2,0,0,1,2,1,2,3,2,1.0,2.0,2.0,0.0,1.0,0.5,
474,4,6,1,5,5,11,3,16,15,307.0,0.45454545454545453,2.0,0.36363636363636365,0.9,5.25,
498,1,0,0,2,1,2,1,3,2,13.0,0.5,1.0,0.0,0.0,1.0,
458,13,17,3,22,16,39,6,55,54,568.0,0.41025641025641024,4.076923076923077,1.8658777120315568,2.6547619047619047,9.65625,
503,1,1,0,1,1,2,1,3,2,5.0,0.5,1.0,0.0,0.0,1.0,
618,0,1,1,0,1,1,1,2,1,0.0,1.0,0.0,0.0,0.0,0.0,
75,1,0,0,1,1,1,1,2,1,0.0,1.0,0.0,0.0,0.0,0.0,
261,4,6,1,5,5,11,4,16,15,303.0,0.45454545454545453,2.5454545454545454,0.975206611570248,1.1666666666666665,4.5,
9,1,1,0,0,1,1,1,2,1,0.0,1.0,0.0,0.0,0.0,0.0,
174,2,0,0,4,2,4,2,6,5,102.0,0.5,1.75,0.1875,0.5,2.0,
593,1,1,0,0,1,1,1,2,1,0.0,1.0,0.0,0.0,0.0,0.0,
356,5,5,0,5,5,10,4,15,14,235.0,0.5,2.2,1.3599999999999999,0.9833333333333334,4.25,
129,3,0,0,1,3,1,3,4,3,105.0,3.0,3.0,0.0,1.5,0.375,
521,3,1,1,6,4,7,3,11,10,153.0,0.5714285714285714,1.5714285714285714,0.5306122448979591,0.8333333333333333,3.375,
622,4,3,0,9,4,12,4,16,15,276.0,0.3333333333333333,2.5833333333333335,1.076388888888889,0.9166666666666665,4.875,
254,1,0,0,1,1,1,1,2,1,0.0,1.0,0.0,0.0,0.0,0.0,
296,1,2,0,1,1,3,1,4,3,69.0,0.3333333333333333,1.0,0.0,0.0,1.5,
473,3,1,0,4,3,5,3,8,7,216.0,0.6,1.6,0.64,0.8333333333333333,2.375,
342,2,1,0,0,2,1,2,3,2,13.0,2.0,2.0,0.0,1.0,0.5,
561,2,4,2,3,4,7,3,11,10,511.0,0.5714285714285714,2.142857142857143,0.4081632653061224,1.1666666666666665,3.25,
300,2,0,0,1,2,1,2,3,2,1.0,2.0,2.0,0.0,1.0,0.5,
406,1,0,0,2,1,2,1,3,2,6.0,0.5,1.0,0.0,0.0,1.0,
476,10,8,2,10,12,18,9,30,29,366.0,0.6666666666666666,4.833333333333333,2.4722222222222223,1.6797619047619046,3.642578125,
586,1,2,1,1,2,3,2,5,4,18.0,0.6666666666666666,1.3333333333333333,0.2222222222222222,0.5,1.5,
157,7,3,0,4,7,7,5,14,13,119.0,1.0,2.7142857142857144,1.3469387755102038,1.2,2.90625,
135,5,5,1,4,6,9,5,15,14,380.0,0.6666666666666666,3.0,0.8888888888888888,1.2333333333333334,3.40625,
242,1,0,0,1,1,1,1,2,1,0.0,1.0,0.0,0.0,0.0,0.0,
274,2,1,2,2,4,3,4,7,6,142.0,1.3333333333333333,3.0,2.0,0.9166666666666666,1.0,
310,3,1,1,1,4,2,3,6,5,211.0,2.0,2.5,0.25,0.8333333333333333,0.875,
361,1,0,0,1,1,1,1,2,1,0.0,1.0,0.0,0.0,0.0,0.0,
291,3,2,0,3,3,5,3,8,7,121.0,0.6,1.8,0.56,0.8333333333333333,2.375,
529,0,1,1,0,1,1,1,2,1,0.0,1.0,0.0,0.0,0.0,0.0,
428,1,0,1,1,2,1,2,3,2,112.0,2.0,2.0,0.0,1.0,0.5,
80,0,0,1,2,1,2,1,3,2,50.0,0.5,1.0,0.0,0.0,1.0,
557,1,0,0,1,1,1,1,2,1,0.0,1.0,0.0,0.0,0.0,0.0,
392,1,0,0,2,1,2,1,3,2,10.0,0.5,1.0,0.0,0.0,1.0,
391,5,2,0,1,5,3,4,8,7,185.0,1.6666666666666667,2.6666666666666665,0.8888888888888888,0.9833333333333334,1.25,
548,1,1,0,0,1,1,1,2,1,0.0,1.0,0.0,0.0,0.0,0.0,
225,3,0,0,1,3,1,3,4,3,113.0,3.0,3.0,0.0,1.5,0.375,
233,1,1,0,0,1,1,1,2,1,0.0,1.0,0.0,0.0,0.0,0.0,
352,1,0,0,1,1,1,1,2,1,0.0,1.0,0.0,0.0,0.0,0.0,
564,0,1,1,0,1,1,1,2,1,0.0,1.0,0.0,0.0,0.0,0.0,
250,1,1,0,1,1,2,1,3,2,43.0,0.5,1.0,0.0,0.0,1.0,
538,5,6,0,9,5,15,2,20,19,267.0,0.3333333333333333,1.7333333333333334,0.1955555555555556,1.3333333333333333,7.5,
451,2,1,1,1,3,2,3,5,4,15.0,1.5,2.5,0.25,1.0,0.875,
449,0,1,1,0,1,1,1,2,1,0.0,1.0,0.0,0.0,0.0,0.0,
479,2,1,0,3,2,4,2,6,5,101.0,0.5,1.5,0.25,0.5,2.0,
464,1,1,0,0,1,1,1,2,1,0.0,1.0,0.0,0.0,0.0,0.0,
502,2,1,0,0,2,1,2,3,2,20.0,2.0,2.0,0.0,1.0,0.5,
322,0,1,1,0,1,1,1,2,1,0.0,1.0,0.0,0.0,0.0,0.0,
152,0,0,1,1,1,1,1,2,1,0.0,1.0,0.0,0.0,0.0,0.0,
50,2,1,2,1,4,2,4,6,5,88.0,2.0,4.0,0.0,1.8333333333333333,0.5,
616,2,0,0,1,2,1,2,3,2,5.0,2.0,2.0,0.0,1.0,0.5,
469,10,3,1,10,11,13,7,24,23,403.0,0.8461538461538461,4.6923076923076925,3.751479289940829,1.536904761904762,2.8359375,
329,2,0,0,1,2,1,2,3,2,13.0,2.0,2.0,0.0,1.0,0.5,
338,1,0,0,1,1,1,1,2,1,0.0,1.0,0.0,0.0,0.0,0.0,
297,3,3,1,4,4,7,4,11,10,90.0,0.5714285714285714,2.142857142857143,0.6938775510204079,0.9166666666666666,3.25,
158,1,0,0,1,1,1,1,2,1,0.0,1.0,0.0,0.0,0.0,0.0,
580,1,1,0,2,1,3,1,4,3,74.0,0.3333333333333333,1.0,0.0,0.0,1.5,
411,1,1,0,0,1,1,1,2,1,0.0,1.0,0.0,0.0,0.0,0.0,
286,1,0,0,1,1,1,1,2,1,0.0,1.0,0.0,0.0,0.0,0.0,
574,1,1,0,1,1,2,1,3,2,82.0,0.5,1.0,0.0,0.0,1.0,
437,2,1,0,1,2,2,2,4,3,51.0,1.0,1.5,0.25,0.5,1.0,
155,0,0,1,1,1,1,1,2,1,0.0,1.0,0.0,0.0,0.0,0.0,
295,4,1,1,6,5,7,4,12,11,211.0,0.7142857142857143,2.5714285714285716,0.5306122448979592,1.1666666666666665,3.0,
569,1,0,0,1,1,1,1,2,1,0.0,1.0,0.0,0.0,0.0,0.0,
123,4,1,0,4,4,5,4,9,8,162.0,0.8,2.0,1.2,0.9166666666666665,2.25,
371,2,4,1,3,3,7,3,10,9,183.0,0.42857142857142855,1.2857142857142858,0.489795918367347,0.8333333333333333,3.375,
441,4,1,0,1,4,2,4,6,5,29.0,2.0,2.5,2.25,0.9166666666666665,0.75,
119,1,0,0,1,1,1,1,2,1,0.0,1.0,0.0,0.0,0.0,0.0,
619,1,1,0,0,1,1,1,2,1,0.0,1.0,0.0,0.0,0.0,0.0,
196,0,0,1,1,1,1,1,2,1,0.0,1.0,0.0,0.0,0.0,0.0,
641,1,0,0,1,1,1,1,2,1,0.0,1.0,0.0,0.0,0.0,0.0,
436,1,0,0,1,1,1,1,2,1,0.0,1.0,0.0,0.0,0.0,0.0,
500,1,1,0,0,1,1,1,2,1,0.0,1.0,0.0,0.0,0.0,0.0,
567,2,1,0,0,2,1,2,3,2,76.0,2.0,2.0,0.0,1.0,0.5,
610,2,2,0,0,2,2,2,4,3,10.0,1.0,1.5,0.25,0.5,1.0,
606,2,0,0,1,2,1,2,3,2,28.0,2.0,2.0,0.0,1.0,0.5,
173,1,0,0,1,1,1,1,2,1,0.0,1.0,0.0,0.0,0.0,0.0,
48,4,1,0,2,4,3,3,7,6,75.0,1.3333333333333333,2.0,0.6666666666666666,0.8333333333333333,1.375,
509,1,1,0,0,1,1,1,2,1,0.0,1.0,0.0,0.0,0.0,0.0,
364,1,1,0,0,1,1,1,2,1,0.0,1.0,0.0,0.0,0.0,0.0,
19,1,0,0,1,1,1,1,2,1,0.0,1.0,0.0,0.0,0.0,0.0,
249,1,0,0,1,1,1,1,2,1,0.0,1.0,0.0,0.0,0.0,0.0,
604,1,1,0,0,1,1,1,2,1,0.0,1.0,0.0,0.0,0.0,0.0,
62,3,3,0,2,3,5,2,8,7,138.0,0.6,1.4,0.24,0.6666666666666666,2.5,
519,9,3,0,11,9,14,6,23,22,255.0,0.6428571428571429,4.142857142857143,1.5510204081632655,1.9333333333333331,3.5625,
535,6,8,0,10,6,18,6,24,23,428.0,0.3333333333333333,3.2777777777777777,2.4228395061728394,1.0666666666666667,5.84375,
22,1,1,0,0,1,1,1,2,1,0.0,1.0,0.0,0.0,0.0,0.0,
168,8,6,0,8,8,14,6,22,21,357.0,0.5714285714285714,3.4285714285714284,2.2448979591836737,1.4333333333333336,4.65625,
60,6,2,1,10,7,12,4,19,18,205.0,0.5833333333333334,2.5833333333333335,1.076388888888889,1.4833333333333332,4.875,
276,2,2,0,2,2,4,2,6,5,74.0,0.5,1.5,0.25,0.5,2.0,
203,9,5,1,7,10,12,6,22,21,343.0,0.8333333333333334,3.6666666666666665,1.888888888888889,1.5785714285714285,3.375,
600,1,0,0,1,1,1,1,2,1,0.0,1.0,0.0,0.0,0.0,0.0,
495,2,0,0,2,2,2,2,4,3,74.0,1.0,1.5,0.25,0.5,1.0,
218,1,0,0,3,1,3,1,4,3,3.0,0.3333333333333333,1.0,0.0,0.0,1.5,
532,1,1,1,1,2,2,2,4,3,91.0,1.0,1.5,0.25,0.5,1.0,
621,5,1,0,6,5,7,4,12,11,195.0,0.7142857142857143,2.2857142857142856,1.6326530612244896,1.1666666666666665,2.875,
492,11,10,5,17,16,27,7,43,42,590.0,0.5925925925925926,5.222222222222222,1.6543209876543203,2.3464285714285715,4.40625,
331,5,3,0,3,5,6,4,11,10,158.0,0.8333333333333334,2.3333333333333335,1.5555555555555556,1.1666666666666665,2.5,
417,2,2,0,2,2,4,2,6,5,122.0,0.5,2.0,0.0,1.0,2.0,
204,2,0,0,2,2,2,2,4,3,45.0,1.0,1.5,0.25,0.5,1.0,
293,3,1,0,3,3,4,3,7,6,95.0,0.75,2.0,0.5,0.8333333333333333,1.875,
566,0,1,1,0,1,1,1,2,1,0.0,1.0,0.0,0.0,0.0,0.0,
81,9,6,0,4,9,10,5,19,18,257.0,0.9,3.8,0.5599999999999999,1.9333333333333331,2.8125,
614,6,1,0,4,6,5,4,11,10,121.0,1.2,3.6,0.6400000000000002,1.2333333333333334,1.5,
284,1,1,0,1,1,2,1,3,2,53.0,0.5,1.0,0.0,0.0,1.0,
109,2,0,0,1,2,1,2,3,2,125.0,2.0,2.0,0.0,1.0,0.5,
475,7,3,0,9,7,12,6,19,18,286.0,0.5833333333333334,3.8333333333333335,0.9722222222222223,1.2333333333333332,3.40625,
198,1,1,0,0,1,1,1,2,1,0.0,1.0,0.0,0.0,0.0,0.0,
514,3,3,0,2,3,5,2,8,7,107.0,0.6,1.6,0.24,0.6666666666666666,2.5,
605,8,1,2,7,10,8,6,18,17,194.0,1.25,3.25,1.9375,1.2357142857142858,2.84375,
433,1,0,0,1,1,1,1,2,1,0.0,1.0,0.0,0.0,0.0,0.0,
413,2,3,1,0,3,3,3,6,5,32.0,1.0,2.0,0.6666666666666666,0.8333333333333333,1.375,
159,1,0,0,3,1,3,1,4,3,33.0,0.3333333333333333,1.0,0.0,0.0,1.5,
497,7,3,0,5,7,8,4,15,14,210.0,0.875,2.75,0.9375,1.1833333333333333,3.125,
189,5,3,1,9,6,12,4,18,17,338.0,0.5,2.75,1.0208333333333333,1.1833333333333333,4.625,
330,1,1,0,2,1,3,1,4,3,24.0,0.3333333333333333,1.0,0.0,0.0,1.5,
179,1,1,0,0,1,1,1,2,1,0.0,1.0,0.0,0.0,0.0,0.0,
511,2,0,0,3,2,3,2,5,4,52.0,0.6666666666666666,1.3333333333333333,0.2222222222222222,0.5,1.5,
148,1,0,0,1,1,1,1,2,1,0.0,1.0,0.0,0.0,0.0,0.0,
320,3,5,0,3,3,8,3,11,10,256.0,0.375,2.5,0.25,1.0,3.5,
421,0,2,1,0,1,2,1,3,2,4.0,0.5,1.0,0.0,0.0,1.0,
91,9,6,0,3,9,9,6,18,17,215.0,1.0,3.6666666666666665,1.7777777777777777,1.1246031746031746,2.625,
524,1,0,0,1,1,1,1,2,1,0.0,1.0,0.0,0.0,0.0,0.0,
418,25,11,1,23,26,34,14,60,59,411.0,0.7647058823529411,8.441176470588236,10.893598615916954,2.192626817626817,2.595703125,
643,0,0,1,1,1,1,1,2,1,0.0,1.0,0.0,0.0,0.0,0.0,
581,1,2,0,0,1,2,1,3,2,56.0,0.5,1.0,0.0,0.0,1.0,
78,5,3,0,6,5,9,3,14,13,130.0,0.5555555555555556,1.7777777777777777,0.3950617283950617,1.0833333333333333,4.375,
272,1,0,0,2,1,2,1,3,2,1.0,0.5,1.0,0.0,0.0,1.0,
1,3,2,0,2,3,4,3,7,6,190.0,0.75,1.75,0.6875,0.8333333333333333,1.875,
493,1,0,0,1,1,1,1,2,1,0.0,1.0,0.0,0.0,0.0,0.0,
354,1,1,0,0,1,1,1,2,1,0.0,1.0,0.0,0.0,0.0,0.0,
26,2,1,0,2,2,3,2,5,4,100.0,0.6666666666666666,1.3333333333333333,0.2222222222222222,0.5,1.5,
241,1,1,0,0,1,1,1,2,1,0.0,1.0,0.0,0.0,0.0,0.0,
138,1,0,0,1,1,1,1,2,1,0.0,1.0,0.0,0.0,0.0,0.0,
394,1,0,0,1,1,1,1,2,1,0.0,1.0,0.0,0.0,0.0,0.0,
128,1,1,0,2,1,3,1,4,3,43.0,0.3333333333333333,1.0,0.0,0.0,1.5,
257,2,1,0,1,2,2,2,4,3,13.0,1.0,1.5,0.25,0.5,1.0,
260,1,0,0,1,1,1,1,2,1,0.0,1.0,0.0,0.0,0.0,0.0,
513,0,1,1,0,1,1,1,2,1,0.0,1.0,0.0,0.0,0.0,0.0,
546,1,0,0,1,1,1,1,2,1,0.0,1.0,0.0,0.0,0.0,0.0,
65,0,0,1,1,1,1,1,2,1,0.0,1.0,0.0,0.0,0.0,0.0,
327,1,0,0,1,1,1,1,2,1,0.0,1.0,0.0,0.0,0.0,0.0,
70,2,0,0,1,2,1,2,3,2,3.0,2.0,2.0,0.0,1.0,0.5,
533,11,4,1,10,12,14,7,26,25,482.0,0.8571428571428571,3.7857142857142856,1.7397959183673468,1.4341269841269841,4.1484375,
7,1,1,0,3,1,4,1,5,4,46.0,0.25,1.0,0.0,0.0,2.0,
30,6,2,0,6,6,8,4,14,13,143.0,0.75,3.0,0.25,1.4166666666666665,3.0,
86,3,4,0,2,3,6,3,9,8,309.0,0.5,1.8333333333333333,0.8055555555555555,0.8333333333333333,2.75,
24,1,1,0,0,1,1,1,2,1,0.0,1.0,0.0,0.0,0.0,0.0,
583,3,3,0,2,3,5,3,8,7,108.0,0.6,2.8,0.15999999999999998,1.0,2.0,
510,3,2,0,2,3,4,3,7,6,215.0,0.75,3.0,0.0,1.5,1.5,
414,1,1,0,0,1,1,1,2,1,0.0,1.0,0.0,0.0,0.0,0.0,
582,1,0,0,1,1,1,1,2,1,0.0,1.0,0.0,0.0,0.0,0.0,
163,4,1,2,7,6,8,5,14,13,493.0,0.75,2.375,1.734375,1.2333333333333334,3.28125,
